event_time,event_name,surface,num_of_sets,playerA,playerB,winner,score,round,duration_minutes,a_aces,a_double_faults,a_first_serve_hits,a_first_serve_total,a_first_serve_won,a_first_serve_played,a_second_serve_won,a_second_serve_played,a_break_points_saved,a_break_points_total,a_service_games,a_service_points_won,a_service_points_total,b_aces,b_double_faults,b_first_serve_hits,b_first_serve_total,b_first_serve_won,b_first_serve_played,b_second_serve_won,b_second_serve_played,b_break_points_saved,b_break_points_total,b_service_games,b_service_points_won,b_service_points_total
2015-01-04 00:00:00.000,Brisbane International presented by Suncorp Australia ATP World Tour 250,HARD,2,Roger Federer,N/A Bye,Roger Federer,,R32,0,0,0,0,0,0,0,0,0,0,0,0,0,0,0,0,0,0,0,0,0,0,0,0,0,0,0
2015-01-04 00:00:00.000,Brisbane International presented by Suncorp Australia ATP World Tour 250,HARD,2,John Millman,Rhyne Williams,John Millman,6-3; 6-1,R32,65,6,2,24,44,19,24,14,20,1,1,8,33,44,3,4,31,50,20,31,5,19,1,5,8,25,50
2015-01-04 00:00:00.000,Brisbane International presented by Suncorp Australia ATP World Tour 250,HARD,2,Jarkko Nieminen,Denis Kudla,Jarkko Nieminen,4-6; 6-1; 6-4,R32,104,4,0,59,92,39,59,17,33,4,7,14,56,92,6,1,50,83,26,50,19,33,3,8,13,45,83
2015-01-04 00:00:00.000,Brisbane International presented by Suncorp Australia ATP World Tour 250,HARD,2,James Duckworth,Gilles Simon,James Duckworth,6-2; 6-2,R32,68,4,0,27,45,20,27,11,18,2,3,8,31,45,2,1,37,56,22,37,5,19,10,15,8,27,56
2015-01-04 00:00:00.000,Brisbane International presented by Suncorp Australia ATP World Tour 250,HARD,2,Grigor Dimitrov,N/A Bye,Grigor Dimitrov,,R32,0,0,0,0,0,0,0,0,0,0,0,0,0,0,0,0,0,0,0,0,0,0,0,0,0,0,0
2015-01-04 00:00:00.000,Brisbane International presented by Suncorp Australia ATP World Tour 250,HARD,2,Jeremy Chardy,Andrey Golubev,Jeremy Chardy,6-4; 6-4,R32,69,7,1,39,53,31,39,11,14,0,0,10,42,53,9,2,38,57,30,38,8,19,1,3,10,38,57
2015-01-04 00:00:00.000,Brisbane International presented by Suncorp Australia ATP World Tour 250,HARD,2,Martin Klizan,Jurgen Melzer,Martin Klizan,6-7(5); 7-6(6); 6-1,R32,144,9,4,79,130,55,79,27,51,6,8,16,82,130,4,4,62,95,40,62,19,33,4,8,15,59,95
2015-01-04 00:00:00.000,Brisbane International presented by Suncorp Australia ATP World Tour 250,HARD,2,Alexandr Dolgopolov,Carlos Berlocq,Alexandr Dolgopolov,6-2; 6-3,R32,78,6,1,31,49,24,31,12,18,3,4,9,36,49,3,2,53,78,32,53,8,25,11,15,8,40,78
2015-01-04 00:00:00.000,Brisbane International presented by Suncorp Australia ATP World Tour 250,HARD,2,Lukasz Kubot,Kevin Anderson,Lukasz Kubot,7-6(3); 6-4,R32,110,6,5,51,78,35,51,14,27,3,5,11,49,78,12,3,43,76,30,43,17,33,4,7,11,47,76
2015-01-04 00:00:00.000,Brisbane International presented by Suncorp Australia ATP World Tour 250,HARD,2,Sam Groth,Lleyton Hewitt,Sam Groth,6-3; 6-2,R32,59,14,0,34,47,30,34,8,13,2,2,9,38,47,1,2,22,45,13,22,14,23,1,4,8,27,45
2015-01-04 00:00:00.000,Brisbane International presented by Suncorp Australia ATP World Tour 250,HARD,2,Mikhail Kukushkin,Marius Copil,Mikhail Kukushkin,6-4; 4-6; 6-4,R32,113,3,1,56,84,42,56,16,28,1,3,15,58,84,17,2,56,89,46,56,15,33,3,6,15,61,89
2015-01-04 00:00:00.000,Brisbane International presented by Suncorp Australia ATP World Tour 250,HARD,2,Milos Raonic,N/A Bye,Milos Raonic,,R32,0,0,0,0,0,0,0,0,0,0,0,0,0,0,0,0,0,0,0,0,0,0,0,0,0,0,0
2015-01-04 00:00:00.000,Brisbane International presented by Suncorp Australia ATP World Tour 250,HARD,2,Thanasi Kokkinakis,Julien Benneteau,Thanasi Kokkinakis,6-4; 6-3,R32,75,9,1,30,52,25,30,14,22,1,2,10,39,52,5,3,33,52,23,33,7,19,1,4,9,30,52
2015-01-04 00:00:00.000,Brisbane International presented by Suncorp Australia ATP World Tour 250,HARD,2,Bernard Tomic,Sam Querrey,Bernard Tomic,7-5; 7-6(5),R32,83,5,0,46,77,36,46,21,31,4,5,12,57,77,20,3,42,70,35,42,14,28,4,6,12,49,70
2015-01-04 00:00:00.000,Brisbane International presented by Suncorp Australia ATP World Tour 250,HARD,2,Steve Johnson,Marinko Matosevic,Steve Johnson,2-6; 7-6(0); 7-5,R32,136,14,3,58,95,45,58,24,37,4,6,16,69,95,10,5,68,106,51,68,19,38,3,4,16,70,106
2015-01-04 00:00:00.000,Brisbane International presented by Suncorp Australia ATP World Tour 250,HARD,2,Kei Nishikori,N/A Bye,Kei Nishikori,,R32,0,0,0,0,0,0,0,0,0,0,0,0,0,0,0,0,0,0,0,0,0,0,0,0,0,0,0
2015-01-04 00:00:00.000,Brisbane International presented by Suncorp Australia ATP World Tour 250,HARD,2,Roger Federer,John Millman,Roger Federer,4-6; 6-4; 6-3,R16,122,8,3,50,85,37,50,19,35,9,11,14,56,85,2,2,72,112,44,72,20,40,9,13,15,64,112
2015-01-04 00:00:00.000,Brisbane International presented by Suncorp Australia ATP World Tour 250,HARD,2,James Duckworth,Jarkko Nieminen,James Duckworth,4-6; 7-6(5); 6-3,R16,123,16,3,66,114,51,66,24,48,7,9,16,75,114,5,0,60,92,45,60,19,32,4,6,15,64,92
2015-01-04 00:00:00.000,Brisbane International presented by Suncorp Australia ATP World Tour 250,HARD,2,Grigor Dimitrov,Jeremy Chardy,Grigor Dimitrov,3-6; 6-4; 7-6(8),R16,148,10,3,64,107,46,64,23,43,5,7,16,69,107,9,6,78,126,60,78,20,48,12,13,15,80,126
2015-01-04 00:00:00.000,Brisbane International presented by Suncorp Australia ATP World Tour 250,HARD,2,Martin Klizan,Alexandr Dolgopolov,Martin Klizan,1-6; 7-6(6); 7-6(7),R16,147,4,5,73,116,46,73,18,43,5,10,15,64,116,16,2,68,103,51,68,19,35,1,4,16,70,103
2015-01-04 00:00:00.000,Brisbane International presented by Suncorp Australia ATP World Tour 250,HARD,2,Sam Groth,Lukasz Kubot,Sam Groth,6-4; 6-7(2); 7-6(3),R16,148,21,2,80,111,62,80,19,31,2,2,17,81,111,14,5,75,112,58,75,22,37,6,7,17,80,112
2015-01-04 00:00:00.000,Brisbane International presented by Suncorp Australia ATP World Tour 250,HARD,2,Milos Raonic,Mikhail Kukushkin,Milos Raonic,6-3; 6-4,R16,61,17,4,31,48,28,31,12,17,0,0,10,40,48,1,1,32,54,22,32,12,22,2,4,9,34,54
2015-01-04 00:00:00.000,Brisbane International presented by Suncorp Australia ATP World Tour 250,HARD,2,Bernard Tomic,Thanasi Kokkinakis,Bernard Tomic,7-6(2); 6-1,R16,79,8,1,51,72,38,51,12,21,0,0,10,50,72,7,3,32,61,23,32,14,29,3,5,9,37,61
2015-01-04 00:00:00.000,Brisbane International presented by Suncorp Australia ATP World Tour 250,HARD,2,Kei Nishikori,Steve Johnson,Kei Nishikori,6-4; 7-5,R16,81,7,1,45,67,34,45,16,22,2,2,11,50,67,6,1,33,61,24,33,17,28,1,3,11,41,61
2015-01-04 00:00:00.000,Brisbane International presented by Suncorp Australia ATP World Tour 250,HARD,2,Roger Federer,James Duckworth,Roger Federer,6-0; 6-1,Q,41,12,2,21,30,19,21,6,9,0,0,6,25,30,0,1,25,38,8,25,4,13,2,8,7,12,38
2015-01-04 00:00:00.000,Brisbane International presented by Suncorp Australia ATP World Tour 250,HARD,2,Grigor Dimitrov,Martin Klizan,Grigor Dimitrov,6-3; 6-4,Q,73,7,2,34,57,26,34,12,23,1,3,10,38,57,3,1,37,53,24,37,5,16,1,5,9,29,53
2015-01-04 00:00:00.000,Brisbane International presented by Suncorp Australia ATP World Tour 250,HARD,2,Milos Raonic,Sam Groth,Milos Raonic,7-6(5); 3-6; 7-6(2),Q,121,15,2,65,96,53,65,19,31,4,5,16,72,96,22,1,74,98,58,74,17,24,0,0,17,75,98
2015-01-04 00:00:00.000,Brisbane International presented by Suncorp Australia ATP World Tour 250,HARD,2,Kei Nishikori,Bernard Tomic,Kei Nishikori,6-0; 6-4,Q,59,5,1,26,38,24,26,8,12,0,0,8,32,38,10,2,41,68,26,41,10,27,12,16,8,36,68
2015-01-04 00:00:00.000,Brisbane International presented by Suncorp Australia ATP World Tour 250,HARD,2,Roger Federer,Grigor Dimitrov,Roger Federer,6-2; 6-2,S,53,1,1,33,48,27,33,9,15,4,4,8,36,48,4,1,30,48,19,30,6,18,3,7,8,25,48
2015-01-04 00:00:00.000,Brisbane International presented by Suncorp Australia ATP World Tour 250,HARD,2,Milos Raonic,Kei Nishikori,Milos Raonic,6-7(4); 7-6(4); 7-6(4),S,153,34,3,84,122,72,84,22,38,3,3,18,94,122,6,3,82,116,69,82,21,34,3,3,18,90,116
2015-01-04 00:00:00.000,Brisbane International presented by Suncorp Australia ATP World Tour 250,HARD,2,Roger Federer,Milos Raonic,Roger Federer,6-4; 6-7(2); 6-4,F,133,21,0,64,100,51,64,19,36,5,6,16,70,100,14,4,58,108,44,58,27,50,4,7,16,71,108
2015-01-05 00:00:00.000,Aircel Chennai Open India ATP World Tour 250,HARD,2,Stan Wawrinka,N/A Bye,Stan Wawrinka,,R32,0,0,0,0,0,0,0,0,0,0,0,0,0,0,0,0,0,0,0,0,0,0,0,0,0,0,0
2015-01-05 00:00:00.000,Aircel Chennai Open India ATP World Tour 250,HARD,2,Borna Coric,Robin Haase,Borna Coric,6-2; 6-2,R32,66,4,1,26,48,21,26,12,22,4,5,8,33,48,1,0,27,46,14,27,5,19,2,7,8,19,46
2015-01-05 00:00:00.000,Aircel Chennai Open India ATP World Tour 250,HARD,2,Elias Ymer,Igor Sijsling,Elias Ymer,6-4; 4-6; 6-3,R32,106,3,2,55,80,39,55,15,25,4,7,15,54,80,3,7,62,98,43,62,13,36,4,8,14,56,98
2015-01-05 00:00:00.000,Aircel Chennai Open India ATP World Tour 250,HARD,2,Gilles Muller,Edouard Roger-Vasselin,Gilles Muller,6-7(11); 6-1; 7-6(3),R32,143,29,4,65,100,49,65,23,35,3,4,15,72,100,4,3,69,101,50,69,16,32,1,5,16,66,101
2015-01-05 00:00:00.000,Aircel Chennai Open India ATP World Tour 250,HARD,2,David Goffin,N/A Bye,David Goffin,,R32,0,0,0,0,0,0,0,0,0,0,0,0,0,0,0,0,0,0,0,0,0,0,0,0,0,0,0
2015-01-05 00:00:00.000,Aircel Chennai Open India ATP World Tour 250,HARD,2,Ricardas Berankis,Luca Vanni,Ricardas Berankis,6-1; 2-6; 7-5,R32,109,4,3,46,76,33,46,16,30,3,6,13,49,76,11,1,46,81,30,46,17,35,2,7,14,47,81
2015-01-05 00:00:00.000,Aircel Chennai Open India ATP World Tour 250,HARD,2,Jiri Vesely,N Vijay Sundar Prashanth,Jiri Vesely,6-2; 6-1,R32,67,4,1,23,39,20,23,9,16,0,0,7,29,39,0,0,28,55,12,28,14,27,5,10,8,26,55
2015-01-05 00:00:00.000,Aircel Chennai Open India ATP World Tour 250,HARD,2,Andreas Haider-Maurer,Marcel Granollers,Andreas Haider-Maurer,3-6; 7-6(6); 2-0 RET,R32,134,3,4,43,91,32,43,22,48,6,9,12,54,91,5,2,38,74,29,38,19,36,4,6,11,48,74
2015-01-05 00:00:00.000,Aircel Chennai Open India ATP World Tour 250,HARD,2,Yen-Hsun Lu,Somdev Devvarman,Yen-Hsun Lu,6-3; 6-4,R32,80,2,0,31,54,22,31,14,23,1,3,10,36,54,3,1,38,61,22,38,9,23,7,11,9,31,61
2015-01-05 00:00:00.000,Aircel Chennai Open India ATP World Tour 250,HARD,2,Pablo Carreno Busta,Alejandro Gonzalez,Pablo Carreno Busta,6-1; 6-3,R32,60,1,1,23,46,20,23,12,23,3,4,8,32,46,2,2,24,45,12,24,7,21,3,8,8,19,45
2015-01-05 00:00:00.000,Aircel Chennai Open India ATP World Tour 250,HARD,2,Peter Gojowczyk,Alejandro Falla,Peter Gojowczyk,6-0; 6-1,R32,43,2,0,21,42,18,21,13,21,3,3,7,31,42,0,0,20,36,9,20,5,16,1,6,6,14,36
2015-01-05 00:00:00.000,Aircel Chennai Open India ATP World Tour 250,HARD,2,Roberto Bautista Agut,N/A Bye,Roberto Bautista Agut,,R32,0,0,0,0,0,0,0,0,0,0,0,0,0,0,0,0,0,0,0,0,0,0,0,0,0,0,0
2015-01-05 00:00:00.000,Aircel Chennai Open India ATP World Tour 250,HARD,2,Guillermo Garcia-Lopez,Evgeny Donskoy,Guillermo Garcia-Lopez,6-7(3); 6-2; 6-3,R32,115,4,1,41,75,31,41,24,34,3,5,14,55,75,6,6,51,94,31,51,20,43,5,11,15,51,94
2015-01-05 00:00:00.000,Aircel Chennai Open India ATP World Tour 250,HARD,2,Tatsuma Ito,Ramkumar Ramanathan,Tatsuma Ito,6-3; 6-3,R32,81,2,1,38,52,33,38,6,14,2,2,9,39,52,9,4,40,77,30,40,13,37,8,11,9,43,77
2015-01-05 00:00:00.000,Aircel Chennai Open India ATP World Tour 250,HARD,2,Aljaz Bedene,Lukas Lacko,Aljaz Bedene,7-6(0); 6-3,R32,96,11,4,40,79,37,40,19,39,3,3,11,56,79,5,2,49,74,35,49,12,25,6,7,10,47,74
2015-01-05 00:00:00.000,Aircel Chennai Open India ATP World Tour 250,HARD,2,Feliciano Lopez,N/A Bye,Feliciano Lopez,,R32,0,0,0,0,0,0,0,0,0,0,0,0,0,0,0,0,0,0,0,0,0,0,0,0,0,0,0
2015-01-05 00:00:00.000,Aircel Chennai Open India ATP World Tour 250,HARD,2,Stan Wawrinka,Borna Coric,Stan Wawrinka,6-1; 6-4,R16,71,4,1,26,48,24,26,12,22,0,0,9,36,48,2,0,28,54,18,28,11,26,5,8,8,29,54
2015-01-05 00:00:00.000,Aircel Chennai Open India ATP World Tour 250,HARD,2,Gilles Muller,Elias Ymer,Gilles Muller,6-4; 6-3,R16,80,6,2,37,68,31,37,16,31,7,7,10,47,68,2,3,35,46,30,35,1,11,0,2,9,31,46
2015-01-05 00:00:00.000,Aircel Chennai Open India ATP World Tour 250,HARD,2,David Goffin,Ricardas Berankis,David Goffin,6-0; 4-6; 7-6(1),R16,116,12,4,46,78,38,46,19,32,2,4,14,57,78,1,4,74,101,48,74,10,27,6,10,14,58,101
2015-01-05 00:00:00.000,Aircel Chennai Open India ATP World Tour 250,HARD,2,Andreas Haider-Maurer,Jiri Vesely,Andreas Haider-Maurer,6-7(3); 6-4; 6-4,R16,126,13,7,67,97,49,67,18,30,3,4,16,67,97,14,4,67,100,53,67,13,33,2,5,16,66,100
2015-01-05 00:00:00.000,Aircel Chennai Open India ATP World Tour 250,HARD,2,Yen-Hsun Lu,Pablo Carreno Busta,Yen-Hsun Lu,6-4; 6-4,R16,74,7,2,39,58,30,39,10,19,4,5,10,40,58,7,2,48,67,32,48,6,19,4,7,10,38,67
2015-01-05 00:00:00.000,Aircel Chennai Open India ATP World Tour 250,HARD,2,Roberto Bautista Agut,Peter Gojowczyk,Roberto Bautista Agut,6-3; 6-2,R16,71,6,4,35,61,23,35,14,26,6,8,9,37,61,5,2,27,47,16,27,6,20,1,6,8,22,47
2015-01-05 00:00:00.000,Aircel Chennai Open India ATP World Tour 250,HARD,2,Guillermo Garcia-Lopez,Tatsuma Ito,Guillermo Garcia-Lopez,6-7(1); 6-2; 6-0,R16,126,8,2,49,87,35,49,19,38,4,7,13,54,87,5,7,58,98,34,58,15,40,10,18,13,49,98
2015-01-05 00:00:00.000,Aircel Chennai Open India ATP World Tour 250,HARD,2,Aljaz Bedene,Feliciano Lopez,Aljaz Bedene,6-4; 6-4,R16,86,7,1,38,57,33,38,10,19,1,1,10,43,57,6,2,42,75,28,42,17,33,8,10,10,45,75
2015-01-05 00:00:00.000,Aircel Chennai Open India ATP World Tour 250,HARD,2,Stan Wawrinka,Gilles Muller,Stan Wawrinka,6-2; 7-6(4),Q,86,4,0,39,61,31,39,17,22,3,4,10,48,61,1,4,38,71,26,38,16,33,3,6,10,42,71
2015-01-05 00:00:00.000,Aircel Chennai Open India ATP World Tour 250,HARD,2,David Goffin,Andreas Haider-Maurer,David Goffin,7-5; 6-2,Q,72,7,1,25,50,21,25,17,25,0,1,10,38,50,6,2,39,62,25,39,10,23,3,7,10,35,62
2015-01-05 00:00:00.000,Aircel Chennai Open India ATP World Tour 250,HARD,2,Roberto Bautista Agut,Yen-Hsun Lu,Roberto Bautista Agut,7-6(7); 6-4,Q,109,3,0,47,73,34,47,16,26,2,3,11,50,73,5,1,47,85,34,47,18,38,4,6,11,52,85
2015-01-05 00:00:00.000,Aircel Chennai Open India ATP World Tour 250,HARD,2,Aljaz Bedene,Guillermo Garcia-Lopez,Aljaz Bedene,2-6; 6-3; 6-2,Q,116,11,1,64,99,44,64,16,35,8,11,13,60,99,3,4,37,73,24,37,18,36,3,7,12,42,73
2015-01-05 00:00:00.000,Aircel Chennai Open India ATP World Tour 250,HARD,2,Stan Wawrinka,David Goffin,Stan Wawrinka,7-5; 6-3,S,91,6,1,37,72,26,37,22,35,7,8,11,48,72,3,2,38,69,29,38,12,31,7,10,10,41,69
2015-01-05 00:00:00.000,Aircel Chennai Open India ATP World Tour 250,HARD,2,Aljaz Bedene,Roberto Bautista Agut,Aljaz Bedene,3-6; 6-3; 7-6(8),S,163,15,3,64,125,45,64,27,61,10,15,15,72,125,2,2,68,99,43,68,18,31,5,10,15,61,99
2015-01-05 00:00:00.000,Aircel Chennai Open India ATP World Tour 250,HARD,2,Stan Wawrinka,Aljaz Bedene,Stan Wawrinka,6-3; 6-4,F,70,2,1,39,59,29,39,13,20,0,0,10,42,59,7,2,33,52,25,33,9,19,2,4,9,34,52
2015-01-05 00:00:00.000,Qatar ExxonMobil Open Qatar ATP World Tour 250,HARD,2,Novak Djokovic,Dusan Lajovic,Novak Djokovic,6-2; 6-1,R32,59,3,2,35,50,24,35,8,15,3,4,8,32,50,0,2,27,43,13,27,5,16,1,6,7,18,43
2015-01-05 00:00:00.000,Qatar ExxonMobil Open Qatar ATP World Tour 250,HARD,2,Sergiy Stakhovsky,Jabor Mohammed Ali Mutawa,Sergiy Stakhovsky,6-1; 6-1,R32,46,7,3,35,52,28,35,6,17,2,2,7,34,52,1,3,23,38,11,23,3,15,3,8,7,14,38
2015-01-05 00:00:00.000,Qatar ExxonMobil Open Qatar ATP World Tour 250,HARD,2,Nikoloz Basilashvili,Mikhail Youzhny,Nikoloz Basilashvili,7-5; 6-2,R32,77,2,0,35,53,26,35,10,18,1,3,10,36,53,1,4,36,65,25,36,9,29,4,9,10,34,65
2015-01-05 00:00:00.000,Qatar ExxonMobil Open Qatar ATP World Tour 250,HARD,2,Ivo Karlovic,Lukas Rosol,Ivo Karlovic,7-6(4); 6-3,R32,92,27,0,47,77,38,47,19,30,8,8,11,57,77,7,3,48,75,36,48,13,27,5,6,10,49,75
2015-01-05 00:00:00.000,Qatar ExxonMobil Open Qatar ATP World Tour 250,HARD,2,David Ferrer,Thiemo de Bakker,David Ferrer,6-7(4); 6-4; 6-3,R32,138,5,2,43,87,31,43,29,44,1,3,15,60,87,13,1,63,118,47,63,24,55,7,12,16,71,118
2015-01-05 00:00:00.000,Qatar ExxonMobil Open Qatar ATP World Tour 250,HARD,2,Fernando Verdasco,Teymuraz Gabashvili,Fernando Verdasco,4-6; 6-3; 7-6(4),R32,144,8,5,99,123,70,99,11,24,8,9,16,81,123,12,4,69,101,58,69,13,32,9,10,15,71,101
2015-01-05 00:00:00.000,Qatar ExxonMobil Open Qatar ATP World Tour 250,HARD,2,Dustin Brown,Paolo Lorenzi,Dustin Brown,7-6(3); 6-3,R32,81,6,2,44,68,31,44,14,24,1,3,11,45,68,0,3,44,65,26,44,9,21,2,5,10,35,65
2015-01-05 00:00:00.000,Qatar ExxonMobil Open Qatar ATP World Tour 250,HARD,2,Jan-Lennard Struff,Philipp Kohlschreiber,Jan-Lennard Struff,7-6(3); 4-6; 6-1,R32,116,7,0,59,95,52,59,15,36,5,6,15,67,95,7,1,65,90,45,65,14,25,4,6,14,59,90
2015-01-05 00:00:00.000,Qatar ExxonMobil Open Qatar ATP World Tour 250,HARD,2,Richard Gasquet,Pablo Andujar,Richard Gasquet,6-3; 7-5,R32,93,8,4,43,64,33,43,10,21,4,5,11,43,64,1,1,51,68,34,51,7,17,4,7,10,41,68
2015-01-05 00:00:00.000,Qatar ExxonMobil Open Qatar ATP World Tour 250,HARD,2,Simone Bolelli,Benjamin Becker,Simone Bolelli,6-3; 7-6(2),R32,90,10,1,43,61,34,43,14,18,1,2,11,48,61,7,0,51,80,31,51,17,29,5,7,10,48,80
2015-01-05 00:00:00.000,Qatar ExxonMobil Open Qatar ATP World Tour 250,HARD,2,Blaz Kavcic,Juan Monaco,Blaz Kavcic,7-6(3); 6-4,R32,114,4,1,58,79,42,58,12,21,4,5,11,54,79,4,1,54,78,33,54,13,24,4,6,11,46,78
2015-01-05 00:00:00.000,Qatar ExxonMobil Open Qatar ATP World Tour 250,HARD,2,Tomas Berdych,Denis Istomin,Tomas Berdych,6-1; 6-4,R32,63,9,0,24,45,23,24,13,21,0,0,9,36,45,0,0,27,47,17,27,9,20,4,7,8,26,47
2015-01-05 00:00:00.000,Qatar ExxonMobil Open Qatar ATP World Tour 250,HARD,2,Andreas Seppi,Leonardo Mayer,Andreas Seppi,5-7; 7-6(4); 7-6(4),R32,164,5,2,68,113,55,68,28,45,4,5,18,83,113,12,5,77,130,61,77,29,53,6,6,18,90,130
2015-01-05 00:00:00.000,Qatar ExxonMobil Open Qatar ATP World Tour 250,HARD,2,Joao Souza,Malek Jaziri,Joao Souza,3-6; 6-4; 6-3,R32,98,8,0,51,72,42,51,14,21,4,5,14,56,72,3,3,35,75,27,35,27,40,1,3,14,54,75
2015-01-05 00:00:00.000,Qatar ExxonMobil Open Qatar ATP World Tour 250,HARD,2,Ivan Dodig,Mohamed Safwat,Ivan Dodig,6-3; 6-1,R32,51,8,0,24,36,23,24,9,12,0,0,8,32,36,0,2,29,48,18,29,6,19,0,4,8,24,48
2015-01-05 00:00:00.000,Qatar ExxonMobil Open Qatar ATP World Tour 250,HARD,2,Michael Berrer,Rafael Nadal,Michael Berrer,1-6; 6-3; 6-4,R32,116,6,2,68,89,47,68,11,21,10,12,13,58,89,2,1,48,72,34,48,15,24,2,4,13,49,72
2015-01-05 00:00:00.000,Qatar ExxonMobil Open Qatar ATP World Tour 250,HARD,2,Novak Djokovic,Sergiy Stakhovsky,Novak Djokovic,6-2; 6-1,R16,61,5,2,34,51,29,34,8,17,3,3,8,37,51,3,1,26,48,16,26,6,22,3,7,7,22,48
2015-01-05 00:00:00.000,Qatar ExxonMobil Open Qatar ATP World Tour 250,HARD,2,Ivo Karlovic,Nikoloz Basilashvili,Ivo Karlovic,7-6(3); 6-3,R16,83,19,0,43,61,36,43,12,18,1,2,11,48,61,4,5,48,78,33,48,14,30,7,9,10,47,78
2015-01-05 00:00:00.000,Qatar ExxonMobil Open Qatar ATP World Tour 250,HARD,2,David Ferrer,Fernando Verdasco,David Ferrer,6-3; 6-2,R16,78,2,3,31,46,23,31,9,15,1,2,8,32,46,1,4,48,74,27,48,9,26,8,13,9,36,74
2015-01-05 00:00:00.000,Qatar ExxonMobil Open Qatar ATP World Tour 250,HARD,2,Dustin Brown,Jan-Lennard Struff,Dustin Brown,7-6(9); 6-4,R16,86,15,4,60,82,50,60,9,22,1,1,11,59,82,8,1,50,75,38,50,14,25,4,5,11,52,75
2015-01-05 00:00:00.000,Qatar ExxonMobil Open Qatar ATP World Tour 250,HARD,2,Richard Gasquet,Simone Bolelli,Richard Gasquet,6-3; 6-2,R16,65,6,1,33,42,27,33,6,9,0,1,9,33,42,3,0,40,57,23,40,6,17,4,8,8,29,57
2015-01-05 00:00:00.000,Qatar ExxonMobil Open Qatar ATP World Tour 250,HARD,2,Tomas Berdych,Blaz Kavcic,Tomas Berdych,6-1; 6-2,R16,58,4,0,29,45,23,29,11,16,0,0,8,34,45,1,3,34,47,21,34,1,13,1,5,7,22,47
2015-01-05 00:00:00.000,Qatar ExxonMobil Open Qatar ATP World Tour 250,HARD,2,Andreas Seppi,Joao Souza,Andreas Seppi,7-5; 6-2,R16,72,7,0,37,54,30,37,10,17,4,5,10,40,54,3,0,34,58,24,34,10,24,4,8,10,34,58
2015-01-05 00:00:00.000,Qatar ExxonMobil Open Qatar ATP World Tour 250,HARD,2,Ivan Dodig,Michael Berrer,Ivan Dodig,7-6(1); 6-2,R16,83,7,0,35,57,28,35,16,22,1,1,10,44,57,7,3,56,75,36,56,7,19,5,7,10,43,75
2015-01-05 00:00:00.000,Qatar ExxonMobil Open Qatar ATP World Tour 250,HARD,2,Ivo Karlovic,Novak Djokovic,Ivo Karlovic,6-7(2); 7-6(6); 6-4,Q,136,21,3,73,99,62,73,13,26,0,0,17,75,99,11,2,81,112,61,81,19,31,3,4,17,80,112
2015-01-05 00:00:00.000,Qatar ExxonMobil Open Qatar ATP World Tour 250,HARD,2,David Ferrer,Dustin Brown,David Ferrer,6-2; 6-2,Q,69,1,3,45,65,31,45,8,20,5,6,8,39,65,2,7,33,55,21,33,4,22,5,10,8,25,55
2015-01-05 00:00:00.000,Qatar ExxonMobil Open Qatar ATP World Tour 250,HARD,2,Tomas Berdych,Richard Gasquet,Tomas Berdych,6-2; 6-1,Q,58,5,2,31,50,26,31,9,19,1,1,8,35,50,1,1,27,37,14,27,3,10,3,7,7,17,37
2015-01-05 00:00:00.000,Qatar ExxonMobil Open Qatar ATP World Tour 250,HARD,2,Andreas Seppi,Ivan Dodig,Andreas Seppi,7-5; 6-4,Q,92,3,2,38,78,32,38,15,40,5,8,11,47,78,3,2,36,62,18,36,13,26,2,7,11,31,62
2015-01-05 00:00:00.000,Qatar ExxonMobil Open Qatar ATP World Tour 250,HARD,2,David Ferrer,Ivo Karlovic,David Ferrer,6-7(2); 7-6(5); 7-6(4),S,152,5,0,97,122,76,97,15,25,2,2,18,91,122,30,1,81,117,67,81,22,36,3,3,18,89,117
2015-01-05 00:00:00.000,Qatar ExxonMobil Open Qatar ATP World Tour 250,HARD,2,Tomas Berdych,Andreas Seppi,Tomas Berdych,6-2; 6-3,S,73,3,2,38,56,32,38,9,18,3,3,9,41,56,2,1,36,58,26,36,6,22,6,9,8,32,58
2015-01-05 00:00:00.000,Qatar ExxonMobil Open Qatar ATP World Tour 250,HARD,2,David Ferrer,Tomas Berdych,David Ferrer,6-4; 7-5,F,90,1,3,42,63,30,42,11,21,6,8,11,41,63,6,3,36,59,27,36,8,23,4,8,11,35,59
2015-01-11 00:00:00.000,Apia International Sydney Australia ATP World Tour 250,HARD,2,Fabio Fognini,N/A Bye,Fabio Fognini,,R32,0,0,0,0,0,0,0,0,0,0,0,0,0,0,0,0,0,0,0,0,0,0,0,0,0,0,0
2015-01-11 00:00:00.000,Apia International Sydney Australia ATP World Tour 250,HARD,2,Juan Martin Del Potro,Sergiy Stakhovsky,Juan Martin Del Potro,6-3; 7-6(4),R32,81,7,0,41,61,37,41,11,20,0,0,11,48,61,7,3,31,58,23,31,17,27,1,2,10,40,58
2015-01-11 00:00:00.000,Apia International Sydney Australia ATP World Tour 250,HARD,2,Mikhail Kukushkin,Denis Istomin,Mikhail Kukushkin,6-3; 7-6(1),R32,88,4,2,32,66,22,32,22,34,2,4,11,44,66,3,0,42,63,32,42,5,21,2,5,10,37,63
2015-01-11 00:00:00.000,Apia International Sydney Australia ATP World Tour 250,HARD,2,Pablo Cuevas,Nicolas Almagro,Pablo Cuevas,7-6(5); 6-4,R32,95,12,3,42,73,35,42,17,31,2,2,11,52,73,13,1,56,84,42,56,13,28,4,5,11,55,84
2015-01-11 00:00:00.000,Apia International Sydney Australia ATP World Tour 250,HARD,2,Julien Benneteau,N/A Bye,Julien Benneteau,,R32,0,0,0,0,0,0,0,0,0,0,0,0,0,0,0,0,0,0,0,0,0,0,0,0,0,0,0
2015-01-11 00:00:00.000,Apia International Sydney Australia ATP World Tour 250,HARD,2,Vasek Pospisil,Andreas Seppi,Vasek Pospisil,6-3; 7-6(4),R32,72,10,1,42,66,35,42,12,24,2,3,11,47,66,5,1,34,59,26,34,13,25,3,5,10,39,59
2015-01-11 00:00:00.000,Apia International Sydney Australia ATP World Tour 250,HARD,2,Jerzy Janowicz,Nick Kyrgios,Jerzy Janowicz,6-1; 6-7(6); 7-6(5),R32,122,14,6,77,113,64,77,20,36,5,5,16,84,113,17,1,66,99,50,66,22,33,2,4,15,72,99
2015-01-11 00:00:00.000,Apia International Sydney Australia ATP World Tour 250,HARD,2,Leonardo Mayer,Benjamin Becker,Leonardo Mayer,7-6(3); 6-2,R32,74,6,0,34,53,28,34,16,19,0,0,10,44,53,6,0,42,69,35,42,9,27,7,9,10,44,69
2015-01-11 00:00:00.000,Apia International Sydney Australia ATP World Tour 250,HARD,2,Jeremy Chardy,Sam Querrey,Jeremy Chardy,6-4; 6-4,R32,65,6,2,44,58,34,44,9,14,3,3,10,43,58,10,2,39,61,31,39,9,22,4,6,10,40,61
2015-01-11 00:00:00.000,Apia International Sydney Australia ATP World Tour 250,HARD,2,Gilles Muller,Sam Groth,Gilles Muller,3-6; 6-3; 7-6(6),R32,116,12,7,68,97,53,68,13,29,5,8,15,66,97,22,4,67,91,51,67,8,24,1,4,15,59,91
2015-01-11 00:00:00.000,Apia International Sydney Australia ATP World Tour 250,HARD,2,Bernard Tomic,Igor Sijsling,Bernard Tomic,6-1; 6-2,R32,43,8,0,34,42,29,34,4,8,0,0,8,33,42,2,2,24,41,14,24,6,17,2,6,7,20,41
2015-01-11 00:00:00.000,Apia International Sydney Australia ATP World Tour 250,HARD,2,Philipp Kohlschreiber,N/A Bye,Philipp Kohlschreiber,,R32,0,0,0,0,0,0,0,0,0,0,0,0,0,0,0,0,0,0,0,0,0,0,0,0,0,0,0
2015-01-11 00:00:00.000,Apia International Sydney Australia ATP World Tour 250,HARD,2,Viktor Troicki,Martin Klizan,Viktor Troicki,6-2; 6-3,R32,48,8,1,29,42,28,29,8,13,0,0,9,36,42,3,2,30,46,19,30,6,16,1,4,8,25,46
2015-01-11 00:00:00.000,Apia International Sydney Australia ATP World Tour 250,HARD,2,Pablo Andujar,Jarkko Nieminen,Pablo Andujar,6-2; 6-2,R32,71,1,0,42,56,27,42,11,14,9,9,8,38,56,4,2,39,59,25,39,3,20,7,11,8,28,59
2015-01-11 00:00:00.000,Apia International Sydney Australia ATP World Tour 250,HARD,2,Simone Bolelli,Marinko Matosevic,Simone Bolelli,6-3; 6-2,R32,55,7,0,33,45,27,33,9,12,0,0,9,36,45,5,3,27,45,18,27,9,18,0,3,8,27,45
2015-01-11 00:00:00.000,Apia International Sydney Australia ATP World Tour 250,HARD,2,David Goffin,N/A Bye,David Goffin,,R32,0,0,0,0,0,0,0,0,0,0,0,0,0,0,0,0,0,0,0,0,0,0,0,0,0,0,0
2015-01-11 00:00:00.000,Apia International Sydney Australia ATP World Tour 250,HARD,2,Juan Martin Del Potro,Fabio Fognini,Juan Martin Del Potro,4-6; 6-2; 6-2,R16,108,11,1,47,75,38,47,14,28,4,6,13,52,75,9,4,39,81,23,39,21,42,5,10,13,44,81
2015-01-11 00:00:00.000,Apia International Sydney Australia ATP World Tour 250,HARD,2,Mikhail Kukushkin,Pablo Cuevas,Mikhail Kukushkin,7-5; 7-5,R16,109,7,1,51,87,34,51,22,36,6,7,12,56,87,6,4,48,82,35,48,13,34,5,8,12,48,82
2015-01-11 00:00:00.000,Apia International Sydney Australia ATP World Tour 250,HARD,2,Julien Benneteau,Vasek Pospisil,Julien Benneteau,7-6(3); 6-3,R16,91,5,0,42,62,34,42,15,20,0,0,11,49,62,4,3,42,73,30,42,16,31,6,7,10,46,73
2015-01-11 00:00:00.000,Apia International Sydney Australia ATP World Tour 250,HARD,2,Leonardo Mayer,Jerzy Janowicz,Leonardo Mayer,4-6; 6-1; 7-6(3),R16,126,13,3,59,102,47,59,23,43,4,5,15,70,102,9,2,58,88,39,58,19,30,2,4,14,58,88
2015-01-11 00:00:00.000,Apia International Sydney Australia ATP World Tour 250,HARD,2,Gilles Muller,Jeremy Chardy,Gilles Muller,2-6; 7-6(1); 6-4,R16,114,15,1,63,98,48,63,18,35,6,8,15,66,98,19,4,51,80,40,51,21,29,5,6,15,61,80
2015-01-11 00:00:00.000,Apia International Sydney Australia ATP World Tour 250,HARD,2,Bernard Tomic,Philipp Kohlschreiber,Bernard Tomic,6-3; 6-4,R16,60,8,1,38,57,31,38,12,19,2,2,10,43,57,4,0,27,43,21,27,11,16,2,4,9,32,43
2015-01-11 00:00:00.000,Apia International Sydney Australia ATP World Tour 250,HARD,2,Viktor Troicki,Pablo Andujar,Viktor Troicki,4-6; 6-3; 6-3,R16,115,13,1,46,79,36,46,17,33,3,6,14,53,79,1,5,59,91,36,59,16,32,5,10,14,52,91
2015-01-11 00:00:00.000,Apia International Sydney Australia ATP World Tour 250,HARD,2,Simone Bolelli,David Goffin,Simone Bolelli,6-3; 6-3,R16,66,5,2,36,56,28,36,12,20,2,2,9,40,56,3,5,26,49,18,26,9,23,3,6,9,27,49
2015-01-11 00:00:00.000,Apia International Sydney Australia ATP World Tour 250,HARD,2,Mikhail Kukushkin,Juan Martin Del Potro,Mikhail Kukushkin,7-6(5); 7-6(3),Q,116,3,1,49,78,37,49,23,29,0,0,12,60,78,13,0,52,72,43,52,12,20,0,0,12,55,72
2015-01-11 00:00:00.000,Apia International Sydney Australia ATP World Tour 250,HARD,2,Leonardo Mayer,Julien Benneteau,Leonardo Mayer,6-3; 7-6(4),Q,90,12,3,49,71,41,49,12,22,4,4,11,53,71,2,2,46,62,32,46,10,16,0,1,10,42,62
2015-01-11 00:00:00.000,Apia International Sydney Australia ATP World Tour 250,HARD,2,Gilles Muller,Bernard Tomic,Gilles Muller,7-6(3); 7-6(13),Q,103,25,0,66,83,57,66,11,17,2,2,12,68,83,15,1,66,87,52,66,15,21,3,3,12,67,87
2015-01-11 00:00:00.000,Apia International Sydney Australia ATP World Tour 250,HARD,2,Viktor Troicki,Simone Bolelli,Viktor Troicki,6-3; 3-6; 7-5,Q,128,16,0,55,82,47,55,13,27,1,3,15,60,82,2,3,83,118,53,83,19,35,11,14,15,72,118
2015-01-11 00:00:00.000,Apia International Sydney Australia ATP World Tour 250,HARD,2,Mikhail Kukushkin,Leonardo Mayer,Mikhail Kukushkin,6-4; 6-4,S,102,4,2,32,75,27,32,23,43,11,11,10,50,75,8,3,46,71,33,46,11,25,4,6,10,44,71
2015-01-11 00:00:00.000,Apia International Sydney Australia ATP World Tour 250,HARD,2,Viktor Troicki,Gilles Muller,Viktor Troicki,6-2; 6-4,S,64,13,1,33,52,27,33,11,19,0,0,9,38,52,9,2,29,51,19,29,13,22,4,7,9,32,51
2015-01-11 00:00:00.000,Apia International Sydney Australia ATP World Tour 250,HARD,2,Viktor Troicki,Mikhail Kukushkin,Viktor Troicki,6-2; 6-3,F,64,13,2,31,46,27,31,7,15,1,2,9,34,46,1,0,29,51,18,29,7,22,1,5,8,25,51
2015-01-12 00:00:00.000,Heineken Open New Zealand ATP World Tour 250,HARD,2,Lucas Pouille,N/A Bye,Lucas Pouille,,R32,0,0,0,0,0,0,0,0,0,0,0,0,0,0,0,0,0,0,0,0,0,0,0,0,0,0,0
2015-01-12 00:00:00.000,Heineken Open New Zealand ATP World Tour 250,HARD,2,Michael Venus,Alejandro Gonzalez,Michael Venus,5-7; 6-3; 7-6(7),R32,125,18,5,52,110,43,52,32,58,8,11,17,75,110,6,1,56,94,46,56,19,38,2,5,16,65,94
2015-01-12 00:00:00.000,Heineken Open New Zealand ATP World Tour 250,HARD,2,Albert Ramos-Vinolas,Paolo Lorenzi,Albert Ramos-Vinolas,6-4; 6-3,R32,81,2,0,34,55,26,34,14,21,1,1,9,40,55,6,1,36,55,23,36,12,19,1,4,10,35,55
2015-01-12 00:00:00.000,Heineken Open New Zealand ATP World Tour 250,HARD,2,Yen-Hsun Lu,Juan Monaco,Yen-Hsun Lu,6-4; 2-6; 6-1,R32,104,2,1,47,82,32,47,17,35,5,9,13,49,82,2,0,57,80,35,57,9,23,6,11,12,44,80
2015-01-12 00:00:00.000,Heineken Open New Zealand ATP World Tour 250,HARD,2,Roberto Bautista Agut,N/A Bye,Roberto Bautista Agut,,R32,0,0,0,0,0,0,0,0,0,0,0,0,0,0,0,0,0,0,0,0,0,0,0,0,0,0,0
2015-01-12 00:00:00.000,Heineken Open New Zealand ATP World Tour 250,HARD,2,Adrian Mannarino,Federico Delbonis,Adrian Mannarino,6-1; 6-1,R32,53,3,1,23,37,17,23,8,14,0,1,7,25,37,2,1,24,40,8,24,5,16,3,9,7,13,40
2015-01-12 00:00:00.000,Heineken Open New Zealand ATP World Tour 250,HARD,2,Alejandro Falla,Jose (Rubin) Statham,Alejandro Falla,6-4; 6-4,R32,74,2,1,36,58,27,36,9,22,1,3,10,36,58,1,2,39,57,21,39,11,18,3,7,10,32,57
2015-01-12 00:00:00.000,Heineken Open New Zealand ATP World Tour 250,HARD,2,Kenny De Schepper,Santiago Giraldo,Kenny De Schepper,6-2; 6-3,R32,78,4,0,46,64,28,46,12,18,7,8,9,40,64,0,3,39,59,23,39,6,20,6,10,8,29,59
2015-01-12 00:00:00.000,Heineken Open New Zealand ATP World Tour 250,HARD,2,Steve Johnson,Joao Sousa,Steve Johnson,7-5; 6-4,R32,89,7,2,35,64,27,35,17,29,1,2,11,44,64,6,1,57,85,39,57,10,28,4,7,11,49,85
2015-01-12 00:00:00.000,Heineken Open New Zealand ATP World Tour 250,HARD,2,Pablo Carreno Busta,Borna Coric,Pablo Carreno Busta,6-4; 6-3,R32,72,7,2,32,52,27,32,12,20,3,3,9,39,52,2,2,38,58,26,38,10,20,3,6,10,36,58
2015-01-12 00:00:00.000,Heineken Open New Zealand ATP World Tour 250,HARD,2,Jan-Lennard Struff,Dominic Thiem,Jan-Lennard Struff,6-7(6); 6-4; 6-3,R32,118,14,1,63,95,50,63,18,32,3,4,15,68,95,10,2,56,102,41,56,26,46,3,7,16,67,102
2015-01-12 00:00:00.000,Heineken Open New Zealand ATP World Tour 250,HARD,2,Kevin Anderson,N/A Bye,Kevin Anderson,,R32,0,0,0,0,0,0,0,0,0,0,0,0,0,0,0,0,0,0,0,0,0,0,0,0,0,0,0
2015-01-12 00:00:00.000,Heineken Open New Zealand ATP World Tour 250,HARD,2,Diego Schwartzman,Guillermo Garcia-Lopez,Diego Schwartzman,6-2; 4-6; 6-1,R32,100,3,4,38,65,24,38,12,27,2,7,12,36,65,7,6,42,82,27,42,7,40,7,16,13,34,82
2015-01-12 00:00:00.000,Heineken Open New Zealand ATP World Tour 250,HARD,2,Donald Young,Go Soeda,Donald Young,6-7(2); 6-1; 6-3,R32,97,9,2,48,79,40,48,19,31,0,0,14,59,79,4,1,42,86,30,42,26,44,8,12,14,56,86
2015-01-12 00:00:00.000,Heineken Open New Zealand ATP World Tour 250,HARD,2,Jiri Vesely,Thomaz Bellucci,Jiri Vesely,6-3; 7-6(4),R32,95,10,2,43,71,37,43,17,28,6,6,11,54,71,7,0,38,62,31,38,12,24,1,2,10,43,62
2015-01-12 00:00:00.000,Heineken Open New Zealand ATP World Tour 250,HARD,2,Ernests Gulbis,N/A Bye,Ernests Gulbis,,R32,0,0,0,0,0,0,0,0,0,0,0,0,0,0,0,0,0,0,0,0,0,0,0,0,0,0,0
2015-01-12 00:00:00.000,Heineken Open New Zealand ATP World Tour 250,HARD,2,Lucas Pouille,Michael Venus,Lucas Pouille,7-5; 6-4,R16,73,16,1,42,68,34,42,15,26,3,3,11,49,68,12,2,35,62,28,35,15,27,2,4,11,43,62
2015-01-12 00:00:00.000,Heineken Open New Zealand ATP World Tour 250,HARD,2,Albert Ramos-Vinolas,Yen-Hsun Lu,Albert Ramos-Vinolas,6-2; 6-4,R16,82,5,2,44,64,31,44,12,20,5,5,9,43,64,6,3,31,59,22,31,14,28,4,7,9,36,59
2015-01-12 00:00:00.000,Heineken Open New Zealand ATP World Tour 250,HARD,2,Adrian Mannarino,Roberto Bautista Agut,Adrian Mannarino,6-2; 2-1 RET,R16,40,2,0,10,24,9,10,11,14,0,0,5,20,24,1,2,23,35,12,23,5,12,3,6,6,17,35
2015-01-12 00:00:00.000,Heineken Open New Zealand ATP World Tour 250,HARD,2,Alejandro Falla,Kenny De Schepper,Alejandro Falla,6-2; 6-4,R16,71,3,2,41,60,28,41,12,19,3,3,9,40,60,4,3,39,53,23,39,7,14,3,6,9,30,53
2015-01-12 00:00:00.000,Heineken Open New Zealand ATP World Tour 250,HARD,2,Steve Johnson,Pablo Carreno Busta,Steve Johnson,6-7(3); 6-4; 6-1,R16,117,15,1,57,93,45,57,23,36,6,6,14,68,93,9,1,64,98,39,64,21,34,6,10,15,60,98
2015-01-12 00:00:00.000,Heineken Open New Zealand ATP World Tour 250,HARD,2,Kevin Anderson,Jan-Lennard Struff,Kevin Anderson,7-6(6); 6-1,R16,90,8,3,49,73,36,49,14,24,4,5,10,50,73,10,0,32,63,23,32,14,31,3,6,9,37,63
2015-01-12 00:00:00.000,Heineken Open New Zealand ATP World Tour 250,HARD,2,Donald Young,Diego Schwartzman,Donald Young,2-6; 6-4; 6-1,R16,86,9,4,45,76,30,45,20,31,1,3,13,50,76,2,2,47,73,29,47,16,26,1,4,12,45,73
2015-01-12 00:00:00.000,Heineken Open New Zealand ATP World Tour 250,HARD,2,Jiri Vesely,Ernests Gulbis,Jiri Vesely,6-2; 3-6; 6-1,R16,94,3,1,32,61,26,32,21,29,0,1,12,47,61,6,2,41,71,27,41,15,30,3,7,12,42,71
2015-01-12 00:00:00.000,Heineken Open New Zealand ATP World Tour 250,HARD,2,Lucas Pouille,Albert Ramos-Vinolas,Lucas Pouille,6-3; 6-2,Q,63,5,0,35,55,25,35,15,20,3,3,9,40,55,0,3,26,44,17,26,7,18,1,4,8,24,44
2015-01-12 00:00:00.000,Heineken Open New Zealand ATP World Tour 250,HARD,2,Adrian Mannarino,Alejandro Falla,Adrian Mannarino,6-3; 6-1,Q,56,4,5,26,44,21,26,9,18,2,3,8,30,44,1,1,27,43,14,27,4,16,5,10,8,18,43
2015-01-12 00:00:00.000,Heineken Open New Zealand ATP World Tour 250,HARD,2,Kevin Anderson,Steve Johnson,Kevin Anderson,6-4; 7-6(8),Q,97,14,2,38,61,34,38,15,23,1,2,11,49,61,10,2,60,90,42,60,16,30,7,9,11,58,90
2015-01-12 00:00:00.000,Heineken Open New Zealand ATP World Tour 250,HARD,2,Jiri Vesely,Donald Young,Jiri Vesely,6-2; 6-3,Q,61,9,1,31,44,25,31,9,13,3,3,8,34,44,2,5,31,54,20,31,9,23,5,9,9,29,54
2015-01-12 00:00:00.000,Heineken Open New Zealand ATP World Tour 250,HARD,2,Adrian Mannarino,Lucas Pouille,Adrian Mannarino,6-4; 3-6; 7-5,S,113,5,3,50,82,39,50,18,32,1,3,15,57,82,11,4,55,90,37,55,21,35,1,4,16,58,90
2015-01-12 00:00:00.000,Heineken Open New Zealand ATP World Tour 250,HARD,2,Jiri Vesely,Kevin Anderson,Jiri Vesely,6-4; 7-6(4),S,89,12,2,43,60,36,43,11,17,0,1,11,47,60,10,1,40,66,29,40,16,26,0,2,11,45,66
2015-01-12 00:00:00.000,Heineken Open New Zealand ATP World Tour 250,HARD,2,Jiri Vesely,Adrian Mannarino,Jiri Vesely,6-3; 6-2,F,67,11,2,31,48,24,31,10,17,2,3,9,34,48,1,4,28,48,17,28,7,20,3,7,8,24,48
2015-01-19 00:00:00.000,Australian Open Australia Grand Slams,HARD,3,Novak Djokovic,Aljaz Bedene,Novak Djokovic,6-3; 6-2; 6-4,R128,109,8,3,52,79,44,52,17,27,3,3,14,61,79,12,3,53,89,35,53,17,36,4,8,13,52,89
2015-01-19 00:00:00.000,Australian Open Australia Grand Slams,HARD,3,Andrey Kuznetsov,Albert Ramos-Vinolas,Andrey Kuznetsov,6-1; 3-6; 6-3; 7-6(3),R128,152,8,3,80,128,59,80,28,48,6,8,19,87,128,1,2,78,107,55,78,13,29,3,7,18,68,107
2015-01-19 00:00:00.000,Australian Open Australia Grand Slams,HARD,3,Go Soeda,Elias Ymer,Go Soeda,1-6; 6-4; 4-6; 6-3; 6-3,R128,207,5,4,79,142,53,79,33,63,9,14,22,86,142,5,6,87,155,61,87,30,68,6,12,23,91,155
2015-01-19 00:00:00.000,Australian Open Australia Grand Slams,HARD,3,Fernando Verdasco,James Ward,Fernando Verdasco,2-6; 6-0; 7-6(6); 6-3,R128,162,13,6,82,123,63,82,15,41,6,9,17,78,123,6,4,75,121,49,75,18,46,8,14,18,67,121
2015-01-19 00:00:00.000,Australian Open Australia Grand Slams,HARD,3,John Isner,Jimmy Wang,John Isner,7-6(5); 6-4; 6-4,R128,127,30,3,59,87,53,59,18,28,1,1,16,71,87,5,2,67,110,46,67,28,43,5,7,16,74,110
2015-01-19 00:00:00.000,Australian Open Australia Grand Slams,HARD,3,Andreas Haider-Maurer,Laurent Lokoli,Andreas Haider-Maurer,6-4; 7-5; 4-6; 6-3,R128,161,7,7,61,120,48,61,33,59,5,8,20,81,120,7,4,95,137,63,95,18,42,6,12,21,81,137
2015-01-19 00:00:00.000,Australian Open Australia Grand Slams,HARD,3,Gilles Muller,Pablo Carreno Busta,Gilles Muller,6-4; 7-6(5); 7-6(3),R128,143,29,3,70,113,62,70,21,43,9,9,17,83,113,7,1,85,121,63,85,18,36,7,8,17,81,121
2015-01-19 00:00:00.000,Australian Open Australia Grand Slams,HARD,3,Roberto Bautista Agut,Dominic Thiem,Roberto Bautista Agut,4-6; 6-2; 6-3; 7-6(5),R128,179,9,6,121,164,80,121,23,43,20,22,20,103,164,13,6,66,135,50,66,30,69,5,9,19,80,135
2015-01-19 00:00:00.000,Australian Open Australia Grand Slams,HARD,3,Feliciano Lopez,Denis Kudla,Feliciano Lopez,3-6; 6-2; 4-6; 6-2; 10-8,R128,194,26,6,86,150,69,86,33,64,4,8,26,102,150,12,8,110,180,71,110,38,70,15,22,27,109,180
2015-01-19 00:00:00.000,Australian Open Australia Grand Slams,HARD,3,Adrian Mannarino,Blaz Rola,Adrian Mannarino,7-6(7); 6-3; 6-2,R128,138,6,5,58,103,49,58,21,45,8,9,15,70,103,6,5,79,109,49,79,13,30,8,12,14,62,109
2015-01-19 00:00:00.000,Australian Open Australia Grand Slams,HARD,3,Jerzy Janowicz,Hiroki Moriya,Jerzy Janowicz,7-6(5); 2-6; 6-3; 7-5,R128,176,25,13,84,134,59,84,22,50,5,11,21,81,134,3,6,82,142,51,82,28,60,9,15,20,79,142
2015-01-19 00:00:00.000,Australian Open Australia Grand Slams,HARD,3,Gael Monfils,Lucas Pouille,Gael Monfils,6-7(3); 3-6; 6-4; 6-1; 6-4,R128,168,22,7,100,149,80,100,24,49,9,11,24,104,149,6,6,82,144,58,82,35,62,7,12,24,93,144
2015-01-19 00:00:00.000,Australian Open Australia Grand Slams,HARD,3,Benjamin Becker,Julien Benneteau,Benjamin Becker,7-5; 5-7; 6-2; 6-4,R128,164,17,2,70,119,53,70,33,49,3,5,21,86,119,14,1,74,117,54,74,24,43,3,8,21,78,117
2015-01-19 00:00:00.000,Australian Open Australia Grand Slams,HARD,3,Lleyton Hewitt,Ze Zhang,Lleyton Hewitt,6-3; 1-6; 6-0; 6-4,R128,140,8,4,57,90,40,57,19,33,4,8,16,59,90,8,5,76,119,48,76,14,43,12,19,16,62,119
2015-01-19 00:00:00.000,Australian Open Australia Grand Slams,HARD,3,Donald Young,Tim Puetz,Donald Young,6-4; 4-6; 6-3; 6-2,R128,133,7,5,60,101,48,60,25,41,4,6,19,73,101,12,8,71,121,54,71,19,50,9,14,18,73,121
2015-01-19 00:00:00.000,Australian Open Australia Grand Slams,HARD,3,Milos Raonic,Illya Marchenko,Milos Raonic,7-6(3); 7-6(3); 6-3,R128,126,28,3,69,92,63,69,14,23,1,1,17,77,92,5,7,51,96,42,51,25,45,1,2,16,67,96
2015-01-19 00:00:00.000,Australian Open Australia Grand Slams,HARD,3,Stan Wawrinka,Marsel Ilhan,Stan Wawrinka,6-1; 6-4; 6-2,R128,89,9,3,44,78,36,44,20,34,2,2,13,56,78,3,6,52,87,31,52,15,35,5,10,12,46,87
2015-01-19 00:00:00.000,Australian Open Australia Grand Slams,HARD,3,Marius Copil,Pablo Andujar,Marius Copil,6-2; 6-2; 7-5,R128,124,18,4,57,112,40,57,28,55,7,9,14,68,112,2,3,55,86,33,55,11,31,5,12,14,44,86
2015-01-19 00:00:00.000,Australian Open Australia Grand Slams,HARD,3,Jarkko Nieminen,Andrey Golubev,Jarkko Nieminen,6-1; 6-2; 7-6(6),R128,113,4,2,63,97,45,63,20,34,3,5,14,65,97,5,5,61,93,38,61,11,32,5,11,13,49,93
2015-01-19 00:00:00.000,Australian Open Australia Grand Slams,HARD,3,Matthias Bachinger,Pablo Cuevas,Matthias Bachinger,7-6(1); 6-3; 6-1,R128,100,8,3,58,91,44,58,19,33,2,3,14,63,91,8,5,63,100,41,63,13,37,5,10,14,54,100
2015-01-19 00:00:00.000,Australian Open Australia Grand Slams,HARD,3,Paolo Lorenzi,Alexandr Dolgopolov,Paolo Lorenzi,6-4; 6-3; 6-2,R128,87,5,0,50,74,37,50,19,24,0,0,14,56,74,13,3,36,73,27,36,17,37,5,9,13,44,73
2015-01-19 00:00:00.000,Australian Open Australia Grand Slams,HARD,3,Vasek Pospisil,Sam Querrey,Vasek Pospisil,6-3; 6-7(5); 2-6; 6-4; 6-4,R128,183,20,5,91,157,64,91,43,66,11,14,25,107,157,25,7,82,136,64,82,27,54,4,8,24,91,136
2015-01-19 00:00:00.000,Australian Open Australia Grand Slams,HARD,3,Guillermo Garcia-Lopez,Peter Gojowczyk,Guillermo Garcia-Lopez,6-7(1); 7-5; 6-4; 1-0 RET,R128,143,6,5,63,108,49,63,21,45,4,6,17,70,108,11,5,56,109,41,56,26,53,6,11,18,67,109
2015-01-19 00:00:00.000,Australian Open Australia Grand Slams,HARD,3,Alejandro Gonzalez,Fabio Fognini,Alejandro Gonzalez,4-6; 6-2; 6-3; 6-4,R128,145,2,3,60,116,46,60,33,56,7,9,19,79,116,3,10,67,112,49,67,19,45,6,11,18,68,112
2015-01-19 00:00:00.000,Australian Open Australia Grand Slams,HARD,3,David Ferrer,Thomaz Bellucci,David Ferrer,6-7(2); 6-2; 6-0; 6-3,R128,145,5,5,61,97,49,61,22,36,3,4,17,71,97,4,4,62,117,34,62,29,55,2,10,18,63,117
2015-01-19 00:00:00.000,Australian Open Australia Grand Slams,HARD,3,Sergiy Stakhovsky,Dusan Lajovic,Sergiy Stakhovsky,6-3; 4-6; 6-4; 6-7(3); 6-4,R128,211,14,6,103,178,79,103,36,75,13,16,25,115,178,4,0,107,171,72,107,34,64,9,15,26,106,171
2015-01-19 00:00:00.000,Australian Open Australia Grand Slams,HARD,3,Marcel Granollers,Stephane Robert,Marcel Granollers,6-3; 6-4; 6-4,R128,124,10,3,55,92,41,55,18,37,9,11,15,59,92,7,6,47,92,30,47,23,45,8,13,14,53,92
2015-01-19 00:00:00.000,Australian Open Australia Grand Slams,HARD,3,Gilles Simon,Robin Haase,Gilles Simon,6-1; 6-3; 6-4,R128,83,5,2,35,64,30,35,20,29,2,3,13,50,64,10,3,45,76,31,45,8,31,2,8,13,39,76
2015-01-19 00:00:00.000,Australian Open Australia Grand Slams,HARD,3,Santiago Giraldo,Jan Hernych,Santiago Giraldo,6-3; 6-2; 6-2,R128,87,5,2,53,72,43,53,11,19,2,3,13,54,72,4,1,44,69,23,44,10,25,6,12,12,33,69
2015-01-19 00:00:00.000,Australian Open Australia Grand Slams,HARD,3,Steve Johnson,Kyle Edmund,Steve Johnson,6-4; 6-4; 6-3,R128,110,17,4,58,92,45,58,20,34,1,1,14,65,92,5,4,58,105,35,58,27,47,6,10,15,62,105
2015-01-19 00:00:00.000,Australian Open Australia Grand Slams,HARD,3,Ivan Dodig,Joao Souza,Ivan Dodig,6-4; 7-5; 6-4,R128,172,10,7,73,111,52,73,17,38,9,12,16,69,111,7,5,72,123,46,72,22,51,5,11,16,68,123
2015-01-19 00:00:00.000,Australian Open Australia Grand Slams,HARD,3,Kei Nishikori,Nicolas Almagro,Kei Nishikori,6-4; 7-6(1); 6-2,R128,127,11,1,58,94,43,58,19,36,7,10,15,62,94,15,6,72,118,46,72,18,46,11,17,15,64,118
2015-01-19 00:00:00.000,Australian Open Australia Grand Slams,HARD,3,Tomas Berdych,Alejandro Falla,Tomas Berdych,6-3; 7-6(1); 6-3,R128,114,8,4,63,102,50,63,18,39,6,9,16,68,102,7,3,45,80,27,45,19,35,3,8,14,46,80
2015-01-19 00:00:00.000,Australian Open Australia Grand Slams,HARD,3,Jurgen Melzer,Victor Estrella Burgos,Jurgen Melzer,6-1; 6-4; 6-2,R128,87,10,9,47,80,38,47,17,33,4,5,13,55,80,1,1,44,73,24,44,12,29,3,9,12,36,73
2015-01-19 00:00:00.000,Australian Open Australia Grand Slams,HARD,3,Viktor Troicki,Jiri Vesely,Viktor Troicki,6-3; 3-6; 6-2; 6-3,R128,126,14,2,58,105,41,58,34,47,3,4,18,75,105,6,5,67,108,47,67,19,41,2,6,17,66,108
2015-01-19 00:00:00.000,Australian Open Australia Grand Slams,HARD,3,Leonardo Mayer,John Millman,Leonardo Mayer,6-3; 6-3; 6-2,R128,101,10,4,49,73,43,49,10,24,0,1,13,53,73,0,6,43,74,25,43,12,31,3,9,13,37,74
2015-01-19 00:00:00.000,Australian Open Australia Grand Slams,HARD,3,Philipp Kohlschreiber,Paul-Henri Mathieu,Philipp Kohlschreiber,6-2; 6-2; 6-1,R128,85,18,2,36,56,31,36,13,20,0,0,11,44,56,8,6,49,80,26,49,13,31,5,12,12,39,80
2015-01-19 00:00:00.000,Australian Open Australia Grand Slams,HARD,3,Bernard Tomic,Tobias Kamke,Bernard Tomic,7-5; 6-7(1); 6-3; 6-2,R128,169,24,1,94,137,70,94,21,43,7,9,21,91,137,3,2,67,119,47,67,25,52,4,10,20,72,119
2015-01-19 00:00:00.000,Australian Open Australia Grand Slams,HARD,3,Sam Groth,Filip Krajinovic,Sam Groth,6-3; 7-6(4); 6-4,R128,111,24,4,68,96,57,68,15,28,1,1,16,72,96,5,0,60,94,39,60,22,34,7,9,15,61,94
2015-01-19 00:00:00.000,Australian Open Australia Grand Slams,HARD,3,Thanasi Kokkinakis,Ernests Gulbis,Thanasi Kokkinakis,5-7; 6-0; 1-6; 7-6(2); 8-6,R128,247,16,11,100,177,70,100,32,77,14,21,26,102,177,29,18,82,159,66,82,31,77,6,13,25,97,159
2015-01-19 00:00:00.000,Australian Open Australia Grand Slams,HARD,3,Kevin Anderson,Diego Schwartzman,Kevin Anderson,7-6(5); 7-5; 5-7; 6-4,R128,215,32,9,112,165,86,112,21,53,10,14,23,107,165,8,2,89,170,61,89,45,81,13,18,23,106,170
2015-01-19 00:00:00.000,Australian Open Australia Grand Slams,HARD,3,Ricardas Berankis,Igor Sijsling,Ricardas Berankis,2-6; 6-4; 7-6(2); 6-7(6); 6-4,R128,198,7,4,108,173,81,108,33,65,9,14,26,114,173,14,6,106,176,76,106,39,70,9,14,26,115,176
2015-01-19 00:00:00.000,Australian Open Australia Grand Slams,HARD,3,James Duckworth,Blaz Kavcic,James Duckworth,6-2; 5-7; 7-6(7); 3-6; 6-2,R128,225,13,8,98,171,74,98,33,73,11,15,24,107,171,7,8,113,154,70,113,24,41,1,7,25,94,154
2015-01-19 00:00:00.000,Australian Open Australia Grand Slams,HARD,3,Richard Gasquet,Carlos Berlocq,Richard Gasquet,6-1; 6-3; 6-1,R128,113,5,2,46,71,37,46,15,25,1,1,12,52,71,3,3,47,86,26,47,15,39,5,11,11,41,86
2015-01-19 00:00:00.000,Australian Open Australia Grand Slams,HARD,3,Lukas Rosol,Kenny De Schepper,Lukas Rosol,4-6; 6-2; 6-7(4); 6-3; 6-4,R128,197,14,6,100,171,75,100,38,71,11,13,25,113,171,11,6,111,161,79,111,22,50,17,22,24,101,161
2015-01-19 00:00:00.000,Australian Open Australia Grand Slams,HARD,3,Dudi Sela,Jan-Lennard Struff,Dudi Sela,6-4; 4-6; 3-6; 6-3; 7-5,R128,208,3,6,102,172,64,102,34,70,11,18,25,98,172,11,6,83,161,60,83,32,78,9,17,25,92,161
2015-01-19 00:00:00.000,Australian Open Australia Grand Slams,HARD,3,Tim Smyczek,Luke Saville,Tim Smyczek,7-6(2); 7-5; 6-4,R128,139,6,3,61,97,44,61,23,36,4,7,17,67,97,5,4,74,119,46,74,23,45,8,13,17,69,119
2015-01-19 00:00:00.000,Australian Open Australia Grand Slams,HARD,3,Rafael Nadal,Mikhail Youzhny,Rafael Nadal,6-3; 6-2; 6-2,R128,110,4,3,35,57,31,35,18,22,1,1,12,49,57,5,5,47,85,28,47,15,38,5,11,13,43,85
2015-01-19 00:00:00.000,Australian Open Australia Grand Slams,HARD,3,Andy Murray,Yuki Bhambri,Andy Murray,6-3; 6-4; 7-6(3),R128,133,13,0,59,92,42,59,26,33,3,5,16,68,92,5,3,76,114,46,76,18,38,2,6,15,64,114
2015-01-19 00:00:00.000,Australian Open Australia Grand Slams,HARD,3,Marinko Matosevic,Alexander Kudryavtsev,Marinko Matosevic,6-4; 6-7(5); 4-6; 7-5; 6-3,R128,208,10,7,106,167,72,106,37,61,4,8,27,109,167,11,7,88,178,60,88,49,90,16,22,26,109,178
2015-01-19 00:00:00.000,Australian Open Australia Grand Slams,HARD,3,Joao Sousa,Jordan Thompson,Joao Sousa,6-4; 7-6(5); 6-4,R128,148,4,1,76,111,54,76,18,35,6,8,16,72,111,4,10,72,130,46,72,29,58,13,17,16,75,130
2015-01-19 00:00:00.000,Australian Open Australia Grand Slams,HARD,3,Martin Klizan,Tatsuma Ito,Martin Klizan,7-6(6); 6-2; 6-4,R128,129,5,1,60,93,45,60,19,33,5,7,15,64,93,3,6,58,108,40,58,21,50,5,10,15,61,108
2015-01-19 00:00:00.000,Australian Open Australia Grand Slams,HARD,3,David Goffin,Michael Russell,David Goffin,6-3; 6-3; 5-7; 6-0,R128,172,11,9,59,122,40,59,33,63,13,17,18,73,122,4,7,96,153,52,96,24,57,14,23,18,76,153
2015-01-19 00:00:00.000,Australian Open Australia Grand Slams,HARD,3,Marcos Baghdatis,Teymuraz Gabashvili,Marcos Baghdatis,6-2; 6-7(5); 3-6; 6-4; 6-4,R128,217,29,5,95,156,73,95,29,61,4,9,25,102,156,7,4,105,181,64,105,41,76,16,23,24,105,181
2015-01-19 00:00:00.000,Australian Open Australia Grand Slams,HARD,3,Lukas Lacko,Maximo Gonzalez,Lukas Lacko,4-6; 6-2; 7-5; 6-7(4); 6-1,R128,206,18,0,85,132,70,85,22,47,1,5,24,92,132,8,4,114,183,71,114,35,69,11,20,25,106,183
2015-01-19 00:00:00.000,Australian Open Australia Grand Slams,HARD,3,Grigor Dimitrov,Dustin Brown,Grigor Dimitrov,6-2; 6-3; 6-2,R128,69,11,1,41,61,36,41,16,20,0,0,13,52,61,2,7,47,70,30,47,7,23,6,11,12,37,70
2015-01-19 00:00:00.000,Australian Open Australia Grand Slams,HARD,3,Edouard Roger-Vasselin,Tommy Robredo,Edouard Roger-Vasselin,2-3 RET,R128,20,0,0,10,15,8,10,2,5,0,1,3,10,15,1,0,11,17,8,11,3,6,1,1,2,11,17
2015-01-19 00:00:00.000,Australian Open Australia Grand Slams,HARD,3,Malek Jaziri,Mikhail Kukushkin,Malek Jaziri,6-2; 6-3; 2-6; 7-6(3),R128,184,3,7,74,135,52,74,33,61,14,17,19,85,135,5,3,79,127,50,79,26,48,9,13,18,76,127
2015-01-19 00:00:00.000,Australian Open Australia Grand Slams,HARD,3,Nick Kyrgios,Federico Delbonis,Nick Kyrgios,7-6(2); 3-6; 6-3; 6-7(5); 6-3,R128,188,21,5,104,160,82,104,33,56,7,9,26,115,160,14,5,110,165,82,110,28,55,11,14,25,110,165
2015-01-19 00:00:00.000,Australian Open Australia Grand Slams,HARD,3,Ivo Karlovic,Ruben Bemelmans,Ivo Karlovic,6-4; 6-2; 6-4,R128,93,19,3,50,69,46,50,11,19,2,2,14,57,69,7,6,51,85,34,51,18,34,7,11,14,52,85
2015-01-19 00:00:00.000,Australian Open Australia Grand Slams,HARD,3,Jeremy Chardy,Borna Coric,Jeremy Chardy,3-6; 6-4; 7-5; 6-4,R128,164,15,2,82,125,64,82,22,43,4,6,21,86,125,9,1,70,111,49,70,25,41,3,6,20,74,111
2015-01-19 00:00:00.000,Australian Open Australia Grand Slams,HARD,3,Andreas Seppi,Denis Istomin,Andreas Seppi,5-7; 6-3; 2-6; 6-1; 6-4,R128,171,12,3,91,148,71,91,25,57,8,11,23,96,148,17,1,86,144,65,86,25,58,13,18,23,90,144
2015-01-19 00:00:00.000,Australian Open Australia Grand Slams,HARD,3,Simone Bolelli,Juan Monaco,Simone Bolelli,6-3; 3-6; 6-3; 6-1,R128,144,4,2,54,90,41,54,21,36,4,8,17,62,90,7,2,80,125,45,80,21,45,12,20,17,66,125
2015-01-19 00:00:00.000,Australian Open Australia Grand Slams,HARD,3,Roger Federer,Yen-Hsun Lu,Roger Federer,6-4; 6-2; 7-5,R128,113,9,3,56,83,48,56,17,27,4,4,15,65,83,1,2,57,97,35,57,22,40,10,14,15,57,97
2015-01-19 00:00:00.000,Australian Open Australia Grand Slams,HARD,3,Novak Djokovic,Andrey Kuznetsov,Novak Djokovic,6-0; 6-1; 6-4,R64,84,7,2,35,57,30,35,15,22,0,1,12,45,57,2,3,39,80,24,39,12,41,6,13,11,36,80
2015-01-19 00:00:00.000,Australian Open Australia Grand Slams,HARD,3,Fernando Verdasco,Go Soeda,Fernando Verdasco,6-3; 6-2; 7-6(3),R64,116,15,4,62,95,49,62,19,33,5,6,15,68,95,3,0,56,92,39,56,16,36,5,9,14,55,92
2015-01-19 00:00:00.000,Australian Open Australia Grand Slams,HARD,3,John Isner,Andreas Haider-Maurer,John Isner,6-4; 7-6(4); 4-6; 6-4,R64,142,27,3,69,100,63,69,23,31,1,2,21,86,100,21,8,83,128,62,83,27,45,3,5,21,89,128
2015-01-19 00:00:00.000,Australian Open Australia Grand Slams,HARD,3,Gilles Muller,Roberto Bautista Agut,Gilles Muller,7-6(5); 1-6; 7-5; 6-1,R64,153,27,6,77,121,63,77,21,44,6,8,19,84,121,15,3,69,107,56,69,23,38,3,6,19,79,107
2015-01-19 00:00:00.000,Australian Open Australia Grand Slams,HARD,3,Feliciano Lopez,Adrian Mannarino,Feliciano Lopez,4-6; 4-6; 7-6(3); 4-0 RET,R64,158,21,5,56,107,32,56,25,51,10,19,18,57,107,5,10,68,107,45,68,11,39,10,19,18,56,107
2015-01-19 00:00:00.000,Australian Open Australia Grand Slams,HARD,3,Jerzy Janowicz,Gael Monfils,Jerzy Janowicz,6-4; 1-6; 6-7(3); 6-3; 6-3,R64,187,14,9,99,143,72,99,18,44,7,11,23,90,143,20,4,103,154,79,103,19,51,11,17,24,98,154
2015-01-19 00:00:00.000,Australian Open Australia Grand Slams,HARD,3,Benjamin Becker,Lleyton Hewitt,Benjamin Becker,2-6; 1-6; 6-3; 6-4; 6-2,R64,182,16,2,77,122,55,77,21,45,5,10,21,76,122,14,4,66,125,44,66,34,59,6,11,21,78,125
2015-01-19 00:00:00.000,Australian Open Australia Grand Slams,HARD,3,Milos Raonic,Donald Young,Milos Raonic,6-4; 7-6(3); 6-3,R64,102,17,2,56,82,50,56,20,26,0,0,16,70,82,4,4,64,91,51,64,12,27,2,4,15,63,91
2015-01-19 00:00:00.000,Australian Open Australia Grand Slams,HARD,3,Stan Wawrinka,Marius Copil,Stan Wawrinka,7-6(4); 7-6(4); 6-3,R64,136,3,3,83,112,61,83,17,29,5,6,17,78,112,16,3,56,100,41,56,29,44,5,7,16,70,100
2015-01-19 00:00:00.000,Australian Open Australia Grand Slams,HARD,3,Jarkko Nieminen,Matthias Bachinger,Jarkko Nieminen,7-6(4); 7-5; 7-5,R64,140,5,1,89,120,63,89,16,31,10,13,18,79,120,12,7,75,120,54,75,18,45,11,16,18,72,120
2015-01-19 00:00:00.000,Australian Open Australia Grand Slams,HARD,3,Vasek Pospisil,Paolo Lorenzi,Vasek Pospisil,6-7(3); 7-6(4); 6-3; 6-4,R64,215,22,7,84,160,65,84,41,76,4,6,22,106,160,11,4,73,135,57,73,32,62,6,10,21,89,135
2015-01-19 00:00:00.000,Australian Open Australia Grand Slams,HARD,3,Guillermo Garcia-Lopez,Alejandro Gonzalez,Guillermo Garcia-Lopez,6-1; 6-3; 6-3,R64,113,7,5,44,83,33,44,23,39,3,4,13,56,83,5,4,43,76,26,43,9,33,4,10,12,35,76
2015-01-19 00:00:00.000,Australian Open Australia Grand Slams,HARD,3,David Ferrer,Sergiy Stakhovsky,David Ferrer,5-7; 6-3; 6-4; 6-2,R64,135,2,4,74,104,56,74,20,30,3,5,20,76,104,13,5,77,117,50,77,21,40,8,13,19,71,117
2015-01-19 00:00:00.000,Australian Open Australia Grand Slams,HARD,3,Gilles Simon,Marcel Granollers,Gilles Simon,7-6(5); 6-2; 6-4,R64,136,5,2,59,87,49,59,13,28,0,2,15,62,87,6,2,54,95,36,54,22,41,5,10,15,58,95
2015-01-19 00:00:00.000,Australian Open Australia Grand Slams,HARD,3,Steve Johnson,Santiago Giraldo,Steve Johnson,6-3; 6-4; 6-2,R64,118,17,2,54,109,45,54,24,55,8,9,14,69,109,3,3,59,90,37,59,12,31,6,11,13,49,90
2015-01-19 00:00:00.000,Australian Open Australia Grand Slams,HARD,3,Kei Nishikori,Ivan Dodig,Kei Nishikori,4-6; 7-5; 6-2; 7-6(0),R64,167,7,3,79,122,60,79,24,43,2,5,21,84,122,15,2,73,116,57,73,14,43,2,7,21,71,116
2015-01-19 00:00:00.000,Australian Open Australia Grand Slams,HARD,3,Tomas Berdych,Jurgen Melzer,Tomas Berdych,7-6(0); 6-2; 6-2,R64,123,9,2,46,84,38,46,18,38,3,5,14,56,84,5,4,59,96,34,59,16,37,4,10,14,50,96
2015-01-19 00:00:00.000,Australian Open Australia Grand Slams,HARD,3,Viktor Troicki,Leonardo Mayer,Viktor Troicki,6-4; 4-6; 6-4; 6-0,R64,148,11,1,77,112,63,77,12,35,6,8,18,75,112,6,3,68,111,40,68,26,43,8,14,18,66,111
2015-01-19 00:00:00.000,Australian Open Australia Grand Slams,HARD,3,Bernard Tomic,Philipp Kohlschreiber,Bernard Tomic,6-7(5); 6-4; 7-6(6); 7-6(5),R64,185,24,2,127,165,99,127,18,38,5,6,23,117,165,19,3,104,150,79,104,30,46,6,8,23,109,150
2015-01-19 00:00:00.000,Australian Open Australia Grand Slams,HARD,3,Sam Groth,Thanasi Kokkinakis,Sam Groth,3-6; 6-3; 7-5; 3-6; 6-1,R64,173,26,3,85,127,66,85,26,42,2,4,23,92,127,14,4,78,124,63,78,20,46,4,8,23,83,124
2015-01-19 00:00:00.000,Australian Open Australia Grand Slams,HARD,3,Kevin Anderson,Ricardas Berankis,Kevin Anderson,6-2; 6-2; 7-6(3),R64,107,14,1,51,75,42,51,19,24,0,0,14,61,75,4,6,47,95,31,47,22,48,3,7,14,53,95
2015-01-19 00:00:00.000,Australian Open Australia Grand Slams,HARD,3,Richard Gasquet,James Duckworth,Richard Gasquet,6-2; 6-3; 7-5,R64,116,23,1,58,87,47,58,18,29,3,3,15,65,87,14,5,70,106,47,70,16,36,12,16,14,63,106
2015-01-19 00:00:00.000,Australian Open Australia Grand Slams,HARD,3,Dudi Sela,Lukas Rosol,Dudi Sela,7-6(2); 5-7; 7-5; 6-3,R64,178,12,4,87,143,61,87,33,56,9,12,22,94,143,17,5,74,137,57,74,29,63,10,15,23,86,137
2015-01-19 00:00:00.000,Australian Open Australia Grand Slams,HARD,3,Rafael Nadal,Tim Smyczek,Rafael Nadal,6-2; 3-6; 6-7(2); 6-3; 7-5,R64,252,3,7,98,154,68,98,29,56,2,7,26,97,154,15,1,102,156,66,102,29,54,9,16,24,95,156
2015-01-19 00:00:00.000,Australian Open Australia Grand Slams,HARD,3,Andy Murray,Marinko Matosevic,Andy Murray,6-1; 6-3; 6-2,R64,102,5,2,39,63,33,39,14,24,1,2,12,47,63,3,6,43,83,26,43,14,40,7,14,12,40,83
2015-01-19 00:00:00.000,Australian Open Australia Grand Slams,HARD,3,Joao Sousa,Martin Klizan,Joao Sousa,4-6; 7-6(4); 6-4; 1-0 RET,R64,151,8,1,68,98,49,68,16,30,7,10,16,65,98,11,9,71,128,49,71,28,57,13,17,17,77,128
2015-01-19 00:00:00.000,Australian Open Australia Grand Slams,HARD,3,Marcos Baghdatis,David Goffin,Marcos Baghdatis,6-1; 6-4; 4-6; 6-0,R64,152,16,4,75,130,54,75,24,55,5,9,17,78,130,5,10,47,99,27,47,16,52,7,16,16,43,99
2015-01-19 00:00:00.000,Australian Open Australia Grand Slams,HARD,3,Grigor Dimitrov,Lukas Lacko,Grigor Dimitrov,6-3; 6-7(10); 6-3; 6-3,R64,169,14,4,66,118,57,66,28,52,4,7,20,85,118,8,2,92,148,55,92,28,56,13,20,19,83,148
2015-01-19 00:00:00.000,Australian Open Australia Grand Slams,HARD,3,Malek Jaziri,Edouard Roger-Vasselin,Malek Jaziri,1-6; 6-3; 6-4; 1-6; 6-3,R64,176,10,3,71,141,51,71,35,70,12,17,21,86,141,17,5,85,119,65,85,16,34,6,10,21,81,119
2015-01-19 00:00:00.000,Australian Open Australia Grand Slams,HARD,3,Nick Kyrgios,Ivo Karlovic,Nick Kyrgios,7-6(4); 6-4; 5-7; 6-4,R64,140,24,4,77,119,60,77,31,42,1,2,22,91,119,39,6,74,110,65,74,23,36,4,6,22,88,110
2015-01-19 00:00:00.000,Australian Open Australia Grand Slams,HARD,3,Andreas Seppi,Jeremy Chardy,Andreas Seppi,7-5; 3-6; 6-2; 6-1,R64,152,8,1,75,116,57,75,22,41,4,6,18,79,116,17,10,76,129,56,76,16,53,9,15,18,72,129
2015-01-19 00:00:00.000,Australian Open Australia Grand Slams,HARD,3,Roger Federer,Simone Bolelli,Roger Federer,3-6; 6-3; 6-2; 6-2,R64,129,16,0,64,92,50,64,20,28,0,1,17,70,92,8,3,57,109,36,57,28,52,6,11,17,64,109
2015-01-19 00:00:00.000,Australian Open Australia Grand Slams,HARD,3,Novak Djokovic,Fernando Verdasco,Novak Djokovic,7-6(8); 6-3; 6-4,R32,141,11,0,66,91,54,66,17,25,3,3,16,71,91,16,5,76,123,58,76,17,47,12,14,15,75,123
2015-01-19 00:00:00.000,Australian Open Australia Grand Slams,HARD,3,Gilles Muller,John Isner,Gilles Muller,7-6(4); 7-6(6); 6-4,R32,133,23,3,59,97,53,59,28,38,1,1,17,81,97,30,2,87,113,69,87,13,26,5,6,17,82,113
2015-01-19 00:00:00.000,Australian Open Australia Grand Slams,HARD,3,Feliciano Lopez,Jerzy Janowicz,Feliciano Lopez,7-6(6); 6-4; 7-6(3),R32,153,19,4,64,123,51,64,35,59,10,11,17,86,123,11,5,73,115,54,73,20,42,6,8,17,74,115
2015-01-19 00:00:00.000,Australian Open Australia Grand Slams,HARD,3,Milos Raonic,Benjamin Becker,Milos Raonic,6-4; 6-3; 6-3,R32,101,22,5,52,73,43,52,11,21,2,3,14,54,73,7,2,65,92,40,65,13,27,9,14,14,53,92
2015-01-19 00:00:00.000,Australian Open Australia Grand Slams,HARD,3,Stan Wawrinka,Jarkko Nieminen,Stan Wawrinka,6-4; 6-2; 6-4,R32,109,9,2,42,78,38,42,17,36,1,3,14,55,78,4,5,69,103,38,69,16,34,10,16,14,54,103
2015-01-19 00:00:00.000,Australian Open Australia Grand Slams,HARD,3,Guillermo Garcia-Lopez,Vasek Pospisil,Guillermo Garcia-Lopez,6-2; 6-4; 6-4,R32,120,3,4,38,92,27,38,35,54,5,6,14,62,92,7,3,47,75,32,47,11,28,3,8,14,43,75
2015-01-19 00:00:00.000,Australian Open Australia Grand Slams,HARD,3,David Ferrer,Gilles Simon,David Ferrer,6-2; 7-5; 5-7; 7-6(4),R32,217,4,5,88,138,55,88,24,50,5,12,22,79,138,3,4,86,147,50,86,28,61,7,16,22,78,147
2015-01-19 00:00:00.000,Australian Open Australia Grand Slams,HARD,3,Kei Nishikori,Steve Johnson,Kei Nishikori,6-7(7); 6-1; 6-2; 6-3,R32,149,15,5,78,120,58,78,25,42,6,7,18,83,120,8,8,73,122,51,73,17,49,3,10,18,68,122
2015-01-19 00:00:00.000,Australian Open Australia Grand Slams,HARD,3,Tomas Berdych,Viktor Troicki,Tomas Berdych,6-4; 6-3; 6-4,R32,111,20,0,44,77,39,44,22,33,0,0,15,61,77,11,5,72,100,50,72,8,28,9,12,14,58,100
2015-01-19 00:00:00.000,Australian Open Australia Grand Slams,HARD,3,Bernard Tomic,Sam Groth,Bernard Tomic,6-4; 7-6(8); 6-3,R32,103,9,2,68,91,56,68,14,23,0,0,16,70,91,16,6,60,92,49,60,13,32,2,4,15,62,92
2015-01-19 00:00:00.000,Australian Open Australia Grand Slams,HARD,3,Kevin Anderson,Richard Gasquet,Kevin Anderson,6-4; 7-6(3); 7-6(6),R32,144,18,3,73,106,61,73,18,33,5,6,17,79,106,5,4,59,104,47,59,24,45,0,2,17,71,104
2015-01-19 00:00:00.000,Australian Open Australia Grand Slams,HARD,3,Rafael Nadal,Dudi Sela,Rafael Nadal,6-1; 6-0; 7-5,R32,124,4,0,51,75,39,51,15,24,7,7,12,54,75,2,1,51,86,30,51,13,35,11,18,13,43,86
2015-01-19 00:00:00.000,Australian Open Australia Grand Slams,HARD,3,Andy Murray,Joao Sousa,Andy Murray,6-1; 6-1; 7-5,R32,126,9,3,42,74,34,42,20,32,1,2,13,54,74,0,3,55,96,30,55,19,41,7,14,13,49,96
2015-01-19 00:00:00.000,Australian Open Australia Grand Slams,HARD,3,Grigor Dimitrov,Marcos Baghdatis,Grigor Dimitrov,4-6; 6-3; 3-6; 6-3; 6-3,R32,208,6,9,98,155,73,98,29,57,8,10,23,102,155,16,10,92,154,60,92,36,62,14,18,23,96,154
2015-01-19 00:00:00.000,Australian Open Australia Grand Slams,HARD,3,Nick Kyrgios,Malek Jaziri,Nick Kyrgios,6-3; 7-6(6); 6-1,R32,118,27,2,72,101,58,72,14,29,3,3,15,72,101,6,2,47,90,34,47,21,43,5,8,13,55,90
2015-01-19 00:00:00.000,Australian Open Australia Grand Slams,HARD,3,Andreas Seppi,Roger Federer,Andreas Seppi,6-4; 7-6(5); 4-6; 7-6(5),R32,177,4,4,86,151,67,86,32,65,7,10,22,99,151,15,9,82,138,66,82,27,56,2,5,22,93,138
2015-01-19 00:00:00.000,Australian Open Australia Grand Slams,HARD,3,Novak Djokovic,Gilles Muller,Novak Djokovic,6-4; 7-5; 7-5,R16,128,13,4,65,92,53,65,18,27,4,4,17,71,92,8,0,65,105,47,65,21,40,8,11,17,68,105
2015-01-19 00:00:00.000,Australian Open Australia Grand Slams,HARD,3,Milos Raonic,Feliciano Lopez,Milos Raonic,6-4; 4-6; 6-3; 6-7(7); 6-3,R16,185,30,3,107,144,85,107,22,37,2,3,26,107,144,21,5,107,169,78,107,32,62,10,13,24,110,169
2015-01-19 00:00:00.000,Australian Open Australia Grand Slams,HARD,3,Stan Wawrinka,Guillermo Garcia-Lopez,Stan Wawrinka,7-6(2); 6-4; 4-6; 7-6(8),R16,182,16,3,86,134,66,86,24,48,5,9,22,90,134,5,4,86,142,60,86,29,56,9,13,22,89,142
2015-01-19 00:00:00.000,Australian Open Australia Grand Slams,HARD,3,Kei Nishikori,David Ferrer,Kei Nishikori,6-3; 6-3; 6-3,R16,127,7,3,54,96,38,54,25,42,5,6,13,63,96,2,5,70,108,39,70,16,38,11,17,14,55,108
2015-01-19 00:00:00.000,Australian Open Australia Grand Slams,HARD,3,Tomas Berdych,Bernard Tomic,Tomas Berdych,6-2; 7-6(3); 6-2,R16,121,17,4,46,88,39,46,25,42,1,1,14,64,88,6,2,69,105,50,69,12,36,9,13,14,62,105
2015-01-19 00:00:00.000,Australian Open Australia Grand Slams,HARD,3,Rafael Nadal,Kevin Anderson,Rafael Nadal,7-5; 6-1; 6-4,R16,126,3,3,59,88,46,59,19,29,6,6,15,65,88,8,3,53,73,36,53,13,20,2,6,14,49,73
2015-01-19 00:00:00.000,Australian Open Australia Grand Slams,HARD,3,Andy Murray,Grigor Dimitrov,Andy Murray,6-4; 6-7(5); 6-3; 7-5,R16,212,12,4,91,136,70,91,18,45,4,8,22,88,136,4,3,108,153,73,108,14,45,12,19,21,87,153
2015-01-19 00:00:00.000,Australian Open Australia Grand Slams,HARD,3,Nick Kyrgios,Andreas Seppi,Nick Kyrgios,5-7; 4-6; 6-3; 7-6(5); 8-6,R16,214,25,7,116,187,87,116,37,71,9,12,29,124,187,23,4,115,178,85,115,33,63,6,9,28,118,178
2015-01-19 00:00:00.000,Australian Open Australia Grand Slams,HARD,3,Novak Djokovic,Milos Raonic,Novak Djokovic,7-6(5); 6-4; 6-2,Q,120,8,2,54,78,48,54,18,24,0,0,15,66,78,17,2,67,99,48,67,17,32,8,11,15,65,99
2015-01-19 00:00:00.000,Australian Open Australia Grand Slams,HARD,3,Stan Wawrinka,Kei Nishikori,Stan Wawrinka,6-3; 6-4; 7-6(6),Q,124,21,4,56,91,48,56,19,35,3,4,16,67,91,6,2,58,94,43,58,18,36,8,11,15,61,94
2015-01-19 00:00:00.000,Australian Open Australia Grand Slams,HARD,3,Tomas Berdych,Rafael Nadal,Tomas Berdych,6-2; 6-0; 7-6(5),Q,133,11,0,58,87,48,58,13,29,4,4,13,61,87,3,6,61,82,39,61,6,21,5,10,13,45,82
2015-01-19 00:00:00.000,Australian Open Australia Grand Slams,HARD,3,Andy Murray,Nick Kyrgios,Andy Murray,6-3; 7-6(5); 6-3,Q,125,12,1,60,87,48,60,18,27,1,2,16,66,87,9,3,69,110,45,69,21,41,6,9,14,66,110
2015-01-19 00:00:00.000,Australian Open Australia Grand Slams,HARD,3,Novak Djokovic,Stan Wawrinka,Novak Djokovic,7-6(1); 3-6; 6-4; 4-6; 6-0,S,210,5,3,88,135,61,88,28,47,3,8,23,89,135,10,4,94,158,60,94,33,64,10,17,24,93,158
2015-01-19 00:00:00.000,Australian Open Australia Grand Slams,HARD,3,Andy Murray,Tomas Berdych,Andy Murray,6-7(6); 6-0; 6-3; 7-5,S,206,16,2,85,130,64,85,24,45,2,3,20,88,130,6,6,75,127,50,75,26,52,4,10,19,76,127
2015-01-19 00:00:00.000,Australian Open Australia Grand Slams,HARD,3,Novak Djokovic,Andy Murray,Novak Djokovic,7-6(5); 6-7(4); 6-3; 6-0,F,219,9,1,81,136,48,81,34,55,7,12,20,82,136,10,3,77,118,50,77,14,41,7,16,19,64,118
2015-02-02 00:00:00.000,Open Sud de France France ATP World Tour 250,HARD,2,Gael Monfils,N/A Bye,Gael Monfils,,R32,0,0,0,0,0,0,0,0,0,0,0,0,0,0,0,0,0,0,0,0,0,0,0,0,0,0,0
2015-02-02 00:00:00.000,Open Sud de France France ATP World Tour 250,HARD,2,Kenny De Schepper,Marsel Ilhan,Kenny De Schepper,6-4; 3-6; 6-3,R32,90,10,0,56,72,42,56,12,16,1,2,14,54,72,5,1,46,70,37,46,15,24,2,4,14,52,70
2015-02-02 00:00:00.000,Open Sud de France France ATP World Tour 250,HARD,2,Steve Darcis,Tatsuma Ito,Steve Darcis,6-2; 6-2,R32,60,3,0,38,54,29,38,8,16,4,4,8,37,54,1,0,28,43,18,28,3,15,4,8,8,21,43
2015-02-02 00:00:00.000,Open Sud de France France ATP World Tour 250,HARD,2,Jarkko Nieminen,Jan-Lennard Struff,Jarkko Nieminen,7-6(5); 6-3,R32,77,1,1,54,77,37,54,12,23,4,6,11,49,77,5,4,34,60,26,34,11,26,1,4,10,37,60
2015-02-02 00:00:00.000,Open Sud de France France ATP World Tour 250,HARD,2,Richard Gasquet,N/A Bye,Richard Gasquet,,R32,0,0,0,0,0,0,0,0,0,0,0,0,0,0,0,0,0,0,0,0,0,0,0,0,0,0,0
2015-02-02 00:00:00.000,Open Sud de France France ATP World Tour 250,HARD,2,Lucas Pouille,Alexander Kudryavtsev,Lucas Pouille,6-4; 7-6(4),R32,92,4,3,39,76,30,39,19,37,3,5,11,49,76,6,0,42,81,32,42,15,39,6,9,11,47,81
2015-02-02 00:00:00.000,Open Sud de France France ATP World Tour 250,HARD,2,Dudi Sela,Jurgen Zopp,Dudi Sela,6-3; 6-4,R32,67,5,1,38,61,27,38,17,23,0,0,10,44,61,3,3,34,57,23,34,11,23,4,6,9,34,57
2015-02-02 00:00:00.000,Open Sud de France France ATP World Tour 250,HARD,2,Denis Istomin,Malek Jaziri,Denis Istomin,3-6 RET,R32,38,5,1,20,29,13,20,4,9,1,3,5,17,29,2,1,19,33,12,19,9,14,1,1,4,21,33
2015-02-02 00:00:00.000,Open Sud de France France ATP World Tour 250,HARD,2,Joao Sousa,Laurent Lokoli,Joao Sousa,6-2; 6-4,R32,68,4,2,31,55,26,31,15,24,3,3,9,41,55,7,3,41,61,26,41,9,20,7,10,9,35,61
2015-02-02 00:00:00.000,Open Sud de France France ATP World Tour 250,HARD,2,Tobias Kamke,Vincent Millot,Tobias Kamke,2-6; 6-3; 7-5,R32,132,0,2,61,99,35,61,19,38,4,10,15,54,99,0,0,46,81,31,46,14,35,3,9,14,45,81
2015-02-02 00:00:00.000,Open Sud de France France ATP World Tour 250,HARD,2,Paul-Henri Mathieu,Taro Daniel,Paul-Henri Mathieu,6-3; 6-7(5); 6-1,R32,119,9,1,54,93,43,54,25,39,3,4,15,68,93,9,3,48,80,34,48,16,32,4,8,13,50,80
2015-02-02 00:00:00.000,Open Sud de France France ATP World Tour 250,HARD,2,Philipp Kohlschreiber,N/A Bye,Philipp Kohlschreiber,,R32,0,0,0,0,0,0,0,0,0,0,0,0,0,0,0,0,0,0,0,0,0,0,0,0,0,0,0
2015-02-02 00:00:00.000,Open Sud de France France ATP World Tour 250,HARD,2,Jerzy Janowicz,Dustin Brown,Jerzy Janowicz,2-6; 7-6(1); 7-5,R32,107,14,5,69,101,51,69,15,32,5,8,16,66,101,9,7,63,101,49,63,17,38,5,7,16,66,101
2015-02-02 00:00:00.000,Open Sud de France France ATP World Tour 250,HARD,2,Benoit Paire,Nikoloz Basilashvili,Benoit Paire,5-7; 6-2; 6-4,R32,98,5,2,44,90,33,44,23,46,4,8,15,56,90,3,4,63,95,38,63,14,32,6,12,15,52,95
2015-02-02 00:00:00.000,Open Sud de France France ATP World Tour 250,HARD,2,Edouard Roger-Vasselin,Andreas Beck,Edouard Roger-Vasselin,3-6; 6-3; 6-4,R32,97,14,1,42,75,34,42,20,33,3,5,14,54,75,7,4,41,73,29,41,21,32,0,3,14,50,73
2015-02-02 00:00:00.000,Open Sud de France France ATP World Tour 250,HARD,2,Gilles Simon,N/A Bye,Gilles Simon,,R32,0,0,0,0,0,0,0,0,0,0,0,0,0,0,0,0,0,0,0,0,0,0,0,0,0,0,0
2015-02-02 00:00:00.000,Open Sud de France France ATP World Tour 250,HARD,2,Gael Monfils,Kenny De Schepper,Gael Monfils,6-4; 7-6(3),R16,95,6,3,48,71,39,48,13,23,3,3,11,52,71,8,3,58,81,43,58,8,23,4,5,11,51,81
2015-02-02 00:00:00.000,Open Sud de France France ATP World Tour 250,HARD,2,Steve Darcis,Jarkko Nieminen,Steve Darcis,6-2; 7-6(3),R16,84,8,1,43,77,31,43,19,34,7,8,10,50,77,3,0,44,62,28,44,9,18,3,6,10,37,62
2015-02-02 00:00:00.000,Open Sud de France France ATP World Tour 250,HARD,2,Richard Gasquet,Lucas Pouille,Richard Gasquet,6-3; 7-6(6),R16,103,4,1,38,62,32,38,15,24,0,1,11,47,62,7,1,50,94,32,50,23,44,10,12,10,55,94
2015-02-02 00:00:00.000,Open Sud de France France ATP World Tour 250,HARD,2,Denis Istomin,Dudi Sela,Denis Istomin,7-6(1); 6-2,R16,84,6,1,53,79,40,53,12,26,3,4,10,52,79,2,2,38,71,25,38,16,33,6,9,10,41,71
2015-02-02 00:00:00.000,Open Sud de France France ATP World Tour 250,HARD,2,Joao Sousa,Tobias Kamke,Joao Sousa,4-6; 6-4; 6-3,R16,119,5,0,61,85,45,61,11,24,6,9,14,56,85,4,3,59,94,34,59,20,35,4,9,15,54,94
2015-02-02 00:00:00.000,Open Sud de France France ATP World Tour 250,HARD,2,Philipp Kohlschreiber,Paul-Henri Mathieu,Philipp Kohlschreiber,3-6; 7-6(5); 6-4,R16,128,19,0,56,104,45,56,27,48,11,13,15,72,104,6,3,65,102,46,65,21,37,6,8,16,67,102
2015-02-02 00:00:00.000,Open Sud de France France ATP World Tour 250,HARD,2,Jerzy Janowicz,Benoit Paire,Jerzy Janowicz,6-2; 3-6; 6-3,R16,94,17,3,55,79,40,55,12,24,2,4,13,52,79,8,5,44,83,31,44,15,39,5,9,13,46,83
2015-02-02 00:00:00.000,Open Sud de France France ATP World Tour 250,HARD,2,Gilles Simon,Edouard Roger-Vasselin,Gilles Simon,6-3; 6-3,R16,78,4,2,29,52,18,29,15,23,3,5,9,33,52,1,3,46,71,26,46,8,25,3,8,9,34,71
2015-02-02 00:00:00.000,Open Sud de France France ATP World Tour 250,HARD,2,Gael Monfils,Steve Darcis,Gael Monfils,4-6; 6-2; 6-3,Q,105,10,2,57,92,41,57,21,35,3,4,14,62,92,0,2,59,84,39,59,12,25,5,8,13,51,84
2015-02-02 00:00:00.000,Open Sud de France France ATP World Tour 250,HARD,2,Richard Gasquet,Denis Istomin,Richard Gasquet,6-3; 6-4,Q,62,7,0,29,52,25,29,15,23,0,0,10,40,52,3,0,30,45,24,30,7,15,0,2,9,31,45
2015-02-02 00:00:00.000,Open Sud de France France ATP World Tour 250,HARD,2,Joao Sousa,Philipp Kohlschreiber,Joao Sousa,7-6(5); 6-4,Q,94,7,3,47,81,34,47,17,34,8,10,11,51,81,4,0,38,76,25,38,21,38,6,9,11,46,76
2015-02-02 00:00:00.000,Open Sud de France France ATP World Tour 250,HARD,2,Jerzy Janowicz,Gilles Simon,Jerzy Janowicz,6-2; 7-5,Q,76,6,3,43,64,34,43,9,21,3,4,10,43,64,2,0,30,52,17,30,11,22,1,5,10,28,52
2015-02-02 00:00:00.000,Open Sud de France France ATP World Tour 250,HARD,2,Richard Gasquet,Gael Monfils,Richard Gasquet,6-4; 6-3,S,79,1,0,40,65,30,40,13,25,7,8,10,43,65,10,0,27,48,19,27,12,21,2,5,9,31,48
2015-02-02 00:00:00.000,Open Sud de France France ATP World Tour 250,HARD,2,Jerzy Janowicz,Joao Sousa,Jerzy Janowicz,7-6(9); 3-6; 6-1,S,113,14,3,61,91,44,61,16,30,2,5,14,60,91,5,2,51,88,37,51,20,37,3,7,14,57,88
2015-02-02 00:00:00.000,Open Sud de France France ATP World Tour 250,HARD,2,Richard Gasquet,Jerzy Janowicz,Richard Gasquet,3-0 RET,F,8,5,0,7,8,7,7,1,1,0,0,2,8,8,0,0,4,6,0,4,0,2,0,1,1,0,6
2015-02-02 00:00:00.000,Ecuador Open Quito Ecuador ATP World Tour 250,CLAY,2,Feliciano Lopez,N/A Bye,Feliciano Lopez,,R32,0,0,0,0,0,0,0,0,0,0,0,0,0,0,0,0,0,0,0,0,0,0,0,0,0,0,0
2015-02-02 00:00:00.000,Ecuador Open Quito Ecuador ATP World Tour 250,CLAY,2,Alejandro Gonzalez,Facundo Bagnis,Alejandro Gonzalez,6-2; 6-4,R32,75,3,6,30,56,23,30,15,26,1,2,9,38,56,7,3,35,60,23,35,10,25,4,8,9,33,60
2015-02-02 00:00:00.000,Ecuador Open Quito Ecuador ATP World Tour 250,CLAY,2,Nicolas Jarry,Gonzalo Escobar,Nicolas Jarry,2-6; 6-4; 6-3,R32,117,19,4,61,98,43,61,21,37,7,9,14,64,98,0,4,58,84,39,58,16,26,2,4,13,55,84
2015-02-02 00:00:00.000,Ecuador Open Quito Ecuador ATP World Tour 250,CLAY,2,Dusan Lajovic,Luca Vanni,Dusan Lajovic,7-6(3); 6-4,R32,102,6,2,46,67,33,46,12,21,3,5,11,45,67,10,6,38,83,28,38,20,45,9,12,11,48,83
2015-02-02 00:00:00.000,Ecuador Open Quito Ecuador ATP World Tour 250,CLAY,2,Fernando Verdasco,N/A Bye,Fernando Verdasco,,R32,0,0,0,0,0,0,0,0,0,0,0,0,0,0,0,0,0,0,0,0,0,0,0,0,0,0,0
2015-02-02 00:00:00.000,Ecuador Open Quito Ecuador ATP World Tour 250,CLAY,2,Gerald Melzer,Andreas Haider-Maurer,Gerald Melzer,1-6; 7-6(1); 7-6(6),R32,143,8,4,67,108,50,67,15,41,12,17,15,65,108,11,19,63,114,51,63,21,51,10,13,16,72,114
2015-02-02 00:00:00.000,Ecuador Open Quito Ecuador ATP World Tour 250,CLAY,2,Alejandro Falla,Joao Souza,Alejandro Falla,6-7(3); 6-1; 6-4,R32,147,4,10,56,111,40,56,27,55,3,6,15,67,111,5,12,42,90,27,42,21,48,6,12,14,48,90
2015-02-02 00:00:00.000,Ecuador Open Quito Ecuador ATP World Tour 250,CLAY,2,Paolo Lorenzi,Adrian Menendez-Maceiras,Paolo Lorenzi,4-6; 6-4; 7-6(1),R32,139,3,4,50,92,39,50,24,42,1,3,16,63,92,6,4,54,100,40,54,27,46,4,6,16,67,100
2015-02-02 00:00:00.000,Ecuador Open Quito Ecuador ATP World Tour 250,CLAY,2,Victor Estrella Burgos,Andre Ghem,Victor Estrella Burgos,6-4; 6-4,R32,69,2,0,34,55,26,34,13,21,0,1,10,39,55,2,2,32,53,26,32,8,21,2,5,10,34,53
2015-02-02 00:00:00.000,Ecuador Open Quito Ecuador ATP World Tour 250,CLAY,2,Renzo Olivo,Evgeny Donskoy,Renzo Olivo,7-6(5); 3-6; 6-1,R32,139,2,13,54,104,39,54,29,50,9,11,14,68,104,1,9,56,108,39,56,27,52,7,10,14,66,108
2015-02-02 00:00:00.000,Ecuador Open Quito Ecuador ATP World Tour 250,CLAY,2,Daniel Gimeno-Traver,Marton Fucsovics,Daniel Gimeno-Traver,3-6; 6-4; 6-4,R32,113,5,2,55,93,35,55,21,38,5,9,15,56,93,2,5,52,93,35,52,20,41,14,18,14,55,93
2015-02-02 00:00:00.000,Ecuador Open Quito Ecuador ATP World Tour 250,CLAY,2,Martin Klizan,N/A Bye,Martin Klizan,,R32,0,0,0,0,0,0,0,0,0,0,0,0,0,0,0,0,0,0,0,0,0,0,0,0,0,0,0
2015-02-02 00:00:00.000,Ecuador Open Quito Ecuador ATP World Tour 250,CLAY,2,Thomaz Bellucci,Giovanni Lapentti,Thomaz Bellucci,6-3; 6-7(4); 6-2,R32,145,14,5,55,95,43,55,22,40,6,7,15,65,95,5,8,69,112,42,69,21,43,6,10,14,63,112
2015-02-02 00:00:00.000,Ecuador Open Quito Ecuador ATP World Tour 250,CLAY,2,Horacio Zeballos,Austin Krajicek,Horacio Zeballos,7-6(3); 6-4,R32,125,10,4,38,65,32,38,18,27,4,4,11,50,65,11,2,60,89,40,60,15,29,6,7,11,55,89
2015-02-02 00:00:00.000,Ecuador Open Quito Ecuador ATP World Tour 250,CLAY,2,Albert Montanes,Facundo Arguello,Albert Montanes,6-1; 6-3,R32,66,1,2,33,48,23,33,11,15,2,3,8,34,48,0,3,37,57,17,37,8,20,8,13,8,25,57
2015-02-02 00:00:00.000,Ecuador Open Quito Ecuador ATP World Tour 250,CLAY,2,Santiago Giraldo,N/A Bye,Santiago Giraldo,,R32,0,0,0,0,0,0,0,0,0,0,0,0,0,0,0,0,0,0,0,0,0,0,0,0,0,0,0
2015-02-02 00:00:00.000,Ecuador Open Quito Ecuador ATP World Tour 250,CLAY,2,Feliciano Lopez,Alejandro Gonzalez,Feliciano Lopez,7-5; 6-2,R16,82,10,2,31,54,26,31,16,23,1,1,10,42,54,2,4,36,67,28,36,11,31,2,5,10,39,67
2015-02-02 00:00:00.000,Ecuador Open Quito Ecuador ATP World Tour 250,CLAY,2,Dusan Lajovic,Nicolas Jarry,Dusan Lajovic,6-4; 3-6; 6-3,R16,98,3,5,43,80,37,43,20,37,3,4,14,57,80,6,6,43,74,32,43,21,31,5,7,14,53,74
2015-02-02 00:00:00.000,Ecuador Open Quito Ecuador ATP World Tour 250,CLAY,2,Fernando Verdasco,Gerald Melzer,Fernando Verdasco,7-6(2); 6-4,R16,103,3,5,47,74,36,47,17,27,8,8,11,53,74,3,2,41,77,31,41,18,36,4,5,11,49,77
2015-02-02 00:00:00.000,Ecuador Open Quito Ecuador ATP World Tour 250,CLAY,2,Paolo Lorenzi,Alejandro Falla,Paolo Lorenzi,7-5; 6-1,R16,73,2,1,26,48,20,26,16,22,2,3,9,36,48,0,9,38,63,23,38,8,25,2,7,10,31,63
2015-02-02 00:00:00.000,Ecuador Open Quito Ecuador ATP World Tour 250,CLAY,2,Victor Estrella Burgos,Renzo Olivo,Victor Estrella Burgos,7-6(5); 6-4,R16,104,5,0,48,73,35,48,14,25,4,5,11,49,73,2,7,49,80,35,49,13,31,3,5,11,48,80
2015-02-02 00:00:00.000,Ecuador Open Quito Ecuador ATP World Tour 250,CLAY,2,Martin Klizan,Daniel Gimeno-Traver,Martin Klizan,6-3; 5-7; 7-5,R16,129,6,7,68,104,48,68,14,36,7,12,17,62,104,1,7,62,93,41,62,13,31,1,7,16,54,93
2015-02-02 00:00:00.000,Ecuador Open Quito Ecuador ATP World Tour 250,CLAY,2,Thomaz Bellucci,Horacio Zeballos,Thomaz Bellucci,6-2; 3-6; 7-6(6),R16,143,5,5,58,117,41,58,29,59,13,15,14,70,117,19,4,65,103,48,65,15,38,6,9,15,63,103
2015-02-02 00:00:00.000,Ecuador Open Quito Ecuador ATP World Tour 250,CLAY,2,Albert Montanes,Santiago Giraldo,Albert Montanes,7-6(1); 7-5,R16,94,3,4,47,71,37,47,12,24,4,6,12,49,71,3,1,63,84,45,63,5,21,6,9,12,50,84
2015-02-02 00:00:00.000,Ecuador Open Quito Ecuador ATP World Tour 250,CLAY,2,Feliciano Lopez,Dusan Lajovic,Feliciano Lopez,4-6; 7-5; 6-1,Q,117,6,3,48,91,36,48,27,43,5,6,15,63,91,7,5,48,89,32,48,23,41,4,7,14,55,89
2015-02-02 00:00:00.000,Ecuador Open Quito Ecuador ATP World Tour 250,CLAY,2,Fernando Verdasco,Paolo Lorenzi,Fernando Verdasco,6-1; 6-2,Q,49,4,3,31,41,28,31,5,10,0,0,8,33,41,1,3,24,37,13,24,5,13,3,7,7,18,37
2015-02-02 00:00:00.000,Ecuador Open Quito Ecuador ATP World Tour 250,CLAY,2,Victor Estrella Burgos,Martin Klizan,Victor Estrella Burgos,6-2; 6-2,Q,60,3,1,25,38,20,25,8,13,0,1,8,28,38,1,3,30,52,16,30,7,22,2,7,8,23,52
2015-02-02 00:00:00.000,Ecuador Open Quito Ecuador ATP World Tour 250,CLAY,2,Thomaz Bellucci,Albert Montanes,Thomaz Bellucci,6-3; 7-6(6),Q,97,10,3,37,68,31,37,17,31,3,4,11,48,68,1,7,39,80,29,39,18,41,7,9,10,47,80
2015-02-02 00:00:00.000,Ecuador Open Quito Ecuador ATP World Tour 250,CLAY,2,Feliciano Lopez,Fernando Verdasco,Feliciano Lopez,7-6(5); 7-6(1),S,111,8,4,67,101,49,67,15,34,10,12,12,64,101,4,7,51,73,35,51,11,22,2,4,12,46,73
2015-02-02 00:00:00.000,Ecuador Open Quito Ecuador ATP World Tour 250,CLAY,2,Victor Estrella Burgos,Thomaz Bellucci,Victor Estrella Burgos,7-6(5); 7-5,S,117,3,2,53,84,39,53,15,31,4,6,12,54,84,15,8,47,85,35,47,15,38,4,7,12,50,85
2015-02-02 00:00:00.000,Ecuador Open Quito Ecuador ATP World Tour 250,CLAY,2,Victor Estrella Burgos,Feliciano Lopez,Victor Estrella Burgos,6-2; 6-7(5); 7-6(5),F,137,3,2,79,109,60,79,18,30,5,6,16,78,109,19,4,77,112,54,77,19,35,4,7,16,73,112
2015-02-02 00:00:00.000,PBZ Zagreb Indoors Croatia ATP World Tour 250,HARD,2,Ivo Karlovic,N/A Bye,Ivo Karlovic,,R32,0,0,0,0,0,0,0,0,0,0,0,0,0,0,0,0,0,0,0,0,0,0,0,0,0,0,0
2015-02-02 00:00:00.000,PBZ Zagreb Indoors Croatia ATP World Tour 250,HARD,2,Marcos Baghdatis,Toni Androic,Marcos Baghdatis,6-7(3); 6-2; 6-3,R32,127,13,2,52,89,44,52,19,37,3,3,15,63,89,2,2,54,105,36,54,27,51,5,8,14,63,105
2015-02-02 00:00:00.000,PBZ Zagreb Indoors Croatia ATP World Tour 250,HARD,2,Sergiy Stakhovsky,Borna Coric,Sergiy Stakhovsky,6-2; 6-4,R32,86,4,1,40,69,26,40,14,29,10,12,9,40,69,2,3,37,61,23,37,7,24,4,9,9,30,61
2015-02-02 00:00:00.000,PBZ Zagreb Indoors Croatia ATP World Tour 250,HARD,2,Mikhail Youzhny,Blaz Kavcic,Mikhail Youzhny,6-3; 1-6; 6-4,R32,100,4,4,46,73,30,46,13,27,5,10,13,43,73,8,7,55,80,36,55,9,25,6,11,13,45,80
2015-02-02 00:00:00.000,PBZ Zagreb Indoors Croatia ATP World Tour 250,HARD,2,Guillermo Garcia-Lopez,N/A Bye,Guillermo Garcia-Lopez,,R32,0,0,0,0,0,0,0,0,0,0,0,0,0,0,0,0,0,0,0,0,0,0,0,0,0,0,0
2015-02-02 00:00:00.000,PBZ Zagreb Indoors Croatia ATP World Tour 250,HARD,2,Damir Dzumhur,Michael Berrer,Damir Dzumhur,6-2; 0-6; 7-5,R32,98,5,3,47,69,28,47,9,22,4,10,13,37,69,2,1,51,79,32,51,11,28,6,12,13,43,79
2015-02-02 00:00:00.000,PBZ Zagreb Indoors Croatia ATP World Tour 250,HARD,2,Go Soeda,Matthias Bachinger,Go Soeda,7-6(4); 7-5,R32,104,4,0,45,89,35,45,23,44,5,6,12,58,89,6,2,47,78,33,47,17,31,5,7,12,50,78
2015-02-02 00:00:00.000,PBZ Zagreb Indoors Croatia ATP World Tour 250,HARD,2,Viktor Troicki,Illya Marchenko,Viktor Troicki,4-6; 7-6(3); 7-6(3),R32,158,17,4,75,113,56,75,18,38,5,9,17,74,113,4,3,68,120,47,68,27,52,11,14,17,74,120
2015-02-02 00:00:00.000,PBZ Zagreb Indoors Croatia ATP World Tour 250,HARD,2,Andreas Seppi,Robin Haase,Andreas Seppi,6-2; 3-6; 6-4,R32,99,8,3,38,80,30,38,24,42,2,4,14,54,80,7,5,47,87,33,47,20,40,3,6,13,53,87
2015-02-02 00:00:00.000,PBZ Zagreb Indoors Croatia ATP World Tour 250,HARD,2,James Ward,Antonio Veic,James Ward,6-2; 6-4,R32,71,3,1,33,57,26,33,12,24,3,4,9,38,57,2,4,40,61,25,40,6,21,5,9,9,31,61
2015-02-02 00:00:00.000,PBZ Zagreb Indoors Croatia ATP World Tour 250,HARD,2,Ricardas Berankis,Lukas Lacko,Ricardas Berankis,6-0; 6-2,R32,42,2,0,17,33,16,17,12,16,0,0,7,28,33,2,2,18,38,7,18,8,20,2,7,7,15,38
2015-02-02 00:00:00.000,PBZ Zagreb Indoors Croatia ATP World Tour 250,HARD,2,Gilles Muller,N/A Bye,Gilles Muller,,R32,0,0,0,0,0,0,0,0,0,0,0,0,0,0,0,0,0,0,0,0,0,0,0,0,0,0,0
2015-02-02 00:00:00.000,PBZ Zagreb Indoors Croatia ATP World Tour 250,HARD,2,Marcel Granollers,Jurgen Melzer,Marcel Granollers,6-2; 7-6(3),R32,92,11,0,40,58,35,40,9,18,0,0,10,44,58,0,1,33,66,20,33,18,33,3,5,10,38,66
2015-02-02 00:00:00.000,PBZ Zagreb Indoors Croatia ATP World Tour 250,HARD,2,Ivan Dodig,Mate Delic,Ivan Dodig,6-2; 6-3,R32,53,11,0,31,44,28,31,9,13,0,0,9,37,44,4,3,33,53,23,33,7,20,7,10,8,30,53
2015-02-02 00:00:00.000,PBZ Zagreb Indoors Croatia ATP World Tour 250,HARD,2,Igor Sijsling,Frank Dancevic,Igor Sijsling,6-4; 7-5,R32,82,10,1,42,68,33,42,13,26,0,1,11,46,68,9,4,50,77,34,50,13,27,5,8,11,47,77
2015-02-02 00:00:00.000,PBZ Zagreb Indoors Croatia ATP World Tour 250,HARD,2,Adrian Mannarino,N/A Bye,Adrian Mannarino,,R32,0,0,0,0,0,0,0,0,0,0,0,0,0,0,0,0,0,0,0,0,0,0,0,0,0,0,0
2015-02-02 00:00:00.000,PBZ Zagreb Indoors Croatia ATP World Tour 250,HARD,2,Marcos Baghdatis,Ivo Karlovic,Marcos Baghdatis,3-6; 7-6(5); 7-6(7),R16,117,11,3,59,97,51,59,24,38,0,1,16,75,97,26,2,85,102,68,85,11,17,1,1,17,79,102
2015-02-02 00:00:00.000,PBZ Zagreb Indoors Croatia ATP World Tour 250,HARD,2,Mikhail Youzhny,Sergiy Stakhovsky,Mikhail Youzhny,6-2; 6-1,R16,64,0,0,32,51,20,32,14,19,4,5,8,34,51,1,2,29,52,14,29,9,23,9,14,7,23,52
2015-02-02 00:00:00.000,PBZ Zagreb Indoors Croatia ATP World Tour 250,HARD,2,Guillermo Garcia-Lopez,Damir Dzumhur,Guillermo Garcia-Lopez,6-1; 6-1,R16,64,4,3,31,54,22,31,13,23,5,5,7,35,54,0,1,23,44,11,23,8,21,0,5,7,19,44
2015-02-02 00:00:00.000,PBZ Zagreb Indoors Croatia ATP World Tour 250,HARD,2,Viktor Troicki,Go Soeda,Viktor Troicki,6-3; 6-1,R16,54,10,2,28,45,27,28,8,17,0,0,8,35,45,0,1,29,47,16,29,8,18,2,6,8,24,47
2015-02-02 00:00:00.000,PBZ Zagreb Indoors Croatia ATP World Tour 250,HARD,2,Andreas Seppi,James Ward,Andreas Seppi,7-5; 6-7(4); 6-3,R16,140,9,7,57,111,45,57,23,54,4,7,17,68,111,7,1,63,97,40,63,18,34,3,8,16,58,97
2015-02-02 00:00:00.000,PBZ Zagreb Indoors Croatia ATP World Tour 250,HARD,2,Ricardas Berankis,Gilles Muller,Ricardas Berankis,3-6; 7-6(5); 6-4,R16,132,6,5,61,101,43,61,24,40,5,8,16,67,101,22,3,68,100,52,68,13,32,4,6,15,65,100
2015-02-02 00:00:00.000,PBZ Zagreb Indoors Croatia ATP World Tour 250,HARD,2,Marcel Granollers,Ivan Dodig,Marcel Granollers,7-6(8); 4-6; 6-3,R16,148,8,1,54,105,42,54,32,51,7,8,16,74,105,12,2,54,95,44,54,22,41,4,5,15,66,95
2015-02-02 00:00:00.000,PBZ Zagreb Indoors Croatia ATP World Tour 250,HARD,2,Igor Sijsling,Adrian Mannarino,Igor Sijsling,7-6(3); 4-6; 6-1,R16,107,8,3,50,87,40,50,20,37,5,8,15,60,87,2,0,63,96,39,63,17,33,10,14,14,56,96
2015-02-02 00:00:00.000,PBZ Zagreb Indoors Croatia ATP World Tour 250,HARD,2,Marcos Baghdatis,Mikhail Youzhny,Marcos Baghdatis,3-6; 6-3; 6-4,Q,111,14,7,51,86,40,51,17,35,8,10,14,57,86,2,2,49,83,40,49,14,34,5,8,14,54,83
2015-02-02 00:00:00.000,PBZ Zagreb Indoors Croatia ATP World Tour 250,HARD,2,Guillermo Garcia-Lopez,Viktor Troicki,Guillermo Garcia-Lopez,6-1; 6-7(5); 7-5,Q,148,3,1,45,100,35,45,33,55,1,3,16,68,100,11,1,80,111,51,80,14,31,8,13,15,65,111
2015-02-02 00:00:00.000,PBZ Zagreb Indoors Croatia ATP World Tour 250,HARD,2,Andreas Seppi,Ricardas Berankis,Andreas Seppi,3-6; 6-2; 7-6(6),Q,119,7,1,48,96,37,48,23,48,4,7,15,60,96,6,1,48,86,41,48,17,38,3,6,14,58,86
2015-02-02 00:00:00.000,PBZ Zagreb Indoors Croatia ATP World Tour 250,HARD,2,Marcel Granollers,Igor Sijsling,Marcel Granollers,6-4; 2-6; 6-4,Q,133,11,3,56,93,42,56,15,37,5,8,14,57,93,8,3,46,86,35,46,18,40,2,5,14,53,86
2015-02-02 00:00:00.000,PBZ Zagreb Indoors Croatia ATP World Tour 250,HARD,2,Guillermo Garcia-Lopez,Marcos Baghdatis,Guillermo Garcia-Lopez,6-4; 6-4,S,97,2,5,35,67,25,35,15,32,2,4,10,40,67,7,3,40,65,28,40,8,25,5,9,10,36,65
2015-02-02 00:00:00.000,PBZ Zagreb Indoors Croatia ATP World Tour 250,HARD,2,Andreas Seppi,Marcel Granollers,Andreas Seppi,7-6(5); 6-1,S,90,4,0,31,61,26,31,17,30,2,3,9,43,61,3,3,35,64,24,35,14,29,1,5,10,38,64
2015-02-02 00:00:00.000,PBZ Zagreb Indoors Croatia ATP World Tour 250,HARD,2,Guillermo Garcia-Lopez,Andreas Seppi,Guillermo Garcia-Lopez,7-6(4); 6-3,F,97,5,1,32,69,24,32,23,37,1,2,11,47,69,4,1,29,60,19,29,20,31,3,5,10,39,60
2015-02-09 00:00:00.000,Memphis Open TN; U.S.A. ATP World Tour 250,HARD,2,Kei Nishikori,N/A Bye,Kei Nishikori,,R32,0,0,0,0,0,0,0,0,0,0,0,0,0,0,0,0,0,0,0,0,0,0,0,0,0,0,0
2015-02-09 00:00:00.000,Memphis Open TN; U.S.A. ATP World Tour 250,HARD,2,Ryan Harrison,Malek Jaziri,Ryan Harrison,7-6(3); 7-6(1),R32,113,5,2,50,80,29,50,20,30,3,6,12,49,80,1,2,49,86,37,49,13,37,9,12,12,50,86
2015-02-09 00:00:00.000,Memphis Open TN; U.S.A. ATP World Tour 250,HARD,2,Austin Krajicek,Mikhail Kukushkin,Austin Krajicek,6-2; 6-7(3); 7-6(8),R32,156,19,1,78,117,56,78,25,39,4,5,16,81,117,9,5,59,107,48,59,22,48,5,8,16,70,107
2015-02-09 00:00:00.000,Memphis Open TN; U.S.A. ATP World Tour 250,HARD,2,Ivo Karlovic,Lukas Lacko,Ivo Karlovic,7-6(7); 6-3,R32,83,23,3,49,71,41,49,13,22,1,1,11,54,71,6,4,44,73,34,44,13,29,5,6,10,47,73
2015-02-09 00:00:00.000,Memphis Open TN; U.S.A. ATP World Tour 250,HARD,2,John Isner,N/A Bye,John Isner,,R32,0,0,0,0,0,0,0,0,0,0,0,0,0,0,0,0,0,0,0,0,0,0,0,0,0,0,0
2015-02-09 00:00:00.000,Memphis Open TN; U.S.A. ATP World Tour 250,HARD,2,Ivan Dodig,Teymuraz Gabashvili,Ivan Dodig,6-2; 6-2,R32,59,12,1,22,41,20,22,12,19,0,0,8,32,41,1,2,20,46,14,20,9,26,4,8,8,23,46
2015-02-09 00:00:00.000,Memphis Open TN; U.S.A. ATP World Tour 250,HARD,2,Jared Donaldson,Stefan Kozlov,Jared Donaldson,7-5; 6-0,R32,79,4,3,25,56,19,25,14,31,2,5,9,33,56,0,4,24,53,12,24,7,29,2,9,9,19,53
2015-02-09 00:00:00.000,Memphis Open TN; U.S.A. ATP World Tour 250,HARD,2,Sam Querrey,Benjamin Becker,Sam Querrey,4-6; 6-2; 6-1,R32,80,21,6,43,79,35,43,20,36,2,3,13,55,79,8,4,38,70,28,38,14,32,4,8,12,42,70
2015-02-09 00:00:00.000,Memphis Open TN; U.S.A. ATP World Tour 250,HARD,2,Donald Young,Adrian Mannarino,Donald Young,6-3; 7-6(9),R32,90,9,5,38,74,30,38,18,36,2,5,11,48,74,4,3,52,72,32,52,9,20,0,4,10,41,72
2015-02-09 00:00:00.000,Memphis Open TN; U.S.A. ATP World Tour 250,HARD,2,Denis Kudla,Thanasi Kokkinakis,Denis Kudla,6-3; 6-4,R32,67,3,1,29,56,26,29,17,27,1,1,10,43,56,9,3,29,50,25,29,8,21,0,2,9,33,50
2015-02-09 00:00:00.000,Memphis Open TN; U.S.A. ATP World Tour 250,HARD,2,Bernard Tomic,Igor Sijsling,Bernard Tomic,4-6; 6-3; 6-2,R32,92,6,1,57,93,42,57,15,36,5,8,14,57,93,8,6,46,88,33,46,17,42,6,11,13,50,88
2015-02-09 00:00:00.000,Memphis Open TN; U.S.A. ATP World Tour 250,HARD,2,Alexandr Dolgopolov,N/A Bye,Alexandr Dolgopolov,,R32,0,0,0,0,0,0,0,0,0,0,0,0,0,0,0,0,0,0,0,0,0,0,0,0,0,0,0
2015-02-09 00:00:00.000,Memphis Open TN; U.S.A. ATP World Tour 250,HARD,2,Steve Johnson,Filip Krajinovic,Steve Johnson,6-3; 6-3,R32,55,15,0,30,47,25,30,12,17,1,1,9,37,47,6,1,37,57,25,37,9,20,4,7,9,34,57
2015-02-09 00:00:00.000,Memphis Open TN; U.S.A. ATP World Tour 250,HARD,2,Dustin Brown,Marinko Matosevic,Dustin Brown,6-4; 6-4,R32,87,6,6,55,85,41,55,11,30,6,7,10,52,85,4,3,47,79,34,47,12,32,8,11,10,46,79
2015-02-09 00:00:00.000,Memphis Open TN; U.S.A. ATP World Tour 250,HARD,2,Sam Groth,Yen-Hsun Lu,Sam Groth,6-4; 6-3,R32,64,10,6,23,51,20,23,15,28,1,3,10,35,51,5,4,37,58,23,37,9,21,5,9,9,32,58
2015-02-09 00:00:00.000,Memphis Open TN; U.S.A. ATP World Tour 250,HARD,2,Kevin Anderson,N/A Bye,Kevin Anderson,,R32,0,0,0,0,0,0,0,0,0,0,0,0,0,0,0,0,0,0,0,0,0,0,0,0,0,0,0
2015-02-09 00:00:00.000,Memphis Open TN; U.S.A. ATP World Tour 250,HARD,2,Kei Nishikori,Ryan Harrison,Kei Nishikori,3-6; 6-3; 6-4,R16,117,6,3,45,86,34,45,19,41,1,3,14,53,86,7,3,57,94,39,57,18,37,8,11,14,57,94
2015-02-09 00:00:00.000,Memphis Open TN; U.S.A. ATP World Tour 250,HARD,2,Austin Krajicek,Ivo Karlovic,Austin Krajicek,7-6(4); 4-6; 6-4,R16,121,14,1,75,99,60,75,13,24,2,3,16,73,99,32,9,56,93,48,56,19,37,5,6,16,67,93
2015-02-09 00:00:00.000,Memphis Open TN; U.S.A. ATP World Tour 250,HARD,2,John Isner,Ivan Dodig,John Isner,6-4; 7-6(5),R16,76,22,1,53,69,45,53,8,16,1,1,11,53,69,6,4,48,67,40,48,10,19,4,5,11,50,67
2015-02-09 00:00:00.000,Memphis Open TN; U.S.A. ATP World Tour 250,HARD,2,Sam Querrey,Jared Donaldson,Sam Querrey,6-4; 6-1,R16,58,6,4,32,50,25,32,11,18,2,2,8,36,50,3,3,26,53,18,26,9,27,1,5,9,27,53
2015-02-09 00:00:00.000,Memphis Open TN; U.S.A. ATP World Tour 250,HARD,2,Donald Young,Denis Kudla,Donald Young,7-5; 6-3,R16,71,4,1,26,56,19,26,23,30,1,2,11,42,56,2,2,40,64,26,40,12,24,2,5,10,38,64
2015-02-09 00:00:00.000,Memphis Open TN; U.S.A. ATP World Tour 250,HARD,2,Bernard Tomic,Alexandr Dolgopolov,Bernard Tomic,6-1; 7-5,R16,67,9,1,54,77,37,54,11,23,7,8,10,48,77,6,3,28,56,20,28,12,28,5,9,9,32,56
2015-02-09 00:00:00.000,Memphis Open TN; U.S.A. ATP World Tour 250,HARD,2,Steve Johnson,Dustin Brown,Steve Johnson,4-6; 7-5; 7-6(3),R16,124,8,5,68,116,49,68,26,48,7,11,17,75,116,10,10,67,116,52,67,24,49,8,12,17,76,116
2015-02-09 00:00:00.000,Memphis Open TN; U.S.A. ATP World Tour 250,HARD,2,Kevin Anderson,Sam Groth,Kevin Anderson,6-3; 6-2,R16,60,6,3,25,44,24,25,12,19,0,0,9,36,44,8,5,26,50,19,26,10,24,4,7,8,29,50
2015-02-09 00:00:00.000,Memphis Open TN; U.S.A. ATP World Tour 250,HARD,2,Kei Nishikori,Austin Krajicek,Kei Nishikori,4-6; 6-3; 6-4,Q,131,8,8,59,100,45,59,21,41,8,10,15,66,100,11,4,61,96,47,61,15,35,6,9,14,62,96
2015-02-09 00:00:00.000,Memphis Open TN; U.S.A. ATP World Tour 250,HARD,2,Sam Querrey,John Isner,Sam Querrey,7-6(3); 7-6(2),Q,86,13,5,42,76,35,42,23,34,1,1,12,58,76,12,1,51,69,41,51,12,18,0,0,12,53,69
2015-02-09 00:00:00.000,Memphis Open TN; U.S.A. ATP World Tour 250,HARD,2,Donald Young,Bernard Tomic,Donald Young,7-6(8); 4-6; 7-5,Q,134,13,7,50,101,43,50,28,51,5,8,17,71,101,14,3,90,133,66,90,19,43,8,11,17,85,133
2015-02-09 00:00:00.000,Memphis Open TN; U.S.A. ATP World Tour 250,HARD,2,Kevin Anderson,Steve Johnson,Kevin Anderson,6-4; 6-4,Q,66,16,0,36,51,32,36,10,15,3,3,10,42,51,6,3,34,58,28,34,11,24,2,4,10,39,58
2015-02-09 00:00:00.000,Memphis Open TN; U.S.A. ATP World Tour 250,HARD,2,Kei Nishikori,Sam Querrey,Kei Nishikori,5-7; 7-6(5); 7-6(5),S,162,5,2,72,129,54,72,33,57,4,6,18,87,129,27,9,71,119,58,71,25,48,4,5,18,83,119
2015-02-09 00:00:00.000,Memphis Open TN; U.S.A. ATP World Tour 250,HARD,2,Kevin Anderson,Donald Young,Kevin Anderson,4-6; 6-3; 6-4,S,119,13,1,56,87,44,56,19,31,4,5,15,63,87,2,5,45,95,30,45,30,50,1,3,14,60,95
2015-02-09 00:00:00.000,Memphis Open TN; U.S.A. ATP World Tour 250,HARD,2,Kei Nishikori,Kevin Anderson,Kei Nishikori,6-4; 6-4,F,76,4,2,31,61,25,31,18,30,2,3,10,43,61,12,1,37,50,28,37,5,13,1,4,10,33,50
2015-02-09 00:00:00.000,ABN AMRO World Tennis Tournament Netherlands ATP World Tour 500,HARD,2,Andy Murray,Nicolas Mahut,Andy Murray,6-3; 6-2,R32,94,4,5,36,62,29,36,12,26,5,6,9,41,62,5,2,32,63,20,32,13,31,5,9,8,33,63
2015-02-09 00:00:00.000,ABN AMRO World Tennis Tournament Netherlands ATP World Tour 500,HARD,2,Vasek Pospisil,Philipp Kohlschreiber,Vasek Pospisil,6-4; 6-2,R32,61,5,1,24,49,18,24,20,25,2,2,9,38,49,2,1,31,48,23,31,5,17,1,4,9,28,48
2015-02-09 00:00:00.000,ABN AMRO World Tennis Tournament Netherlands ATP World Tour 500,HARD,2,Jeremy Chardy,Julien Benneteau,Jeremy Chardy,3-3 RET,R32,21,5,0,10,18,9,10,5,8,2,2,3,14,18,4,0,11,16,9,11,3,5,0,0,3,12,16
2015-02-09 00:00:00.000,ABN AMRO World Tennis Tournament Netherlands ATP World Tour 500,HARD,2,Gilles Simon,Joao Sousa,Gilles Simon,5-7; 6-3; 6-2,R32,140,8,0,54,96,36,54,23,42,8,12,15,59,96,1,2,53,94,30,53,20,41,5,11,14,50,94
2015-02-09 00:00:00.000,ABN AMRO World Tennis Tournament Netherlands ATP World Tour 500,HARD,2,Tomas Berdych,Tobias Kamke,Tomas Berdych,6-1; 7-5,R32,89,11,2,36,61,29,36,11,25,6,8,10,40,61,0,2,31,58,18,31,11,27,3,8,9,29,58
2015-02-09 00:00:00.000,ABN AMRO World Tennis Tournament Netherlands ATP World Tour 500,HARD,2,Andreas Seppi,Robin Haase,Andreas Seppi,6-7(5); 6-3; 6-3,R32,135,9,0,64,96,48,64,13,32,4,7,15,61,96,9,4,75,113,47,75,15,38,5,11,15,62,113
2015-02-09 00:00:00.000,ABN AMRO World Tennis Tournament Netherlands ATP World Tour 500,HARD,2,Gael Monfils,Edouard Roger-Vasselin,Gael Monfils,6-3; 6-2,R32,67,8,0,53,71,31,53,13,18,4,5,9,44,71,1,1,31,43,17,31,4,12,3,7,8,21,43
2015-02-09 00:00:00.000,ABN AMRO World Tennis Tournament Netherlands ATP World Tour 500,HARD,2,Roberto Bautista Agut,Alexander Zverev,Roberto Bautista Agut,6-4; 6-1,R32,66,3,0,33,45,28,33,8,12,0,0,9,36,45,7,0,32,51,19,32,7,19,3,6,8,26,51
2015-02-09 00:00:00.000,ABN AMRO World Tennis Tournament Netherlands ATP World Tour 500,HARD,2,Grigor Dimitrov,Paul-Henri Mathieu,Grigor Dimitrov,4-6; 7-6(2); 6-2,R32,129,13,3,56,93,45,56,17,37,4,6,15,62,93,3,3,58,93,41,58,18,35,1,4,15,59,93
2015-02-09 00:00:00.000,ABN AMRO World Tennis Tournament Netherlands ATP World Tour 500,HARD,2,Gilles Muller,David Goffin,Gilles Muller,7-6(5); 6-7(6); 6-3,R32,134,24,5,70,103,62,70,19,33,3,3,17,81,103,19,7,68,113,60,68,18,45,5,6,16,78,113
2015-02-09 00:00:00.000,ABN AMRO World Tennis Tournament Netherlands ATP World Tour 500,HARD,2,Guillermo Garcia-Lopez,Denis Istomin,Guillermo Garcia-Lopez,7-6(5); 6-4,R32,125,6,4,52,89,36,52,14,37,3,6,11,50,89,7,1,57,80,38,57,9,23,4,8,11,47,80
2015-02-09 00:00:00.000,ABN AMRO World Tennis Tournament Netherlands ATP World Tour 500,HARD,2,Stan Wawrinka,Jesse Huta Galung,Stan Wawrinka,6-3; 3-6; 6-3,R32,99,8,3,61,104,43,61,22,43,8,10,14,65,104,3,4,44,65,35,44,10,21,1,4,13,45,65
2015-02-09 00:00:00.000,ABN AMRO World Tennis Tournament Netherlands ATP World Tour 500,HARD,2,Dominic Thiem,Ernests Gulbis,Dominic Thiem,6-4; 6-2,R32,70,5,0,27,47,23,27,14,20,1,1,9,37,47,7,1,33,54,20,33,13,21,2,5,9,33,54
2015-02-09 00:00:00.000,ABN AMRO World Tennis Tournament Netherlands ATP World Tour 500,HARD,2,Sergiy Stakhovsky,Marcel Granollers,Sergiy Stakhovsky,6-2; 7-6(7),R32,84,2,0,55,72,39,55,10,17,6,7,10,49,72,7,3,32,62,21,32,16,30,3,6,10,37,62
2015-02-09 00:00:00.000,ABN AMRO World Tennis Tournament Netherlands ATP World Tour 500,HARD,2,Simone Bolelli,Lukas Rosol,Simone Bolelli,6-3; 6-1,R32,53,4,0,33,41,26,33,5,8,0,1,8,31,41,4,7,30,52,18,30,6,22,3,8,8,24,52
2015-02-09 00:00:00.000,ABN AMRO World Tennis Tournament Netherlands ATP World Tour 500,HARD,2,Milos Raonic,Andrey Kuznetsov,Milos Raonic,6-7(5); 6-1; 7-5,R32,114,19,4,58,89,52,58,15,31,2,3,16,67,89,0,1,59,94,41,59,19,35,2,6,15,60,94
2015-02-09 00:00:00.000,ABN AMRO World Tennis Tournament Netherlands ATP World Tour 500,HARD,2,Andy Murray,Vasek Pospisil,Andy Murray,6-3; 7-5,R16,104,2,4,42,66,27,42,14,24,5,7,11,41,66,6,0,44,69,32,44,7,25,3,7,10,39,69
2015-02-09 00:00:00.000,ABN AMRO World Tennis Tournament Netherlands ATP World Tour 500,HARD,2,Gilles Simon,Jeremy Chardy,Gilles Simon,6-4; 6-3,R16,68,1,2,29,47,24,29,12,18,0,0,9,36,47,3,6,34,58,26,34,9,24,4,7,10,35,58
2015-02-09 00:00:00.000,ABN AMRO World Tennis Tournament Netherlands ATP World Tour 500,HARD,2,Tomas Berdych,Andreas Seppi,Tomas Berdych,6-0; 3-6; 6-3,R16,88,10,2,41,61,35,41,11,20,0,1,12,46,61,4,1,43,76,31,43,13,33,3,7,12,44,76
2015-02-09 00:00:00.000,ABN AMRO World Tennis Tournament Netherlands ATP World Tour 500,HARD,2,Gael Monfils,Roberto Bautista Agut,Gael Monfils,7-5; 7-6(5),R16,100,9,1,56,83,39,56,16,27,1,2,12,55,83,4,1,45,72,33,45,15,27,1,3,12,48,72
2015-02-09 00:00:00.000,ABN AMRO World Tennis Tournament Netherlands ATP World Tour 500,HARD,2,Gilles Muller,Grigor Dimitrov,Gilles Muller,6-2; 7-6(8),R16,85,11,1,49,73,44,49,10,24,4,4,10,54,73,11,0,44,64,33,44,12,20,2,4,10,45,64
2015-02-09 00:00:00.000,ABN AMRO World Tennis Tournament Netherlands ATP World Tour 500,HARD,2,Stan Wawrinka,Guillermo Garcia-Lopez,Stan Wawrinka,6-7(2); 6-4; 6-2,R16,135,8,0,58,92,46,58,18,34,3,4,15,64,92,3,4,52,99,41,52,21,47,4,8,15,62,99
2015-02-09 00:00:00.000,ABN AMRO World Tennis Tournament Netherlands ATP World Tour 500,HARD,2,Sergiy Stakhovsky,Dominic Thiem,Sergiy Stakhovsky,6-1; 6-3,R16,63,9,1,40,59,32,40,10,19,6,6,8,42,59,7,6,33,54,21,33,8,21,6,10,8,29,54
2015-02-09 00:00:00.000,ABN AMRO World Tennis Tournament Netherlands ATP World Tour 500,HARD,2,Milos Raonic,Simone Bolelli,Milos Raonic,6-3; 7-6(2),R16,77,17,1,41,62,34,41,14,21,0,0,11,48,62,3,0,48,60,33,48,7,12,4,5,10,40,60
2015-02-09 00:00:00.000,ABN AMRO World Tennis Tournament Netherlands ATP World Tour 500,HARD,2,Gilles Simon,Andy Murray,Gilles Simon,6-4; 6-2,Q,86,3,1,33,58,20,33,15,25,4,6,9,35,58,1,0,26,52,16,26,7,26,1,6,9,23,52
2015-02-09 00:00:00.000,ABN AMRO World Tennis Tournament Netherlands ATP World Tour 500,HARD,2,Tomas Berdych,Gael Monfils,Tomas Berdych,6-1; 6-4,Q,72,7,0,34,55,30,34,10,21,0,0,9,40,55,7,2,36,56,24,36,7,20,6,9,8,31,56
2015-02-09 00:00:00.000,ABN AMRO World Tennis Tournament Netherlands ATP World Tour 500,HARD,2,Stan Wawrinka,Gilles Muller,Stan Wawrinka,7-6(3); 6-3,Q,77,9,1,37,60,29,37,19,23,2,3,11,48,60,9,2,43,63,35,43,7,20,3,5,10,42,63
2015-02-09 00:00:00.000,ABN AMRO World Tennis Tournament Netherlands ATP World Tour 500,HARD,2,Milos Raonic,Sergiy Stakhovsky,Milos Raonic,2-6; 6-3; 6-4,Q,93,6,1,51,74,37,51,15,23,3,5,14,52,74,2,1,53,83,41,53,15,30,3,5,13,56,83
2015-02-09 00:00:00.000,ABN AMRO World Tennis Tournament Netherlands ATP World Tour 500,HARD,2,Tomas Berdych,Gilles Simon,Tomas Berdych,6-2; 6-1,S,58,3,0,23,36,22,23,10,13,0,0,8,32,36,1,0,21,43,11,21,8,22,1,5,7,19,43
2015-02-09 00:00:00.000,ABN AMRO World Tennis Tournament Netherlands ATP World Tour 500,HARD,2,Stan Wawrinka,Milos Raonic,Stan Wawrinka,7-6(3); 7-6(7),S,98,10,3,57,86,47,57,17,29,6,6,12,64,86,15,0,51,73,44,51,13,22,1,1,12,57,73
2015-02-09 00:00:00.000,ABN AMRO World Tennis Tournament Netherlands ATP World Tour 500,HARD,2,Stan Wawrinka,Tomas Berdych,Stan Wawrinka,4-6; 6-3; 6-4,F,118,3,1,53,83,41,53,15,30,2,4,15,56,83,9,1,46,90,32,46,23,44,3,6,14,55,90
2015-02-09 00:00:00.000,Brasil Open 2015 Brazil ATP World Tour 250,CLAY,2,Luca Vanni,N/A Bye,Luca Vanni,,R32,0,0,0,0,0,0,0,0,0,0,0,0,0,0,0,0,0,0,0,0,0,0,0,0,0,0,0
2015-02-09 00:00:00.000,Brasil Open 2015 Brazil ATP World Tour 250,CLAY,2,Thiemo de Bakker,Juan Monaco,Thiemo de Bakker,6-7(5); 7-6(4); 6-4,R32,169,19,1,59,115,49,59,29,56,8,9,17,78,115,4,2,98,136,65,98,22,38,8,10,17,87,136
2015-02-09 00:00:00.000,Brasil Open 2015 Brazil ATP World Tour 250,CLAY,2,Dusan Lajovic,Pablo Andujar,Dusan Lajovic,3-6; 6-3; 6-2,R32,110,5,0,54,87,38,54,18,33,7,9,13,56,87,0,1,46,74,33,46,13,28,3,7,13,46,74
2015-02-09 00:00:00.000,Brasil Open 2015 Brazil ATP World Tour 250,CLAY,2,Fernando Verdasco,Maximo Gonzalez,Fernando Verdasco,6-2; 6-3,R32,70,2,3,25,50,17,25,15,25,0,2,9,32,50,3,0,28,48,19,28,5,20,3,8,8,24,48
2015-02-09 00:00:00.000,Brasil Open 2015 Brazil ATP World Tour 250,CLAY,2,Leonardo Mayer,N/A Bye,Leonardo Mayer,,R32,0,0,0,0,0,0,0,0,0,0,0,0,0,0,0,0,0,0,0,0,0,0,0,0,0,0,0
2015-02-09 00:00:00.000,Brasil Open 2015 Brazil ATP World Tour 250,CLAY,2,Albert Ramos-Vinolas,Guilherme Clezar,Albert Ramos-Vinolas,7-5; 7-5,R32,109,9,2,39,68,27,39,15,29,0,3,12,42,68,2,5,42,78,24,42,18,36,6,11,12,42,78
2015-02-09 00:00:00.000,Brasil Open 2015 Brazil ATP World Tour 250,CLAY,2,Joao Souza,Pablo Carreno Busta,Joao Souza,6-2; 7-6(6),R32,93,5,2,32,58,26,32,17,26,0,1,10,43,58,3,3,46,74,29,46,13,28,4,7,10,42,74
2015-02-09 00:00:00.000,Brasil Open 2015 Brazil ATP World Tour 250,CLAY,2,Martin Klizan,Thomaz Bellucci,Martin Klizan,5-7; 6-3; 7-5,R32,155,5,4,60,110,42,60,29,50,4,6,17,71,110,6,3,63,100,46,63,19,37,7,10,16,65,100
2015-02-09 00:00:00.000,Brasil Open 2015 Brazil ATP World Tour 250,CLAY,2,Santiago Giraldo,Kimmer Coppejans,Santiago Giraldo,7-5; 7-6(4),R32,100,3,2,56,73,44,56,10,17,5,6,12,54,73,10,3,55,79,40,55,13,24,4,6,12,53,79
2015-02-09 00:00:00.000,Brasil Open 2015 Brazil ATP World Tour 250,CLAY,2,Carlos Berlocq,Guido Pella,Carlos Berlocq,6-4; 7-6(4),R32,120,4,4,46,78,32,46,19,32,3,5,11,51,78,4,1,60,78,38,60,8,18,8,11,11,46,78
2015-02-09 00:00:00.000,Brasil Open 2015 Brazil ATP World Tour 250,CLAY,2,Diego Schwartzman,Paolo Lorenzi,Diego Schwartzman,7-5; 6-4,R32,95,2,2,30,60,23,30,16,30,1,3,11,39,60,5,7,40,81,30,40,16,41,5,9,11,46,81
2015-02-09 00:00:00.000,Brasil Open 2015 Brazil ATP World Tour 250,CLAY,2,Fabio Fognini,N/A Bye,Fabio Fognini,,R32,0,0,0,0,0,0,0,0,0,0,0,0,0,0,0,0,0,0,0,0,0,0,0,0,0,0,0
2015-02-09 00:00:00.000,Brasil Open 2015 Brazil ATP World Tour 250,CLAY,2,Pablo Cuevas,Jiri Vesely,Pablo Cuevas,6-4; 3-6; 7-5,R32,127,15,1,45,84,39,45,21,39,3,5,15,60,84,6,3,74,103,50,74,17,29,4,7,16,67,103
2015-02-09 00:00:00.000,Brasil Open 2015 Brazil ATP World Tour 250,CLAY,2,Facundo Bagnis,Federico Delbonis,Facundo Bagnis,6-3; 2-6; 6-4,R32,117,2,3,54,90,38,54,22,36,5,7,14,60,90,1,3,45,76,35,45,16,31,3,5,13,51,76
2015-02-09 00:00:00.000,Brasil Open 2015 Brazil ATP World Tour 250,CLAY,2,Nicolas Almagro,Blaz Rola,Nicolas Almagro,7-6(3); 6-4,R32,98,10,2,43,76,35,43,18,33,6,7,11,53,76,5,5,49,79,36,49,14,30,4,6,11,50,79
2015-02-09 00:00:00.000,Brasil Open 2015 Brazil ATP World Tour 250,CLAY,2,Tommy Robredo,N/A Bye,Tommy Robredo,,R32,0,0,0,0,0,0,0,0,0,0,0,0,0,0,0,0,0,0,0,0,0,0,0,0,0,0,0
2015-02-09 00:00:00.000,Brasil Open 2015 Brazil ATP World Tour 250,CLAY,2,Luca Vanni,Thiemo de Bakker,Luca Vanni,7-6(5); 3-6; 6-3,R16,119,14,3,60,106,42,60,24,46,5,8,15,66,106,8,2,47,77,39,47,15,30,0,3,15,54,77
2015-02-09 00:00:00.000,Brasil Open 2015 Brazil ATP World Tour 250,CLAY,2,Dusan Lajovic,Fernando Verdasco,Dusan Lajovic,6-7(6); 6-3; 6-4,R16,133,9,2,79,115,62,79,16,36,4,4,16,78,115,8,5,53,90,42,53,22,37,4,6,15,64,90
2015-02-09 00:00:00.000,Brasil Open 2015 Brazil ATP World Tour 250,CLAY,2,Leonardo Mayer,Albert Ramos-Vinolas,Leonardo Mayer,6-4; 3-6; 6-1,R16,127,9,1,48,86,35,48,20,38,8,10,13,55,86,3,2,55,82,38,55,12,27,7,11,13,50,82
2015-02-09 00:00:00.000,Brasil Open 2015 Brazil ATP World Tour 250,CLAY,2,Joao Souza,Martin Klizan,Joao Souza,3-6; 6-3; 6-2,R16,127,11,4,52,80,40,52,15,28,5,6,13,55,80,5,1,54,91,36,54,17,37,8,11,13,53,91
2015-02-09 00:00:00.000,Brasil Open 2015 Brazil ATP World Tour 250,CLAY,2,Santiago Giraldo,Carlos Berlocq,Santiago Giraldo,4-6; 7-5; 6-3,R16,141,0,0,77,96,50,77,10,19,5,8,15,60,96,4,3,63,100,42,63,17,37,4,9,16,59,100
2015-02-09 00:00:00.000,Brasil Open 2015 Brazil ATP World Tour 250,CLAY,2,Fabio Fognini,Diego Schwartzman,Fabio Fognini,6-3; 1-6; 6-2,R16,98,5,5,43,87,23,43,22,44,9,14,12,45,87,7,4,48,76,29,48,10,28,2,8,12,39,76
2015-02-09 00:00:00.000,Brasil Open 2015 Brazil ATP World Tour 250,CLAY,2,Pablo Cuevas,Facundo Bagnis,Pablo Cuevas,5-1 RET,R16,22,2,0,7,18,7,7,6,11,0,0,3,13,18,1,0,14,21,6,14,3,7,4,6,3,9,21
2015-02-09 00:00:00.000,Brasil Open 2015 Brazil ATP World Tour 250,CLAY,2,Nicolas Almagro,Tommy Robredo,Nicolas Almagro,6-3; 7-6(1),R16,86,10,0,39,74,28,39,23,35,5,6,11,51,74,6,4,36,57,27,36,10,21,1,3,10,37,57
2015-02-09 00:00:00.000,Brasil Open 2015 Brazil ATP World Tour 250,CLAY,2,Luca Vanni,Dusan Lajovic,Luca Vanni,7-6(5); 7-6(4),Q,114,10,2,54,83,40,54,19,29,1,2,12,59,83,3,2,64,88,50,64,11,24,5,6,12,61,88
2015-02-09 00:00:00.000,Brasil Open 2015 Brazil ATP World Tour 250,CLAY,2,Joao Souza,Leonardo Mayer,Joao Souza,6-4; 3-6; 6-3,Q,132,0,4,68,101,52,68,14,33,8,9,14,66,101,13,1,52,74,41,52,13,22,3,5,14,54,74
2015-02-09 00:00:00.000,Brasil Open 2015 Brazil ATP World Tour 250,CLAY,2,Santiago Giraldo,Fabio Fognini,Santiago Giraldo,7-6(4); 7-5,Q,104,0,0,53,76,40,53,11,23,6,8,12,51,76,4,2,53,80,36,53,12,27,2,5,12,48,80
2015-02-09 00:00:00.000,Brasil Open 2015 Brazil ATP World Tour 250,CLAY,2,Pablo Cuevas,Nicolas Almagro,Pablo Cuevas,7-6(6); 3-6; 6-2,Q,122,9,0,58,92,44,58,20,34,5,7,15,64,92,7,2,48,84,38,48,19,36,1,3,14,57,84
2015-02-09 00:00:00.000,Brasil Open 2015 Brazil ATP World Tour 250,CLAY,2,Luca Vanni,Joao Souza,Luca Vanni,6-4; 6-7(5); 6-4,S,176,10,5,65,110,49,65,24,45,5,7,16,73,110,4,1,71,103,51,71,14,32,2,6,16,65,103
2015-02-09 00:00:00.000,Brasil Open 2015 Brazil ATP World Tour 250,CLAY,2,Pablo Cuevas,Santiago Giraldo,Pablo Cuevas,6-4; 6-3,S,71,7,0,32,53,26,32,11,21,5,6,9,37,53,1,0,44,55,28,44,4,11,2,6,10,32,55
2015-02-09 00:00:00.000,Brasil Open 2015 Brazil ATP World Tour 250,CLAY,2,Pablo Cuevas,Luca Vanni,Pablo Cuevas,6-4; 3-6; 7-6(4),F,123,6,3,51,85,37,51,23,34,2,4,15,60,85,13,2,62,93,41,62,19,31,2,4,16,60,93
2015-02-16 00:00:00.000,Delray Beach Open FL; U.S.A. ATP World Tour 250,HARD,2,Kevin Anderson,John-Patrick Smith,Kevin Anderson,6-3; 6-3,R32,74,1,1,27,48,22,27,15,21,1,1,9,37,48,2,1,28,58,20,28,14,30,2,5,9,34,58
2015-02-16 00:00:00.000,Delray Beach Open FL; U.S.A. ATP World Tour 250,HARD,2,Yen-Hsun Lu,Sam Groth,Yen-Hsun Lu,6-7(6); 7-6(5); 6-4,R32,140,8,3,62,112,48,62,32,50,4,6,17,80,112,15,2,80,115,58,80,20,35,5,8,17,78,115
2015-02-16 00:00:00.000,Delray Beach Open FL; U.S.A. ATP World Tour 250,HARD,2,Denis Kudla,Lukas Lacko,Denis Kudla,6-3; 6-4,R32,66,3,6,40,69,31,40,14,29,6,7,10,45,69,4,2,28,50,17,28,11,22,1,4,9,28,50
2015-02-16 00:00:00.000,Delray Beach Open FL; U.S.A. ATP World Tour 250,HARD,2,Adrian Mannarino,Eric Quigley,Adrian Mannarino,6-4; 6-4,R32,69,8,1,33,57,26,33,18,24,4,4,10,44,57,6,3,33,59,24,33,15,26,2,4,10,39,59
2015-02-16 00:00:00.000,Delray Beach Open FL; U.S.A. ATP World Tour 250,HARD,2,Ivo Karlovic,Dustin Brown,Ivo Karlovic,6-3; 6-7(3); 6-2,R32,102,23,6,53,83,45,53,18,30,0,0,15,63,83,6,8,52,88,41,52,16,36,4,7,14,57,88
2015-02-16 00:00:00.000,Delray Beach Open FL; U.S.A. ATP World Tour 250,HARD,2,Thanasi Kokkinakis,Filip Krajinovic,Thanasi Kokkinakis,6-2; 6-3,R32,57,7,3,22,45,19,22,17,23,0,0,9,36,45,1,2,25,47,19,25,8,22,1,4,8,27,47
2015-02-16 00:00:00.000,Delray Beach Open FL; U.S.A. ATP World Tour 250,HARD,2,Andrey Rublev,Dudi Sela,Andrey Rublev,6-4; 1-6; 6-3,R32,93,2,4,48,80,31,48,21,32,5,7,13,52,80,11,7,42,82,32,42,22,40,2,4,13,54,82
2015-02-16 00:00:00.000,Delray Beach Open FL; U.S.A. ATP World Tour 250,HARD,2,Steve Johnson,Mikhail Kukushkin,Steve Johnson,6-3; 4-1 RET,R32,53,7,0,28,44,21,28,8,16,5,6,7,29,44,1,3,31,47,16,31,7,16,2,6,7,23,47
2015-02-16 00:00:00.000,Delray Beach Open FL; U.S.A. ATP World Tour 250,HARD,2,Alejandro Gonzalez,Sam Querrey,Alejandro Gonzalez,3-6; 2-1 RET,R32,56,3,1,32,40,23,32,3,8,3,4,6,26,40,5,6,26,43,20,26,8,17,2,2,6,28,43
2015-02-16 00:00:00.000,Delray Beach Open FL; U.S.A. ATP World Tour 250,HARD,2,Donald Young,Ivan Dodig,Donald Young,7-5; 7-5,R32,101,4,8,32,67,28,32,19,35,0,1,12,47,67,6,6,50,90,34,50,17,40,5,8,12,51,90
2015-02-16 00:00:00.000,Delray Beach Open FL; U.S.A. ATP World Tour 250,HARD,2,Tim Smyczek,Stefan Kozlov,Tim Smyczek,7-5; 6-2,R32,83,0,1,37,60,23,37,11,23,1,4,10,34,60,1,2,26,60,12,26,16,34,3,9,10,28,60
2015-02-16 00:00:00.000,Delray Beach Open FL; U.S.A. ATP World Tour 250,HARD,2,Alexandr Dolgopolov,Teymuraz Gabashvili,Alexandr Dolgopolov,7-6(4); 6-3,R32,94,9,2,29,68,25,29,23,39,2,3,11,48,68,3,5,36,86,21,36,29,50,6,8,10,50,86
2015-02-16 00:00:00.000,Delray Beach Open FL; U.S.A. ATP World Tour 250,HARD,2,Viktor Troicki,Stephane Robert,Viktor Troicki,6-7(3); 7-5; 6-1,R32,110,18,1,53,90,41,53,20,37,4,6,15,61,90,1,5,54,100,32,54,23,46,6,12,16,55,100
2015-02-16 00:00:00.000,Delray Beach Open FL; U.S.A. ATP World Tour 250,HARD,2,Bernard Tomic,Malek Jaziri,Bernard Tomic,6-3; 6-3,R32,51,7,0,37,61,28,37,11,24,5,6,9,39,61,5,4,27,48,20,27,6,21,1,5,9,26,48
2015-02-16 00:00:00.000,Delray Beach Open FL; U.S.A. ATP World Tour 250,HARD,2,Yoshihito Nishioka,Igor Sijsling,Yoshihito Nishioka,7-5; 6-1,R32,76,1,0,33,58,24,33,16,25,1,2,10,40,58,3,1,37,69,23,37,13,32,8,12,9,36,69
2015-02-16 00:00:00.000,Delray Beach Open FL; U.S.A. ATP World Tour 250,HARD,2,Marinko Matosevic,John Isner,Marinko Matosevic,6-4; 6-4,R32,75,4,3,32,60,25,32,19,28,3,3,10,44,60,16,6,45,66,31,45,8,21,3,5,10,39,66
2015-02-16 00:00:00.000,Delray Beach Open FL; U.S.A. ATP World Tour 250,HARD,2,Yen-Hsun Lu,Kevin Anderson,Yen-Hsun Lu,7-6(6); 6-3,R16,79,3,1,31,59,28,31,19,28,1,2,11,47,59,12,1,43,59,32,43,7,16,1,3,10,39,59
2015-02-16 00:00:00.000,Delray Beach Open FL; U.S.A. ATP World Tour 250,HARD,2,Adrian Mannarino,Denis Kudla,Adrian Mannarino,6-2; 6-2,R16,60,1,0,29,43,22,29,11,14,2,2,8,33,43,4,1,38,54,20,38,7,16,5,9,8,27,54
2015-02-16 00:00:00.000,Delray Beach Open FL; U.S.A. ATP World Tour 250,HARD,2,Ivo Karlovic,Thanasi Kokkinakis,Ivo Karlovic,7-6(4); 7-6(2),R16,108,21,3,46,74,42,46,19,28,2,2,12,61,74,5,6,45,78,37,45,18,33,2,2,12,55,78
2015-02-16 00:00:00.000,Delray Beach Open FL; U.S.A. ATP World Tour 250,HARD,2,Steve Johnson,Andrey Rublev,Steve Johnson,6-3; 6-3,R16,68,7,3,32,54,22,32,12,22,4,6,9,34,54,5,2,45,63,24,45,7,18,2,7,9,31,63
2015-02-16 00:00:00.000,Delray Beach Open FL; U.S.A. ATP World Tour 250,HARD,2,Donald Young,Alejandro Gonzalez,Donald Young,6-3; 6-2,R16,68,2,4,32,55,23,32,14,23,1,2,9,37,55,1,3,34,52,21,34,6,18,4,8,8,27,52
2015-02-16 00:00:00.000,Delray Beach Open FL; U.S.A. ATP World Tour 250,HARD,2,Alexandr Dolgopolov,Tim Smyczek,Alexandr Dolgopolov,6-2; 6-4,R16,71,3,3,30,53,18,30,12,23,3,6,9,30,53,1,0,37,58,17,37,8,21,3,9,9,25,58
2015-02-16 00:00:00.000,Delray Beach Open FL; U.S.A. ATP World Tour 250,HARD,2,Bernard Tomic,Viktor Troicki,Bernard Tomic,6-3; 6-7(2); 6-4,R16,117,3,1,59,102,42,59,25,43,5,7,16,67,102,13,2,63,93,48,63,14,30,6,10,15,62,93
2015-02-16 00:00:00.000,Delray Beach Open FL; U.S.A. ATP World Tour 250,HARD,2,Yoshihito Nishioka,Marinko Matosevic,Yoshihito Nishioka,6-1; 6-3,R16,70,0,0,30,53,16,30,16,23,2,3,8,32,53,1,2,25,52,17,25,7,27,4,9,8,24,52
2015-02-16 00:00:00.000,Delray Beach Open FL; U.S.A. ATP World Tour 250,HARD,2,Adrian Mannarino,Yen-Hsun Lu,Adrian Mannarino,3-6; 6-1; 6-1,Q,90,4,2,44,73,33,44,15,29,3,5,12,48,73,3,3,38,70,21,38,16,32,7,12,11,37,70
2015-02-16 00:00:00.000,Delray Beach Open FL; U.S.A. ATP World Tour 250,HARD,2,Ivo Karlovic,Steve Johnson,Ivo Karlovic,6-2; 7-6(4),Q,95,17,5,38,67,32,38,16,29,5,5,10,48,67,0,4,36,59,25,36,14,23,1,3,10,39,59
2015-02-16 00:00:00.000,Delray Beach Open FL; U.S.A. ATP World Tour 250,HARD,2,Donald Young,Alexandr Dolgopolov,Donald Young,2-6; 6-3; 6-4,Q,110,3,4,60,92,39,60,17,32,3,6,14,56,92,11,4,49,95,37,49,21,46,10,13,13,58,95
2015-02-16 00:00:00.000,Delray Beach Open FL; U.S.A. ATP World Tour 250,HARD,2,Bernard Tomic,Yoshihito Nishioka,Bernard Tomic,6-3; 6-1,Q,58,5,1,29,47,24,29,11,18,7,7,8,35,47,1,2,35,54,19,35,7,19,1,5,8,26,54
2015-02-16 00:00:00.000,Delray Beach Open FL; U.S.A. ATP World Tour 250,HARD,2,Ivo Karlovic,Adrian Mannarino,Ivo Karlovic,6-3; 6-4,S,71,17,2,38,61,31,38,13,23,5,5,10,44,61,3,2,31,52,21,31,13,21,3,5,9,34,52
2015-02-16 00:00:00.000,Delray Beach Open FL; U.S.A. ATP World Tour 250,HARD,2,Donald Young,Bernard Tomic,Donald Young,4-6; 6-4; 6-2,S,114,2,8,41,93,26,41,30,52,7,10,14,56,93,13,1,59,92,41,59,12,33,7,12,14,53,92
2015-02-16 00:00:00.000,Delray Beach Open FL; U.S.A. ATP World Tour 250,HARD,2,Ivo Karlovic,Donald Young,Ivo Karlovic,6-3; 6-3,F,70,13,6,35,59,28,35,13,24,7,7,9,41,59,1,4,28,54,19,28,14,26,0,3,9,33,54
2015-02-16 00:00:00.000,Open 13 France ATP World Tour 250,HARD,2,Milos Raonic,N/A Bye,Milos Raonic,,R32,0,0,0,0,0,0,0,0,0,0,0,0,0,0,0,0,0,0,0,0,0,0,0,0,0,0,0
2015-02-16 00:00:00.000,Open 13 France ATP World Tour 250,HARD,2,Simone Bolelli,Luca Vanni,Simone Bolelli,6-4; 7-6(4),R32,91,4,1,45,65,37,45,15,20,0,0,11,52,65,9,2,48,73,38,48,12,25,1,2,11,50,73
2015-02-16 00:00:00.000,Open 13 France ATP World Tour 250,HARD,2,Andrey Kuznetsov,Andrey Golubev,Andrey Kuznetsov,3-6; 6-4; 6-2,R32,115,10,4,51,92,41,51,20,41,8,10,13,61,92,8,4,51,92,37,51,18,41,8,12,14,55,92
2015-02-16 00:00:00.000,Open 13 France ATP World Tour 250,HARD,2,Gael Monfils,Alexander Zverev,Gael Monfils,6-1; 7-6(12),R32,86,6,2,29,54,25,29,12,25,0,2,9,37,54,2,1,41,69,29,41,10,28,5,10,10,39,69
2015-02-16 00:00:00.000,Open 13 France ATP World Tour 250,HARD,2,Roberto Bautista Agut,N/A Bye,Roberto Bautista Agut,,R32,0,0,0,0,0,0,0,0,0,0,0,0,0,0,0,0,0,0,0,0,0,0,0,0,0,0,0
2015-02-16 00:00:00.000,Open 13 France ATP World Tour 250,HARD,2,Vasek Pospisil,Robin Haase,Vasek Pospisil,4-6; 6-3; 6-4,R32,122,16,1,55,95,39,55,26,40,8,9,15,65,95,0,2,53,82,41,53,14,29,5,7,14,55,82
2015-02-16 00:00:00.000,Open 13 France ATP World Tour 250,HARD,2,Dominic Thiem,Joao Sousa,Dominic Thiem,7-6(6); 6-4,R32,111,5,4,48,93,35,48,22,45,8,10,11,57,93,5,3,49,83,32,49,15,34,9,12,11,47,83
2015-02-16 00:00:00.000,Open 13 France ATP World Tour 250,HARD,2,David Goffin,Jerzy Janowicz,David Goffin,6-4; 6-2,R32,76,7,4,30,58,20,30,17,28,4,5,9,37,58,2,6,41,62,25,41,8,21,9,13,9,33,62
2015-02-16 00:00:00.000,Open 13 France ATP World Tour 250,HARD,2,Gilles Simon,Pierre-Hugues Herbert,Gilles Simon,7-5; 2-0 RET,R32,62,2,1,20,34,16,20,8,14,0,1,7,24,34,4,1,26,50,17,26,9,24,4,7,7,26,50
2015-02-16 00:00:00.000,Open 13 France ATP World Tour 250,HARD,2,Borna Coric,Denis Istomin,Borna Coric,6-4; 7-5,R32,76,3,1,33,56,26,33,16,23,0,1,11,42,56,9,1,41,58,28,41,9,17,0,3,11,37,58
2015-02-16 00:00:00.000,Open 13 France ATP World Tour 250,HARD,2,Jeremy Chardy,David Guez,Jeremy Chardy,4-6; 6-3; 6-2,R32,111,10,6,48,91,35,48,24,43,4,5,14,59,91,4,2,46,82,29,46,22,36,1,4,13,51,82
2015-02-16 00:00:00.000,Open 13 France ATP World Tour 250,HARD,2,Ernests Gulbis,N/A Bye,Ernests Gulbis,,R32,0,0,0,0,0,0,0,0,0,0,0,0,0,0,0,0,0,0,0,0,0,0,0,0,0,0,0
2015-02-16 00:00:00.000,Open 13 France ATP World Tour 250,HARD,2,Sergiy Stakhovsky,Lukas Rosol,Sergiy Stakhovsky,6-3; 6-2,R32,54,9,1,33,46,27,33,7,13,0,0,8,34,46,1,7,34,53,21,34,6,19,6,10,9,27,53
2015-02-16 00:00:00.000,Open 13 France ATP World Tour 250,HARD,2,Jan-Lennard Struff,Nicolas Mahut,Jan-Lennard Struff,6-1; 6-7(6); 7-6(1),R32,121,15,1,66,103,57,66,21,37,0,0,16,78,103,8,2,56,87,43,56,20,31,0,2,15,63,87
2015-02-16 00:00:00.000,Open 13 France ATP World Tour 250,HARD,2,Benoit Paire,Paul-Henri Mathieu,Benoit Paire,6-4 RET,R32,36,7,1,17,28,14,17,6,11,0,0,5,20,28,0,2,18,36,14,18,7,18,3,4,5,21,36
2015-02-16 00:00:00.000,Open 13 France ATP World Tour 250,HARD,2,Stan Wawrinka,N/A Bye,Stan Wawrinka,,R32,0,0,0,0,0,0,0,0,0,0,0,0,0,0,0,0,0,0,0,0,0,0,0,0,0,0,0
2015-02-16 00:00:00.000,Open 13 France ATP World Tour 250,HARD,2,Simone Bolelli,Milos Raonic,Simone Bolelli,6-4; 3-6; 7-6(3),R16,115,7,1,63,101,49,63,21,38,7,8,15,70,101,21,1,51,83,45,51,20,32,0,1,16,65,83
2015-02-16 00:00:00.000,Open 13 France ATP World Tour 250,HARD,2,Gael Monfils,Andrey Kuznetsov,Gael Monfils,6-3; 6-2,R16,64,13,3,36,59,27,36,14,23,3,3,9,41,59,6,1,40,61,27,40,7,21,4,7,8,34,61
2015-02-16 00:00:00.000,Open 13 France ATP World Tour 250,HARD,2,Roberto Bautista Agut,Vasek Pospisil,Roberto Bautista Agut,7-5; 6-4,R16,88,1,0,36,64,28,36,19,28,2,2,11,47,64,8,1,44,65,35,44,6,21,1,3,11,41,65
2015-02-16 00:00:00.000,Open 13 France ATP World Tour 250,HARD,2,Dominic Thiem,David Goffin,Dominic Thiem,5-1 RET,R16,21,2,1,2,13,2,2,10,11,0,0,3,12,13,1,2,15,22,10,15,0,7,4,6,3,10,22
2015-02-16 00:00:00.000,Open 13 France ATP World Tour 250,HARD,2,Gilles Simon,Borna Coric,Gilles Simon,6-2; 3-6; 6-3,R16,121,7,0,44,73,31,44,17,29,5,8,13,48,73,7,2,56,81,35,56,9,25,7,12,13,44,81
2015-02-16 00:00:00.000,Open 13 France ATP World Tour 250,HARD,2,Jeremy Chardy,Ernests Gulbis,Jeremy Chardy,6-3; 6-4,R16,70,5,4,35,56,30,35,13,21,4,4,10,43,56,8,0,29,51,24,29,9,22,2,4,9,33,51
2015-02-16 00:00:00.000,Open 13 France ATP World Tour 250,HARD,2,Sergiy Stakhovsky,Jan-Lennard Struff,Sergiy Stakhovsky,6-4; 4-6; 6-3,R16,90,15,2,47,72,41,47,14,25,1,2,14,55,72,6,3,62,86,46,62,14,24,4,7,15,60,86
2015-02-16 00:00:00.000,Open 13 France ATP World Tour 250,HARD,2,Stan Wawrinka,Benoit Paire,Stan Wawrinka,6-2; 6-3,R16,59,1,0,46,65,30,46,15,19,4,4,9,45,65,3,0,23,45,19,23,8,22,3,6,8,27,45
2015-02-16 00:00:00.000,Open 13 France ATP World Tour 250,HARD,2,Gael Monfils,Simone Bolelli,Gael Monfils,6-4; 6-4,Q,73,8,1,31,51,28,31,13,20,1,1,10,41,51,3,3,47,69,31,47,11,22,3,5,10,42,69
2015-02-16 00:00:00.000,Open 13 France ATP World Tour 250,HARD,2,Roberto Bautista Agut,Dominic Thiem,Roberto Bautista Agut,7-6(7); 6-3,Q,95,2,2,44,70,36,44,16,26,2,2,11,52,70,7,2,43,74,33,43,15,31,4,5,10,48,74
2015-02-16 00:00:00.000,Open 13 France ATP World Tour 250,HARD,2,Gilles Simon,Jeremy Chardy,Gilles Simon,7-5; 7-6(6),Q,103,3,4,41,78,32,41,23,37,1,3,12,55,78,8,2,49,81,32,49,21,32,8,11,12,53,81
2015-02-16 00:00:00.000,Open 13 France ATP World Tour 250,HARD,2,Sergiy Stakhovsky,Stan Wawrinka,Sergiy Stakhovsky,6-4; 3-6; 6-4,Q,112,5,1,59,85,45,59,14,26,4,5,14,59,85,6,0,68,110,50,68,23,42,8,10,15,73,110
2015-02-16 00:00:00.000,Open 13 France ATP World Tour 250,HARD,2,Gael Monfils,Roberto Bautista Agut,Gael Monfils,6-4; 6-2,S,65,9,1,32,49,24,32,10,17,4,5,9,34,49,1,2,25,49,18,25,9,24,1,5,9,27,49
2015-02-16 00:00:00.000,Open 13 France ATP World Tour 250,HARD,2,Gilles Simon,Sergiy Stakhovsky,Gilles Simon,3-6; 6-3; 6-2,S,98,9,2,53,85,41,53,12,32,3,5,13,53,85,3,1,40,67,28,40,14,27,2,6,13,42,67
2015-02-16 00:00:00.000,Open 13 France ATP World Tour 250,HARD,2,Gilles Simon,Gael Monfils,Gilles Simon,6-4; 1-6; 7-6(4),F,149,3,2,67,112,43,67,19,45,6,11,15,62,112,11,5,61,95,47,61,10,34,5,8,14,57,95
2015-02-16 00:00:00.000,Rio Open presented by Claro Brazil ATP World Tour 500,CLAY,2,Rafael Nadal,Thomaz Bellucci,Rafael Nadal,6-4; 6-1,R32,92,2,0,31,43,20,31,8,12,0,2,8,28,43,3,6,28,65,16,28,12,37,7,13,9,28,65
2015-02-16 00:00:00.000,Rio Open presented by Claro Brazil ATP World Tour 500,CLAY,2,Pablo Carreno Busta,Carlos Berlocq,Pablo Carreno Busta,6-3; 6-7(3); 6-0,R32,147,1,1,58,92,42,58,22,34,3,3,13,64,92,2,2,68,100,37,68,19,32,5,10,14,56,100
2015-02-16 00:00:00.000,Rio Open presented by Claro Brazil ATP World Tour 500,CLAY,2,Albert Montanes,Maximo Gonzalez,Albert Montanes,4-6; 6-4; 6-0,R32,138,3,3,59,100,42,59,17,41,9,12,13,59,100,1,5,59,99,29,59,20,40,12,18,13,49,99
2015-02-16 00:00:00.000,Rio Open presented by Claro Brazil ATP World Tour 500,CLAY,2,Pablo Cuevas,Nicolas Almagro,Pablo Cuevas,4-6; 6-3; 6-4,R32,141,6,3,38,91,23,38,33,53,7,10,14,56,91,7,2,36,79,25,36,22,43,4,9,15,47,79
2015-02-16 00:00:00.000,Rio Open presented by Claro Brazil ATP World Tour 500,CLAY,2,Fabio Fognini,Jiri Vesely,Fabio Fognini,1-6; 7-6(7); 6-1,R32,100,7,5,49,86,33,49,21,37,3,7,14,54,86,12,3,41,67,30,41,13,26,4,7,12,43,67
2015-02-16 00:00:00.000,Rio Open presented by Claro Brazil ATP World Tour 500,CLAY,2,Pablo Andujar,Paolo Lorenzi,Pablo Andujar,3-6; 6-0; 6-3,R32,134,3,2,49,81,34,49,20,32,7,9,12,54,81,3,3,47,82,23,47,18,35,5,10,12,41,82
2015-02-16 00:00:00.000,Rio Open presented by Claro Brazil ATP World Tour 500,CLAY,2,Federico Delbonis,Diego Schwartzman,Federico Delbonis,6-7(8); 7-6(6); 2-1 RET,R32,161,4,4,58,111,39,58,25,53,9,14,14,64,111,2,9,62,118,38,62,28,56,9,14,13,66,118
2015-02-16 00:00:00.000,Rio Open presented by Claro Brazil ATP World Tour 500,CLAY,2,Martin Klizan,Dusan Lajovic,Martin Klizan,6-4; 0-6; 6-4,R32,128,0,7,46,78,31,46,13,32,5,10,13,44,78,5,2,58,94,37,58,17,36,8,12,13,54,94
2015-02-16 00:00:00.000,Rio Open presented by Claro Brazil ATP World Tour 500,CLAY,2,Blaz Rola,Leonardo Mayer,Blaz Rola,4-6; 7-6(3); 4-1 RET,R32,140,5,8,63,98,46,63,18,35,12,13,13,64,98,8,4,54,86,42,54,16,32,3,5,14,58,86
2015-02-16 00:00:00.000,Rio Open presented by Claro Brazil ATP World Tour 500,CLAY,2,Joao Souza,Facundo Arguello,Joao Souza,6-2; 6-1,R32,71,4,0,27,44,22,27,11,17,2,2,8,33,44,0,0,24,42,9,24,11,18,0,4,7,20,42
2015-02-16 00:00:00.000,Rio Open presented by Claro Brazil ATP World Tour 500,CLAY,2,Andreas Haider-Maurer,Albert Ramos-Vinolas,Andreas Haider-Maurer,3-6; 6-3; 6-2,R32,136,6,2,40,81,26,40,23,41,1,4,13,49,81,6,2,53,95,34,53,17,42,8,13,13,51,95
2015-02-16 00:00:00.000,Rio Open presented by Claro Brazil ATP World Tour 500,CLAY,2,Tommy Robredo,Elias Ymer,Tommy Robredo,6-4; 6-3,R32,92,1,0,31,54,22,31,13,23,1,3,9,35,54,0,0,49,76,23,49,17,27,12,17,10,40,76
2015-02-16 00:00:00.000,Rio Open presented by Claro Brazil ATP World Tour 500,CLAY,2,Juan Monaco,Santiago Giraldo,Juan Monaco,6-3; 3-0 RET,R32,56,5,1,18,36,16,18,12,18,1,1,6,28,36,1,3,28,39,16,28,3,11,2,5,6,19,39
2015-02-16 00:00:00.000,Rio Open presented by Claro Brazil ATP World Tour 500,CLAY,2,Jarkko Nieminen,Marco Cecchinato,Jarkko Nieminen,4-6; 6-3; 7-5,R32,123,4,2,49,85,39,49,21,36,0,2,16,60,85,6,4,69,107,46,69,19,38,4,7,15,65,107
2015-02-16 00:00:00.000,Rio Open presented by Claro Brazil ATP World Tour 500,CLAY,2,Thiemo de Bakker,Guilherme Clezar,Thiemo de Bakker,5-7; 6-3; 6-1,R32,127,10,3,46,93,35,46,25,47,7,9,14,60,93,1,2,60,93,36,60,17,33,5,10,14,53,93
2015-02-16 00:00:00.000,Rio Open presented by Claro Brazil ATP World Tour 500,CLAY,2,David Ferrer,Daniel Gimeno-Traver,David Ferrer,6-4; 6-3,R32,89,1,2,35,63,26,35,12,28,8,10,10,38,63,2,1,29,62,20,29,12,33,6,10,9,32,62
2015-02-16 00:00:00.000,Rio Open presented by Claro Brazil ATP World Tour 500,CLAY,2,Rafael Nadal,Pablo Carreno Busta,Rafael Nadal,7-5; 6-3,R16,122,4,1,49,73,30,49,16,24,2,3,11,46,73,2,0,53,74,36,53,8,21,8,11,10,44,74
2015-02-16 00:00:00.000,Rio Open presented by Claro Brazil ATP World Tour 500,CLAY,2,Pablo Cuevas,Albert Montanes,Pablo Cuevas,6-2; 6-2,R16,68,6,2,32,52,24,32,12,20,2,2,8,36,52,0,3,27,51,18,27,8,24,4,8,8,26,51
2015-02-16 00:00:00.000,Rio Open presented by Claro Brazil ATP World Tour 500,CLAY,2,Fabio Fognini,Pablo Andujar,Fabio Fognini,6-3; 6-2,R16,72,3,4,31,63,24,31,14,32,5,6,8,38,63,0,1,29,49,14,29,8,20,1,6,9,22,49
2015-02-16 00:00:00.000,Rio Open presented by Claro Brazil ATP World Tour 500,CLAY,2,Federico Delbonis,Martin Klizan,Federico Delbonis,6-2; 6-1,R16,74,2,2,18,38,14,18,12,20,0,1,7,26,38,0,4,34,64,18,34,9,30,7,13,8,27,64
2015-02-16 00:00:00.000,Rio Open presented by Claro Brazil ATP World Tour 500,CLAY,2,Joao Souza,Blaz Rola,Joao Souza,6-4; 6-7(9); 6-4,R16,182,5,2,65,111,45,65,23,46,6,9,16,68,111,5,11,72,111,50,72,13,39,7,12,16,63,111
2015-02-16 00:00:00.000,Rio Open presented by Claro Brazil ATP World Tour 500,CLAY,2,Andreas Haider-Maurer,Tommy Robredo,Andreas Haider-Maurer,6-3; 6-2,R16,68,2,2,30,53,26,30,14,23,0,0,9,40,53,2,3,29,50,20,29,9,21,8,11,8,29,50
2015-02-16 00:00:00.000,Rio Open presented by Claro Brazil ATP World Tour 500,CLAY,2,Juan Monaco,Jarkko Nieminen,Juan Monaco,6-1; 7-6(4),R16,83,5,2,29,54,20,29,15,25,2,4,9,35,54,0,3,41,75,19,41,18,34,8,13,10,37,75
2015-02-16 00:00:00.000,Rio Open presented by Claro Brazil ATP World Tour 500,CLAY,2,David Ferrer,Thiemo de Bakker,David Ferrer,7-6(8); 2-0 RET,R16,73,0,2,30,48,24,30,12,18,2,2,7,36,48,4,2,30,59,22,30,15,29,4,5,7,37,59
2015-02-16 00:00:00.000,Rio Open presented by Claro Brazil ATP World Tour 500,CLAY,2,Rafael Nadal,Pablo Cuevas,Rafael Nadal,4-6; 7-5; 6-0,Q,125,2,3,46,72,35,46,17,26,0,2,14,52,72,6,3,41,82,27,41,20,41,7,12,14,47,82
2015-02-16 00:00:00.000,Rio Open presented by Claro Brazil ATP World Tour 500,CLAY,2,Fabio Fognini,Federico Delbonis,Fabio Fognini,6-4; 6-7(10); 7-6(9),Q,192,3,3,72,133,47,72,36,61,10,13,17,83,133,8,9,72,131,53,72,26,59,8,12,17,79,131
2015-02-16 00:00:00.000,Rio Open presented by Claro Brazil ATP World Tour 500,CLAY,2,Andreas Haider-Maurer,Joao Souza,Andreas Haider-Maurer,7-6(4); 1-6; 6-4,Q,140,7,5,59,86,40,59,15,27,1,5,14,55,86,12,4,51,87,38,51,21,36,6,9,15,59,87
2015-02-16 00:00:00.000,Rio Open presented by Claro Brazil ATP World Tour 500,CLAY,2,David Ferrer,Juan Monaco,David Ferrer,6-3; 4-6; 6-2,Q,124,4,3,46,85,31,46,26,39,5,7,14,57,85,1,2,36,69,27,36,14,33,1,5,13,41,69
2015-02-16 00:00:00.000,Rio Open presented by Claro Brazil ATP World Tour 500,CLAY,2,Fabio Fognini,Rafael Nadal,Fabio Fognini,1-6; 6-2; 7-5,S,138,2,5,56,86,38,56,14,30,5,9,13,52,86,0,6,56,91,36,56,15,35,4,9,14,51,91
2015-02-16 00:00:00.000,Rio Open presented by Claro Brazil ATP World Tour 500,CLAY,2,David Ferrer,Andreas Haider-Maurer,David Ferrer,7-5; 6-1,S,85,0,2,30,56,20,30,12,26,1,4,9,32,56,0,3,31,58,14,31,9,27,2,9,10,23,58
2015-02-16 00:00:00.000,Rio Open presented by Claro Brazil ATP World Tour 500,CLAY,2,David Ferrer,Fabio Fognini,David Ferrer,6-2; 6-3,F,83,3,1,37,58,24,37,14,21,4,5,9,38,58,0,1,44,60,23,44,8,16,8,12,8,31,60
2015-02-23 00:00:00.000,Abierto Mexicano Telcel Mexico ATP World Tour 500,HARD,2,Kei Nishikori,Alejandro Gonzalez,Kei Nishikori,6-3; 7-5,R32,96,0,1,37,64,27,37,14,27,6,7,10,41,64,3,2,54,78,33,54,12,24,7,11,11,45,78
2015-02-23 00:00:00.000,Abierto Mexicano Telcel Mexico ATP World Tour 500,HARD,2,Yen-Hsun Lu,Victor Estrella Burgos,Yen-Hsun Lu,6-2; 7-5,R32,83,1,2,23,48,19,23,15,25,0,2,10,34,48,1,3,43,73,26,43,12,30,6,11,10,38,73
2015-02-23 00:00:00.000,Abierto Mexicano Telcel Mexico ATP World Tour 500,HARD,2,Andreas Haider-Maurer,Robin Haase,Andreas Haider-Maurer,6-3; 2-6; 6-2,R32,107,6,4,51,89,41,51,16,38,8,10,13,57,89,1,3,49,77,31,49,14,28,7,10,12,45,77
2015-02-23 00:00:00.000,Abierto Mexicano Telcel Mexico ATP World Tour 500,HARD,2,Alexandr Dolgopolov,Sam Groth,Alexandr Dolgopolov,6-3; 4-6; 6-0,R32,84,6,1,44,60,34,44,13,16,0,1,12,47,60,10,4,45,76,32,45,11,31,1,6,13,43,76
2015-02-23 00:00:00.000,Abierto Mexicano Telcel Mexico ATP World Tour 500,HARD,2,Kevin Anderson,Dustin Brown,Kevin Anderson,6-1; 6-2,R32,53,5,3,29,40,25,29,7,11,0,0,8,32,40,4,5,34,59,22,34,8,25,9,13,7,30,59
2015-02-23 00:00:00.000,Abierto Mexicano Telcel Mexico ATP World Tour 500,HARD,2,Steve Johnson,Ivan Dodig,Steve Johnson,6-4; 6-4,R32,76,4,1,26,52,23,26,17,26,0,0,10,40,52,6,6,36,65,27,36,15,29,7,9,10,42,65
2015-02-23 00:00:00.000,Abierto Mexicano Telcel Mexico ATP World Tour 500,HARD,2,Viktor Troicki,Daniel Garza,Viktor Troicki,6-4; 6-3,R32,68,11,3,33,64,26,33,18,31,4,5,10,44,64,1,2,31,56,19,31,13,25,2,5,9,32,56
2015-02-23 00:00:00.000,Abierto Mexicano Telcel Mexico ATP World Tour 500,HARD,2,Santiago Giraldo,Austin Krajicek,Santiago Giraldo,7-6(8); 6-1,R32,112,3,1,59,77,39,59,11,18,6,7,9,50,77,5,3,43,72,26,43,15,29,4,8,10,41,72
2015-02-23 00:00:00.000,Abierto Mexicano Telcel Mexico ATP World Tour 500,HARD,2,Ivo Karlovic,Teymuraz Gabashvili,Ivo Karlovic,6-4; 3-6; 6-2,R32,104,19,4,47,81,39,47,16,34,5,6,13,55,81,3,2,50,83,34,50,20,33,5,8,14,54,83
2015-02-23 00:00:00.000,Abierto Mexicano Telcel Mexico ATP World Tour 500,HARD,2,Dusan Lajovic,Thanasi Kokkinakis,Dusan Lajovic,6-4; 7-6(4),R32,110,4,2,46,70,27,46,14,24,4,8,11,41,70,5,4,51,87,34,51,13,36,3,8,11,47,87
2015-02-23 00:00:00.000,Abierto Mexicano Telcel Mexico ATP World Tour 500,HARD,2,Ryan Harrison,Donald Young,Ryan Harrison,4-6; 6-2; 4-2 RET,R32,98,6,4,48,71,34,48,12,23,7,11,12,46,71,2,7,38,72,23,38,16,34,2,8,12,39,72
2015-02-23 00:00:00.000,Abierto Mexicano Telcel Mexico ATP World Tour 500,HARD,2,Grigor Dimitrov,Filip Krajinovic,Grigor Dimitrov,6-3; 5-7; 6-0,R32,122,5,6,46,81,33,46,16,35,2,7,14,49,81,2,7,54,110,26,54,24,56,19,27,13,50,110
2015-02-23 00:00:00.000,Abierto Mexicano Telcel Mexico ATP World Tour 500,HARD,2,Benjamin Becker,Tobias Kamke,Benjamin Becker,7-6(4); 6-2,R32,97,8,1,39,69,29,39,16,30,1,2,10,45,69,5,2,39,69,25,39,14,30,1,4,10,39,69
2015-02-23 00:00:00.000,Abierto Mexicano Telcel Mexico ATP World Tour 500,HARD,2,Bernard Tomic,Adrian Mannarino,Bernard Tomic,3-6; 6-4; 6-4,R32,96,7,1,53,88,37,53,18,35,1,5,15,55,88,7,2,60,87,39,60,14,27,8,12,14,53,87
2015-02-23 00:00:00.000,Abierto Mexicano Telcel Mexico ATP World Tour 500,HARD,2,Marinko Matosevic,Marcel Granollers,Marinko Matosevic,6-4; 6-2,R32,84,2,5,30,56,25,30,10,26,5,7,9,35,56,3,4,32,61,19,32,10,29,3,8,9,29,61
2015-02-23 00:00:00.000,Abierto Mexicano Telcel Mexico ATP World Tour 500,HARD,2,David Ferrer,Igor Sijsling,David Ferrer,6-3; 7-6(4),R32,87,1,2,54,69,34,54,9,15,2,5,11,43,69,0,4,38,68,21,38,13,30,3,7,10,34,68
2015-02-23 00:00:00.000,Abierto Mexicano Telcel Mexico ATP World Tour 500,HARD,2,Kei Nishikori,Yen-Hsun Lu,Kei Nishikori,6-1; 6-3,R16,60,2,1,33,47,27,33,5,14,4,5,8,32,47,0,3,26,45,15,26,5,19,1,6,8,20,45
2015-02-23 00:00:00.000,Abierto Mexicano Telcel Mexico ATP World Tour 500,HARD,2,Alexandr Dolgopolov,Andreas Haider-Maurer,Alexandr Dolgopolov,6-2; 6-3,R16,60,5,0,19,39,16,19,17,20,2,2,8,33,39,3,8,30,62,20,30,12,32,6,10,9,32,62
2015-02-23 00:00:00.000,Abierto Mexicano Telcel Mexico ATP World Tour 500,HARD,2,Kevin Anderson,Steve Johnson,Kevin Anderson,3-6; 7-5; 6-3,R16,127,13,2,46,87,37,46,20,41,4,6,15,57,87,9,2,44,84,33,44,26,40,7,10,15,59,84
2015-02-23 00:00:00.000,Abierto Mexicano Telcel Mexico ATP World Tour 500,HARD,2,Viktor Troicki,Santiago Giraldo,Viktor Troicki,6-3; 6-4,R16,79,4,1,26,48,18,26,15,22,0,2,9,33,48,0,1,46,63,25,46,7,17,4,9,10,32,63
2015-02-23 00:00:00.000,Abierto Mexicano Telcel Mexico ATP World Tour 500,HARD,2,Ivo Karlovic,Dusan Lajovic,Ivo Karlovic,3-6; 6-3; 6-1,R16,86,18,7,40,67,36,40,14,27,1,2,12,50,67,3,4,43,71,29,43,14,28,3,7,13,43,71
2015-02-23 00:00:00.000,Abierto Mexicano Telcel Mexico ATP World Tour 500,HARD,2,Ryan Harrison,Grigor Dimitrov,Ryan Harrison,7-5; 4-6; 6-0,R16,109,5,2,38,76,32,38,20,38,0,2,14,52,76,3,7,40,88,26,40,24,48,4,9,14,50,88
2015-02-23 00:00:00.000,Abierto Mexicano Telcel Mexico ATP World Tour 500,HARD,2,Bernard Tomic,Benjamin Becker,Bernard Tomic,4-6; 6-3; 6-2,R16,78,13,2,61,88,45,61,12,27,3,5,14,57,88,5,1,44,64,30,44,12,20,2,6,13,42,64
2015-02-23 00:00:00.000,Abierto Mexicano Telcel Mexico ATP World Tour 500,HARD,2,David Ferrer,Marinko Matosevic,David Ferrer,7-6(3); 6-4,R16,103,0,4,30,61,19,30,19,31,0,3,11,38,61,1,6,47,74,26,47,11,27,0,4,11,37,74
2015-02-23 00:00:00.000,Abierto Mexicano Telcel Mexico ATP World Tour 500,HARD,2,Kei Nishikori,Alexandr Dolgopolov,Kei Nishikori,6-4; 6-4,Q,101,2,1,41,63,26,41,17,22,4,5,10,43,63,4,3,47,89,29,47,21,42,7,10,10,50,89
2015-02-23 00:00:00.000,Abierto Mexicano Telcel Mexico ATP World Tour 500,HARD,2,Kevin Anderson,Viktor Troicki,Kevin Anderson,3-6; 6-3; 6-3,Q,106,6,3,40,67,34,40,15,27,0,1,13,49,67,4,4,54,85,37,54,15,31,6,9,14,52,85
2015-02-23 00:00:00.000,Abierto Mexicano Telcel Mexico ATP World Tour 500,HARD,2,Ryan Harrison,Ivo Karlovic,Ryan Harrison,4-6; 7-6(0); 7-6(4),Q,146,7,2,66,98,53,66,22,32,1,2,17,75,98,16,5,70,107,58,70,18,37,7,7,17,76,107
2015-02-23 00:00:00.000,Abierto Mexicano Telcel Mexico ATP World Tour 500,HARD,2,David Ferrer,Bernard Tomic,David Ferrer,6-4; 3-6; 6-1,Q,100,1,2,46,68,35,46,16,22,2,3,13,51,68,8,3,52,84,40,52,12,32,3,6,13,52,84
2015-02-23 00:00:00.000,Abierto Mexicano Telcel Mexico ATP World Tour 500,HARD,2,Kei Nishikori,Kevin Anderson,Kei Nishikori,6-2; 3-6; 6-3,S,122,6,1,42,76,32,42,21,34,3,5,13,53,76,11,3,47,79,34,47,14,32,8,12,13,48,79
2015-02-23 00:00:00.000,Abierto Mexicano Telcel Mexico ATP World Tour 500,HARD,2,David Ferrer,Ryan Harrison,David Ferrer,4-6; 6-0; 6-0,S,112,1,4,41,69,34,41,15,28,4,5,11,49,69,4,2,41,73,21,41,14,32,7,13,11,35,73
2015-02-23 00:00:00.000,Abierto Mexicano Telcel Mexico ATP World Tour 500,HARD,2,David Ferrer,Kei Nishikori,David Ferrer,6-3; 7-5,F,109,0,4,44,74,25,44,16,30,5,9,11,41,74,1,2,35,65,18,35,12,30,4,10,10,30,65
2015-02-23 00:00:00.000,Argentina Open presentado por Buenos Aires Ciudad Argentina ATP World Tour 250,CLAY,2,Rafael Nadal,N/A Bye,Rafael Nadal,,R32,0,0,0,0,0,0,0,0,0,0,0,0,0,0,0,0,0,0,0,0,0,0,0,0,0,0,0
2015-02-23 00:00:00.000,Argentina Open presentado por Buenos Aires Ciudad Argentina ATP World Tour 250,CLAY,2,Facundo Arguello,Albert Montanes,Facundo Arguello,6-3; 6-2,R32,62,5,2,30,47,26,30,10,17,0,0,9,36,47,2,3,30,44,18,30,6,14,1,4,8,24,44
2015-02-23 00:00:00.000,Argentina Open presentado por Buenos Aires Ciudad Argentina ATP World Tour 250,CLAY,2,Paolo Lorenzi,Thomaz Bellucci,Paolo Lorenzi,6-4; 6-7(5); 6-1,R32,159,4,2,74,112,55,74,17,38,11,12,15,72,112,5,6,55,96,41,55,17,41,4,8,14,58,96
2015-02-23 00:00:00.000,Argentina Open presentado por Buenos Aires Ciudad Argentina ATP World Tour 250,CLAY,2,Federico Delbonis,Pablo Carreno Busta,Federico Delbonis,7-6(2); 3-0 RET,R32,74,2,0,26,49,21,26,14,23,2,3,7,35,49,3,3,37,57,24,37,8,20,4,7,8,32,57
2015-02-23 00:00:00.000,Argentina Open presentado por Buenos Aires Ciudad Argentina ATP World Tour 250,CLAY,2,Fabio Fognini,N/A Bye,Fabio Fognini,,R32,0,0,0,0,0,0,0,0,0,0,0,0,0,0,0,0,0,0,0,0,0,0,0,0,0,0,0
2015-02-23 00:00:00.000,Argentina Open presentado por Buenos Aires Ciudad Argentina ATP World Tour 250,CLAY,2,Carlos Berlocq,Diego Schwartzman,Carlos Berlocq,6-3; 6-3,R32,62,8,0,32,45,26,32,10,13,0,0,9,36,45,1,4,28,50,17,28,12,22,2,5,9,29,50
2015-02-23 00:00:00.000,Argentina Open presentado por Buenos Aires Ciudad Argentina ATP World Tour 250,CLAY,2,Facundo Bagnis,Marco Cecchinato,Facundo Bagnis,4-6; 7-5; 6-3,R32,130,3,1,54,86,32,54,23,32,3,7,15,55,86,2,1,74,105,44,74,14,31,1,7,16,58,105
2015-02-23 00:00:00.000,Argentina Open presentado por Buenos Aires Ciudad Argentina ATP World Tour 250,CLAY,2,Blaz Rola,Jiri Vesely,Blaz Rola,6-4; 6-3,R32,92,4,1,45,61,33,45,7,16,4,5,9,40,61,9,5,56,80,30,56,11,24,8,12,10,41,80
2015-02-23 00:00:00.000,Argentina Open presentado por Buenos Aires Ciudad Argentina ATP World Tour 250,CLAY,2,Leonardo Mayer,Stephane Robert,Leonardo Mayer,6-0; 6-1,R32,47,6,0,28,39,22,28,7,11,2,2,7,29,39,2,4,26,46,14,26,3,20,7,12,6,17,46
2015-02-23 00:00:00.000,Argentina Open presentado por Buenos Aires Ciudad Argentina ATP World Tour 250,CLAY,2,Juan Monaco,Maximo Gonzalez,Juan Monaco,6-2; 6-2,R32,69,2,0,35,47,24,35,6,12,3,5,8,30,47,0,0,34,49,15,34,5,15,5,11,8,20,49
2015-02-23 00:00:00.000,Argentina Open presentado por Buenos Aires Ciudad Argentina ATP World Tour 250,CLAY,2,Guido Andreozzi,Andres Molteni,Guido Andreozzi,6-2; 6-2,R32,71,3,2,33,53,25,33,11,20,3,3,8,36,53,1,1,28,47,17,28,7,19,3,7,8,24,47
2015-02-23 00:00:00.000,Argentina Open presentado por Buenos Aires Ciudad Argentina ATP World Tour 250,CLAY,2,Pablo Cuevas,N/A Bye,Pablo Cuevas,,R32,0,0,0,0,0,0,0,0,0,0,0,0,0,0,0,0,0,0,0,0,0,0,0,0,0,0,0
2015-02-23 00:00:00.000,Argentina Open presentado por Buenos Aires Ciudad Argentina ATP World Tour 250,CLAY,2,Nicolas Almagro,Pablo Andujar,Nicolas Almagro,6-3; 3-6; 6-2,R32,95,5,2,42,63,32,42,15,21,1,3,13,47,63,1,3,64,83,39,64,9,19,3,7,13,48,83
2015-02-23 00:00:00.000,Argentina Open presentado por Buenos Aires Ciudad Argentina ATP World Tour 250,CLAY,2,Albert Ramos-Vinolas,Horacio Zeballos,Albert Ramos-Vinolas,6-4; 6-1,R32,72,2,2,29,42,26,29,7,13,0,0,8,33,42,2,1,38,60,25,38,8,22,4,8,9,33,60
2015-02-23 00:00:00.000,Argentina Open presentado por Buenos Aires Ciudad Argentina ATP World Tour 250,CLAY,2,Renzo Olivo,Jarkko Nieminen,Renzo Olivo,7-6(3); 5-7; 6-0,R32,131,5,11,45,84,38,45,21,39,1,3,15,59,84,4,4,73,112,48,73,15,39,9,13,15,63,112
2015-02-23 00:00:00.000,Argentina Open presentado por Buenos Aires Ciudad Argentina ATP World Tour 250,CLAY,2,Tommy Robredo,N/A Bye,Tommy Robredo,,R32,0,0,0,0,0,0,0,0,0,0,0,0,0,0,0,0,0,0,0,0,0,0,0,0,0,0,0
2015-02-23 00:00:00.000,Argentina Open presentado por Buenos Aires Ciudad Argentina ATP World Tour 250,CLAY,2,Rafael Nadal,Facundo Arguello,Rafael Nadal,6-4; 6-0,R16,65,2,0,30,42,23,30,7,12,2,3,8,30,42,2,3,33,47,15,33,5,14,3,8,8,20,47
2015-02-23 00:00:00.000,Argentina Open presentado por Buenos Aires Ciudad Argentina ATP World Tour 250,CLAY,2,Federico Delbonis,Paolo Lorenzi,Federico Delbonis,6-4; 6-2,R16,78,0,1,29,51,21,29,13,22,1,3,9,34,51,0,2,35,55,20,35,5,20,5,10,9,25,55
2015-02-23 00:00:00.000,Argentina Open presentado por Buenos Aires Ciudad Argentina ATP World Tour 250,CLAY,2,Carlos Berlocq,Fabio Fognini,Carlos Berlocq,6-3; 6-0,R16,56,4,0,24,37,20,24,7,13,0,1,7,27,37,0,1,23,45,11,23,7,22,3,9,8,18,45
2015-02-23 00:00:00.000,Argentina Open presentado por Buenos Aires Ciudad Argentina ATP World Tour 250,CLAY,2,Blaz Rola,Facundo Bagnis,Blaz Rola,6-2; 6-1,R16,65,0,0,44,62,29,44,12,18,3,3,8,41,62,0,5,23,42,12,23,7,19,4,8,7,19,42
2015-02-23 00:00:00.000,Argentina Open presentado por Buenos Aires Ciudad Argentina ATP World Tour 250,CLAY,2,Juan Monaco,Leonardo Mayer,Juan Monaco,6-4; 6-4,R16,101,0,1,56,66,39,56,5,10,6,7,10,44,66,3,2,44,68,26,44,11,24,5,8,10,37,68
2015-02-23 00:00:00.000,Argentina Open presentado por Buenos Aires Ciudad Argentina ATP World Tour 250,CLAY,2,Pablo Cuevas,Guido Andreozzi,Pablo Cuevas,7-6(4); 6-1,R16,84,7,2,48,72,39,48,10,24,3,4,10,49,72,1,2,35,55,22,35,11,20,4,7,9,33,55
2015-02-23 00:00:00.000,Argentina Open presentado por Buenos Aires Ciudad Argentina ATP World Tour 250,CLAY,2,Nicolas Almagro,Albert Ramos-Vinolas,Nicolas Almagro,6-3; 6-4,R16,87,7,2,42,63,32,42,12,21,2,2,10,44,63,0,1,39,64,27,39,12,25,6,8,9,39,64
2015-02-23 00:00:00.000,Argentina Open presentado por Buenos Aires Ciudad Argentina ATP World Tour 250,CLAY,2,Tommy Robredo,Renzo Olivo,Tommy Robredo,6-1; 6-2,R16,66,2,1,37,54,29,37,9,17,2,2,8,38,54,0,5,34,52,18,34,7,18,3,7,7,25,52
2015-02-23 00:00:00.000,Argentina Open presentado por Buenos Aires Ciudad Argentina ATP World Tour 250,CLAY,2,Rafael Nadal,Federico Delbonis,Rafael Nadal,6-1; 6-1,Q,62,0,2,24,38,20,24,9,14,0,0,7,29,38,0,2,29,46,15,29,5,17,4,9,7,20,46
2015-02-23 00:00:00.000,Argentina Open presentado por Buenos Aires Ciudad Argentina ATP World Tour 250,CLAY,2,Carlos Berlocq,Blaz Rola,Carlos Berlocq,6-1; 6-3,Q,79,2,0,36,49,23,36,8,13,2,4,8,31,49,1,2,42,57,19,42,6,15,5,11,8,25,57
2015-02-23 00:00:00.000,Argentina Open presentado por Buenos Aires Ciudad Argentina ATP World Tour 250,CLAY,2,Juan Monaco,Pablo Cuevas,Juan Monaco,7-6(1); 6-7(4); 6-4,Q,158,5,0,80,105,51,80,16,25,5,9,17,67,105,8,4,69,115,46,69,22,46,6,11,17,68,115
2015-02-23 00:00:00.000,Argentina Open presentado por Buenos Aires Ciudad Argentina ATP World Tour 250,CLAY,2,Nicolas Almagro,Tommy Robredo,Nicolas Almagro,6-3; 6-2,Q,61,3,1,39,56,32,39,9,17,2,2,9,41,56,2,1,28,42,18,28,7,14,1,4,8,25,42
2015-02-23 00:00:00.000,Argentina Open presentado por Buenos Aires Ciudad Argentina ATP World Tour 250,CLAY,2,Rafael Nadal,Carlos Berlocq,Rafael Nadal,7-6(7); 6-2,S,113,1,1,45,72,32,45,16,27,3,4,10,48,72,3,1,49,71,35,49,8,22,6,9,10,43,71
2015-02-23 00:00:00.000,Argentina Open presentado por Buenos Aires Ciudad Argentina ATP World Tour 250,CLAY,2,Juan Monaco,Nicolas Almagro,Juan Monaco,6-3; 6-7(6); 6-4,S,148,2,1,86,110,53,86,12,24,12,15,15,65,110,7,5,51,102,37,51,21,51,4,10,16,58,102
2015-02-23 00:00:00.000,Argentina Open presentado por Buenos Aires Ciudad Argentina ATP World Tour 250,CLAY,2,Rafael Nadal,Juan Monaco,Rafael Nadal,6-4; 6-1,F,87,1,0,38,49,30,38,4,11,0,0,8,34,49,0,0,45,60,26,45,6,15,5,9,9,32,60
2015-02-23 00:00:00.000,Dubai Duty Free Tennis Championships U.A.E. ATP World Tour 500,HARD,2,Novak Djokovic,Vasek Pospisil,Novak Djokovic,6-4; 6-4,R32,78,5,2,28,56,22,28,17,28,2,3,10,39,56,2,6,32,62,26,32,10,30,1,4,10,36,62
2015-02-23 00:00:00.000,Dubai Duty Free Tennis Championships U.A.E. ATP World Tour 500,HARD,2,Andrey Golubev,Fabrice Martin,Andrey Golubev,7-5; 6-4,R32,87,2,6,48,78,32,48,16,30,2,4,11,48,78,0,1,32,59,22,32,12,27,0,4,11,34,59
2015-02-23 00:00:00.000,Dubai Duty Free Tennis Championships U.A.E. ATP World Tour 500,HARD,2,Marsel Ilhan,Alexander Zverev,Marsel Ilhan,6-1; 7-6(4),R32,76,7,2,36,66,31,36,15,30,0,1,10,46,66,6,1,32,54,22,32,11,22,4,7,9,33,54
2015-02-23 00:00:00.000,Dubai Duty Free Tennis Championships U.A.E. ATP World Tour 500,HARD,2,Feliciano Lopez,James Ward,Feliciano Lopez,6-4; 6-4,R32,91,13,7,46,82,35,46,17,36,8,8,10,52,82,7,5,32,63,22,32,16,31,7,9,10,38,63
2015-02-23 00:00:00.000,Dubai Duty Free Tennis Championships U.A.E. ATP World Tour 500,HARD,2,Tomas Berdych,Jeremy Chardy,Tomas Berdych,7-6(2); 6-4,R32,93,5,1,35,62,29,35,15,27,2,4,11,44,62,12,6,51,80,40,51,7,29,3,6,11,47,80
2015-02-23 00:00:00.000,Dubai Duty Free Tennis Championships U.A.E. ATP World Tour 500,HARD,2,Simone Bolelli,Lucas Pouille,Simone Bolelli,6-3; 6-3,R32,57,3,2,30,48,23,30,14,18,1,1,9,37,48,4,3,28,48,19,28,10,20,1,4,9,29,48
2015-02-23 00:00:00.000,Dubai Duty Free Tennis Championships U.A.E. ATP World Tour 500,HARD,2,Sergiy Stakhovsky,Lukas Rosol,Sergiy Stakhovsky,4-6; 6-1; 6-4,R32,102,6,2,53,82,41,53,16,29,6,7,14,57,82,2,7,53,98,37,53,22,45,7,10,13,59,98
2015-02-23 00:00:00.000,Dubai Duty Free Tennis Championships U.A.E. ATP World Tour 500,HARD,2,Denis Istomin,Ernests Gulbis,Denis Istomin,7-5; 6-2,R32,93,8,0,36,62,27,36,14,26,3,5,10,41,62,5,11,41,74,27,41,10,33,5,10,10,37,74
2015-02-23 00:00:00.000,Dubai Duty Free Tennis Championships U.A.E. ATP World Tour 500,HARD,2,Marcos Baghdatis,David Goffin,Marcos Baghdatis,6-2; 7-5,R32,71,4,9,28,60,22,28,12,32,4,7,10,34,60,2,3,24,57,15,24,13,33,1,7,10,28,57
2015-02-23 00:00:00.000,Dubai Duty Free Tennis Championships U.A.E. ATP World Tour 500,HARD,2,Borna Coric,Malek Jaziri,Borna Coric,5-7; 6-3; 6-3,R32,111,8,2,49,89,37,49,23,40,3,5,15,60,89,3,3,51,85,31,51,22,34,4,8,15,53,85
2015-02-23 00:00:00.000,Dubai Duty Free Tennis Championships U.A.E. ATP World Tour 500,HARD,2,Joao Sousa,James McGee,Joao Sousa,6-1; 6-2,R32,65,2,1,41,59,27,41,10,18,2,3,8,37,59,1,3,26,43,15,26,4,17,5,10,7,19,43
2015-02-23 00:00:00.000,Dubai Duty Free Tennis Championships U.A.E. ATP World Tour 500,HARD,2,Andy Murray,Gilles Muller,Andy Murray,6-4; 7-5,R32,105,9,6,45,71,36,45,13,26,3,4,11,49,71,11,3,51,85,36,51,13,34,5,8,11,49,85
2015-02-23 00:00:00.000,Dubai Duty Free Tennis Championships U.A.E. ATP World Tour 500,HARD,2,Roberto Bautista Agut,Dominic Thiem,Roberto Bautista Agut,6-3; 6-2,R32,51,0,3,34,46,29,34,7,12,0,0,9,36,46,0,2,22,43,16,22,10,21,0,3,8,26,43
2015-02-23 00:00:00.000,Dubai Duty Free Tennis Championships U.A.E. ATP World Tour 500,HARD,2,Richard Gasquet,Andreas Seppi,Richard Gasquet,6-4; 6-7(1); 6-4,R32,142,5,2,55,99,41,55,23,44,1,4,16,64,99,8,4,44,96,30,44,31,52,4,9,16,61,96
2015-02-23 00:00:00.000,Dubai Duty Free Tennis Championships U.A.E. ATP World Tour 500,HARD,2,Fernando Verdasco,Guillermo Garcia-Lopez,Fernando Verdasco,7-5; 6-1,R32,81,7,3,41,61,32,41,11,20,4,5,10,43,61,2,4,31,57,16,31,13,26,4,8,9,29,57
2015-02-23 00:00:00.000,Dubai Duty Free Tennis Championships U.A.E. ATP World Tour 500,HARD,2,Roger Federer,Mikhail Youzhny,Roger Federer,6-3; 6-1,R32,56,8,2,31,49,26,31,9,18,0,0,8,35,49,0,3,20,45,9,20,14,25,3,7,8,23,45
2015-02-23 00:00:00.000,Dubai Duty Free Tennis Championships U.A.E. ATP World Tour 500,HARD,2,Novak Djokovic,Andrey Golubev,Novak Djokovic,6-1; 6-2,R16,60,1,0,28,43,21,28,11,15,0,0,8,32,43,2,1,27,49,16,27,7,22,6,10,7,23,49
2015-02-23 00:00:00.000,Dubai Duty Free Tennis Championships U.A.E. ATP World Tour 500,HARD,2,Marsel Ilhan,Feliciano Lopez,Marsel Ilhan,3-6; 7-5; 6-3,R16,117,8,1,64,103,45,64,23,39,11,12,15,68,103,16,6,43,93,32,43,31,50,7,9,15,63,93
2015-02-23 00:00:00.000,Dubai Duty Free Tennis Championships U.A.E. ATP World Tour 500,HARD,2,Tomas Berdych,Simone Bolelli,Tomas Berdych,7-6(7); 5-7; 6-0,R16,144,12,1,52,90,40,52,27,38,5,6,15,67,90,5,2,80,109,50,80,16,29,4,7,15,66,109
2015-02-23 00:00:00.000,Dubai Duty Free Tennis Championships U.A.E. ATP World Tour 500,HARD,2,Sergiy Stakhovsky,Denis Istomin,Sergiy Stakhovsky,6-4; 3-6; 6-4,R16,102,8,2,51,86,37,51,19,35,4,6,14,56,86,7,2,50,84,38,50,18,34,5,8,15,56,84
2015-02-23 00:00:00.000,Dubai Duty Free Tennis Championships U.A.E. ATP World Tour 500,HARD,2,Borna Coric,Marcos Baghdatis,Borna Coric,6-4; 3-6; 6-6 RET,R16,176,1,5,56,110,37,56,21,54,6,12,15,58,110,5,6,54,117,37,54,26,63,7,13,16,63,117
2015-02-23 00:00:00.000,Dubai Duty Free Tennis Championships U.A.E. ATP World Tour 500,HARD,2,Andy Murray,Joao Sousa,Andy Murray,6-0; 6-2,R16,58,5,2,24,36,20,24,8,12,0,0,7,28,36,1,3,26,50,15,26,7,24,4,9,7,22,50
2015-02-23 00:00:00.000,Dubai Duty Free Tennis Championships U.A.E. ATP World Tour 500,HARD,2,Richard Gasquet,Roberto Bautista Agut,Richard Gasquet,6-4; 3-6; 7-6(6),R16,141,4,3,55,93,42,55,20,38,4,7,15,62,93,11,4,77,114,51,77,21,37,9,12,16,72,114
2015-02-23 00:00:00.000,Dubai Duty Free Tennis Championships U.A.E. ATP World Tour 500,HARD,2,Roger Federer,Fernando Verdasco,Roger Federer,6-4; 6-3,R16,60,4,0,28,40,24,28,7,12,0,2,9,31,40,5,3,28,53,17,28,10,25,2,7,10,27,53
2015-02-23 00:00:00.000,Dubai Duty Free Tennis Championships U.A.E. ATP World Tour 500,HARD,2,Novak Djokovic,Marsel Ilhan,Novak Djokovic,6-1; 6-1,Q,49,7,1,27,42,23,27,8,15,3,3,7,31,42,3,1,24,41,15,24,2,17,2,7,7,17,41
2015-02-23 00:00:00.000,Dubai Duty Free Tennis Championships U.A.E. ATP World Tour 500,HARD,2,Tomas Berdych,Sergiy Stakhovsky,Tomas Berdych,6-3; 4-6; 6-2,Q,102,9,0,43,77,35,43,21,34,3,5,14,56,77,0,3,49,76,33,49,11,27,4,8,13,44,76
2015-02-23 00:00:00.000,Dubai Duty Free Tennis Championships U.A.E. ATP World Tour 500,HARD,2,Borna Coric,Andy Murray,Borna Coric,6-1; 6-3,Q,79,0,1,18,37,16,18,16,19,0,0,8,32,37,3,3,37,67,22,37,11,30,4,8,8,33,67
2015-02-23 00:00:00.000,Dubai Duty Free Tennis Championships U.A.E. ATP World Tour 500,HARD,2,Roger Federer,Richard Gasquet,Roger Federer,6-1 RET,Q,21,3,0,8,12,8,8,4,4,0,0,3,12,12,0,2,16,25,9,16,2,9,1,4,4,11,25
2015-02-23 00:00:00.000,Dubai Duty Free Tennis Championships U.A.E. ATP World Tour 500,HARD,2,Novak Djokovic,Tomas Berdych,Novak Djokovic,6-0; 5-7; 6-4,S,124,4,1,54,85,39,54,14,31,2,5,14,53,85,4,0,42,78,25,42,17,36,4,10,14,42,78
2015-02-23 00:00:00.000,Dubai Duty Free Tennis Championships U.A.E. ATP World Tour 500,HARD,2,Roger Federer,Borna Coric,Roger Federer,6-2; 6-1,S,56,3,3,32,49,23,32,7,17,2,3,8,30,49,2,3,25,40,12,25,3,15,2,7,7,15,40
2015-02-23 00:00:00.000,Dubai Duty Free Tennis Championships U.A.E. ATP World Tour 500,HARD,2,Roger Federer,Novak Djokovic,Roger Federer,6-3; 7-5,F,84,12,1,51,79,41,51,11,28,7,7,11,52,79,1,2,39,62,27,39,12,23,0,2,10,39,62
2015-03-12 00:00:00.000,BNP Paribas Open CA; U.S.A. ATP World Tour Masters 1000,HARD,2,Novak Djokovic,N/A Bye,Novak Djokovic,,R128,0,0,0,0,0,0,0,0,0,0,0,0,0,0,0,0,0,0,0,0,0,0,0,0,0,0,0
2015-03-12 00:00:00.000,BNP Paribas Open CA; U.S.A. ATP World Tour Masters 1000,HARD,2,Marcos Baghdatis,Jiri Vesely,Marcos Baghdatis,6-3; 1-1 RET,R128,49,3,3,15,36,9,15,10,21,2,4,6,19,36,1,2,22,27,10,22,2,5,1,4,5,12,27
2015-03-12 00:00:00.000,BNP Paribas Open CA; U.S.A. ATP World Tour Masters 1000,HARD,2,Albert Ramos-Vinolas,Viktor Troicki,Albert Ramos-Vinolas,6-4; 6-4,R128,89,2,2,31,58,25,31,18,27,3,3,10,43,58,5,1,22,55,17,22,21,33,3,5,10,38,55
2015-03-12 00:00:00.000,BNP Paribas Open CA; U.S.A. ATP World Tour Masters 1000,HARD,2,Julien Benneteau,N/A Bye,Julien Benneteau,,R128,0,0,0,0,0,0,0,0,0,0,0,0,0,0,0,0,0,0,0,0,0,0,0,0,0,0,0
2015-03-12 00:00:00.000,BNP Paribas Open CA; U.S.A. ATP World Tour Masters 1000,HARD,2,John Isner,N/A Bye,John Isner,,R128,0,0,0,0,0,0,0,0,0,0,0,0,0,0,0,0,0,0,0,0,0,0,0,0,0,0,0
2015-03-12 00:00:00.000,BNP Paribas Open CA; U.S.A. ATP World Tour Masters 1000,HARD,2,Jurgen Melzer,Dennis Novikov,Jurgen Melzer,6-4; 6-4,R128,82,7,6,47,64,38,47,7,17,2,3,10,45,64,3,3,34,72,22,34,18,38,4,7,10,40,72
2015-03-12 00:00:00.000,BNP Paribas Open CA; U.S.A. ATP World Tour Masters 1000,HARD,2,Federico Delbonis,Dusan Lajovic,Federico Delbonis,6-4; 6-3,R128,70,3,1,35,55,27,35,10,20,2,3,9,37,55,3,2,39,65,23,39,12,26,4,8,10,35,65
2015-03-12 00:00:00.000,BNP Paribas Open CA; U.S.A. ATP World Tour Masters 1000,HARD,2,Kevin Anderson,N/A Bye,Kevin Anderson,,R128,0,0,0,0,0,0,0,0,0,0,0,0,0,0,0,0,0,0,0,0,0,0,0,0,0,0,0
2015-03-12 00:00:00.000,BNP Paribas Open CA; U.S.A. ATP World Tour Masters 1000,HARD,2,Marin Cilic,N/A Bye,Marin Cilic,,R128,0,0,0,0,0,0,0,0,0,0,0,0,0,0,0,0,0,0,0,0,0,0,0,0,0,0,0
2015-03-12 00:00:00.000,BNP Paribas Open CA; U.S.A. ATP World Tour Masters 1000,HARD,2,Juan Monaco,Teymuraz Gabashvili,Juan Monaco,6-2; 3-6; 6-3,R128,123,5,0,66,92,41,66,14,26,10,14,13,55,92,6,3,51,89,35,51,11,38,5,11,13,46,89
2015-03-12 00:00:00.000,BNP Paribas Open CA; U.S.A. ATP World Tour Masters 1000,HARD,2,Thanasi Kokkinakis,Jan-Lennard Struff,Thanasi Kokkinakis,7-6(3); 6-3,R128,88,10,2,47,67,37,47,13,20,3,3,11,50,67,3,4,36,66,33,36,11,30,1,2,10,44,66
2015-03-12 00:00:00.000,BNP Paribas Open CA; U.S.A. ATP World Tour Masters 1000,HARD,2,Guillermo Garcia-Lopez,N/A Bye,Guillermo Garcia-Lopez,,R128,0,0,0,0,0,0,0,0,0,0,0,0,0,0,0,0,0,0,0,0,0,0,0,0,0,0,0
2015-03-12 00:00:00.000,BNP Paribas Open CA; U.S.A. ATP World Tour Masters 1000,HARD,2,Bernard Tomic,N/A Bye,Bernard Tomic,,R128,0,0,0,0,0,0,0,0,0,0,0,0,0,0,0,0,0,0,0,0,0,0,0,0,0,0,0
2015-03-12 00:00:00.000,BNP Paribas Open CA; U.S.A. ATP World Tour Masters 1000,HARD,2,Borna Coric,Andreas Haider-Maurer,Borna Coric,6-4; 6-4,R128,86,5,1,34,53,29,34,12,19,2,2,10,41,53,1,2,26,58,18,26,16,32,4,6,10,34,58
2015-03-12 00:00:00.000,BNP Paribas Open CA; U.S.A. ATP World Tour Masters 1000,HARD,2,Ivan Dodig,Joao Sousa,Ivan Dodig,6-3; 7-5,R128,88,10,4,29,56,25,29,14,27,0,1,10,39,56,1,3,32,66,23,32,14,34,1,5,11,37,66
2015-03-12 00:00:00.000,BNP Paribas Open CA; U.S.A. ATP World Tour Masters 1000,HARD,2,David Ferrer,N/A Bye,David Ferrer,,R128,0,0,0,0,0,0,0,0,0,0,0,0,0,0,0,0,0,0,0,0,0,0,0,0,0,0,0
2015-03-12 00:00:00.000,BNP Paribas Open CA; U.S.A. ATP World Tour Masters 1000,HARD,2,Andy Murray,N/A Bye,Andy Murray,,R128,0,0,0,0,0,0,0,0,0,0,0,0,0,0,0,0,0,0,0,0,0,0,0,0,0,0,0
2015-03-12 00:00:00.000,BNP Paribas Open CA; U.S.A. ATP World Tour Masters 1000,HARD,2,Vasek Pospisil,Mikhail Kukushkin,Vasek Pospisil,6-4; 4-2 RET,R128,63,9,0,33,47,31,33,6,14,2,2,8,37,47,0,1,32,46,18,32,12,14,4,6,8,30,46
2015-03-12 00:00:00.000,BNP Paribas Open CA; U.S.A. ATP World Tour Masters 1000,HARD,2,Tim Smyczek,Benjamin Becker,Tim Smyczek,6-3; 7-6(4),R128,82,1,1,44,63,33,44,12,19,0,1,11,45,63,3,2,46,78,34,46,12,32,8,10,10,46,78
2015-03-12 00:00:00.000,BNP Paribas Open CA; U.S.A. ATP World Tour Masters 1000,HARD,2,Philipp Kohlschreiber,N/A Bye,Philipp Kohlschreiber,,R128,0,0,0,0,0,0,0,0,0,0,0,0,0,0,0,0,0,0,0,0,0,0,0,0,0,0,0
2015-03-12 00:00:00.000,BNP Paribas Open CA; U.S.A. ATP World Tour Masters 1000,HARD,2,Fabio Fognini,N/A Bye,Fabio Fognini,,R128,0,0,0,0,0,0,0,0,0,0,0,0,0,0,0,0,0,0,0,0,0,0,0,0,0,0,0
2015-03-12 00:00:00.000,BNP Paribas Open CA; U.S.A. ATP World Tour Masters 1000,HARD,2,Adrian Mannarino,Mischa Zverev,Adrian Mannarino,6-4; 6-4,R128,79,2,3,29,60,22,29,16,31,4,7,10,38,60,6,5,43,68,25,43,9,25,6,11,10,34,68
2015-03-12 00:00:00.000,BNP Paribas Open CA; U.S.A. ATP World Tour Masters 1000,HARD,2,Daniel Gimeno-Traver,Sam Groth,Daniel Gimeno-Traver,7-6(5); 7-6(6),R128,96,5,4,65,87,46,65,13,22,4,5,12,59,87,15,5,51,84,37,51,19,33,5,6,12,56,84
2015-03-12 00:00:00.000,BNP Paribas Open CA; U.S.A. ATP World Tour Masters 1000,HARD,2,Ernests Gulbis,N/A Bye,Ernests Gulbis,,R128,0,0,0,0,0,0,0,0,0,0,0,0,0,0,0,0,0,0,0,0,0,0,0,0,0,0,0
2015-03-12 00:00:00.000,BNP Paribas Open CA; U.S.A. ATP World Tour Masters 1000,HARD,2,Feliciano Lopez,N/A Bye,Feliciano Lopez,,R128,0,0,0,0,0,0,0,0,0,0,0,0,0,0,0,0,0,0,0,0,0,0,0,0,0,0,0
2015-03-12 00:00:00.000,BNP Paribas Open CA; U.S.A. ATP World Tour Masters 1000,HARD,2,Edouard Roger-Vasselin,Marinko Matosevic,Edouard Roger-Vasselin,5-7; 6-4; 6-3,R128,129,2,2,51,80,38,51,17,29,3,6,15,55,80,4,6,56,107,34,56,29,51,12,17,16,63,107
2015-03-12 00:00:00.000,BNP Paribas Open CA; U.S.A. ATP World Tour Masters 1000,HARD,2,Jarkko Nieminen,Thiemo de Bakker,Jarkko Nieminen,7-6(3); 6-4,R128,99,2,3,57,95,40,57,17,38,11,13,11,57,95,4,2,43,74,27,43,16,31,2,5,11,43,74
2015-03-12 00:00:00.000,BNP Paribas Open CA; U.S.A. ATP World Tour Masters 1000,HARD,2,Pablo Cuevas,N/A Bye,Pablo Cuevas,,R128,0,0,0,0,0,0,0,0,0,0,0,0,0,0,0,0,0,0,0,0,0,0,0,0,0,0,0
2015-03-12 00:00:00.000,BNP Paribas Open CA; U.S.A. ATP World Tour Masters 1000,HARD,2,Fernando Verdasco,N/A Bye,Fernando Verdasco,,R128,0,0,0,0,0,0,0,0,0,0,0,0,0,0,0,0,0,0,0,0,0,0,0,0,0,0,0
2015-03-12 00:00:00.000,BNP Paribas Open CA; U.S.A. ATP World Tour Masters 1000,HARD,2,James Duckworth,Dominic Thiem,James Duckworth,7-6(5); 6-1,R128,67,7,0,46,59,38,46,9,13,0,0,10,47,59,4,3,24,49,17,24,16,25,1,3,9,33,49
2015-03-12 00:00:00.000,BNP Paribas Open CA; U.S.A. ATP World Tour Masters 1000,HARD,2,Ryan Harrison,Mardy Fish,Ryan Harrison,6-4; 4-6; 7-6(3),R128,156,1,7,71,114,51,71,19,43,12,15,16,70,114,9,9,46,94,34,46,24,48,0,3,16,58,94
2015-03-12 00:00:00.000,BNP Paribas Open CA; U.S.A. ATP World Tour Masters 1000,HARD,2,Kei Nishikori,N/A Bye,Kei Nishikori,,R128,0,0,0,0,0,0,0,0,0,0,0,0,0,0,0,0,0,0,0,0,0,0,0,0,0,0,0
2015-03-12 00:00:00.000,BNP Paribas Open CA; U.S.A. ATP World Tour Masters 1000,HARD,2,Milos Raonic,N/A Bye,Milos Raonic,,R128,0,0,0,0,0,0,0,0,0,0,0,0,0,0,0,0,0,0,0,0,0,0,0,0,0,0,0
2015-03-12 00:00:00.000,BNP Paribas Open CA; U.S.A. ATP World Tour Masters 1000,HARD,2,Simone Bolelli,Thomaz Bellucci,Simone Bolelli,6-2; 6-7(3); 6-4,R128,149,3,0,64,95,46,64,20,31,6,6,15,66,95,6,6,59,109,42,59,26,50,7,10,15,68,109
2015-03-12 00:00:00.000,BNP Paribas Open CA; U.S.A. ATP World Tour Masters 1000,HARD,2,Alexandr Dolgopolov,Frank Dancevic,Alexandr Dolgopolov,6-2; 7-5,R128,69,7,0,33,55,26,33,16,22,1,1,10,42,55,5,0,32,60,23,32,13,28,2,5,10,36,60
2015-03-12 00:00:00.000,BNP Paribas Open CA; U.S.A. ATP World Tour Masters 1000,HARD,2,Santiago Giraldo,N/A Bye,Santiago Giraldo,,R128,0,0,0,0,0,0,0,0,0,0,0,0,0,0,0,0,0,0,0,0,0,0,0,0,0,0,0
2015-03-12 00:00:00.000,BNP Paribas Open CA; U.S.A. ATP World Tour Masters 1000,HARD,2,Tommy Robredo,N/A Bye,Tommy Robredo,,R128,0,0,0,0,0,0,0,0,0,0,0,0,0,0,0,0,0,0,0,0,0,0,0,0,0,0,0
2015-03-12 00:00:00.000,BNP Paribas Open CA; U.S.A. ATP World Tour Masters 1000,HARD,2,Andrey Golubev,Dustin Brown,Andrey Golubev,6-7(4); 6-3; 7-6(3),R128,146,16,5,82,128,54,82,25,46,10,12,17,79,128,13,7,66,111,49,66,22,45,10,13,16,71,111
2015-03-12 00:00:00.000,BNP Paribas Open CA; U.S.A. ATP World Tour Masters 1000,HARD,2,Nick Kyrgios,Denis Kudla,Nick Kyrgios,6-4; 7-5,R128,68,11,0,37,60,32,37,14,23,1,1,11,46,60,1,1,37,57,25,37,13,20,1,3,11,38,57
2015-03-12 00:00:00.000,BNP Paribas Open CA; U.S.A. ATP World Tour Masters 1000,HARD,2,Grigor Dimitrov,N/A Bye,Grigor Dimitrov,,R128,0,0,0,0,0,0,0,0,0,0,0,0,0,0,0,0,0,0,0,0,0,0,0,0,0,0,0
2015-03-12 00:00:00.000,BNP Paribas Open CA; U.S.A. ATP World Tour Masters 1000,HARD,2,Gilles Simon,N/A Bye,Gilles Simon,,R128,0,0,0,0,0,0,0,0,0,0,0,0,0,0,0,0,0,0,0,0,0,0,0,0,0,0,0
2015-03-12 00:00:00.000,BNP Paribas Open CA; U.S.A. ATP World Tour Masters 1000,HARD,2,Malek Jaziri,Tatsuma Ito,Malek Jaziri,7-5; 6-1,R128,89,4,1,30,53,26,30,13,23,1,2,10,39,53,3,2,40,72,22,40,14,32,5,9,9,36,72
2015-03-12 00:00:00.000,BNP Paribas Open CA; U.S.A. ATP World Tour Masters 1000,HARD,2,Michael Berrer,Victor Estrella Burgos,Michael Berrer,6-3; 5-7; 6-4,R128,109,7,3,59,88,45,59,19,29,4,6,16,64,88,3,1,60,88,42,60,14,28,2,5,15,56,88
2015-03-12 00:00:00.000,BNP Paribas Open CA; U.S.A. ATP World Tour Masters 1000,HARD,2,Richard Gasquet,N/A Bye,Richard Gasquet,,R128,0,0,0,0,0,0,0,0,0,0,0,0,0,0,0,0,0,0,0,0,0,0,0,0,0,0,0
2015-03-12 00:00:00.000,BNP Paribas Open CA; U.S.A. ATP World Tour Masters 1000,HARD,2,Jeremy Chardy,N/A Bye,Jeremy Chardy,,R128,0,0,0,0,0,0,0,0,0,0,0,0,0,0,0,0,0,0,0,0,0,0,0,0,0,0,0
2015-03-12 00:00:00.000,BNP Paribas Open CA; U.S.A. ATP World Tour Masters 1000,HARD,2,Donald Young,Pablo Carreno Busta,Donald Young,6-3; 6-4,R128,90,2,3,41,79,28,41,21,38,5,6,10,49,79,2,4,37,61,23,37,11,24,4,7,9,34,61
2015-03-12 00:00:00.000,BNP Paribas Open CA; U.S.A. ATP World Tour Masters 1000,HARD,2,Igor Sijsling,Filip Krajinovic,Igor Sijsling,6-4; 3-6; 6-2,R128,118,9,2,65,108,35,65,26,43,13,16,13,61,108,8,5,55,97,35,55,20,42,8,13,14,55,97
2015-03-12 00:00:00.000,BNP Paribas Open CA; U.S.A. ATP World Tour Masters 1000,HARD,2,Rafael Nadal,N/A Bye,Rafael Nadal,,R128,0,0,0,0,0,0,0,0,0,0,0,0,0,0,0,0,0,0,0,0,0,0,0,0,0,0,0
2015-03-12 00:00:00.000,BNP Paribas Open CA; U.S.A. ATP World Tour Masters 1000,HARD,2,Stan Wawrinka,N/A Bye,Stan Wawrinka,,R128,0,0,0,0,0,0,0,0,0,0,0,0,0,0,0,0,0,0,0,0,0,0,0,0,0,0,0
2015-03-12 00:00:00.000,BNP Paribas Open CA; U.S.A. ATP World Tour Masters 1000,HARD,2,Robin Haase,Alex Bolt,Robin Haase,6-4; 6-2,R128,67,5,1,32,56,25,32,14,24,4,4,9,39,56,3,4,39,59,25,39,10,20,4,7,9,35,59
2015-03-12 00:00:00.000,BNP Paribas Open CA; U.S.A. ATP World Tour Masters 1000,HARD,2,Martin Klizan,Pablo Andujar,Martin Klizan,7-6(4); 6-3,R128,94,6,7,43,75,32,43,18,32,2,3,11,50,75,4,0,40,66,28,40,13,26,2,4,10,41,66
2015-03-12 00:00:00.000,BNP Paribas Open CA; U.S.A. ATP World Tour Masters 1000,HARD,2,Lukas Rosol,N/A Bye,Lukas Rosol,,R128,0,0,0,0,0,0,0,0,0,0,0,0,0,0,0,0,0,0,0,0,0,0,0,0,0,0,0
2015-03-12 00:00:00.000,BNP Paribas Open CA; U.S.A. ATP World Tour Masters 1000,HARD,2,Ivo Karlovic,N/A Bye,Ivo Karlovic,,R128,0,0,0,0,0,0,0,0,0,0,0,0,0,0,0,0,0,0,0,0,0,0,0,0,0,0,0
2015-03-12 00:00:00.000,BNP Paribas Open CA; U.S.A. ATP World Tour Masters 1000,HARD,2,Steve Johnson,Marcel Granollers,Steve Johnson,6-2; 6-3,R128,69,6,1,30,54,26,30,15,24,3,3,9,41,54,2,3,34,53,21,34,10,19,4,7,8,31,53
2015-03-12 00:00:00.000,BNP Paribas Open CA; U.S.A. ATP World Tour Masters 1000,HARD,2,Sergiy Stakhovsky,Sam Querrey,Sergiy Stakhovsky,2-6; 6-4; 6-2,R128,87,4,0,35,70,22,35,23,35,2,5,13,45,70,17,4,47,78,38,47,14,31,4,8,13,52,78
2015-03-12 00:00:00.000,BNP Paribas Open CA; U.S.A. ATP World Tour Masters 1000,HARD,2,Tomas Berdych,N/A Bye,Tomas Berdych,,R128,0,0,0,0,0,0,0,0,0,0,0,0,0,0,0,0,0,0,0,0,0,0,0,0,0,0,0
2015-03-12 00:00:00.000,BNP Paribas Open CA; U.S.A. ATP World Tour Masters 1000,HARD,2,Roberto Bautista Agut,N/A Bye,Roberto Bautista Agut,,R128,0,0,0,0,0,0,0,0,0,0,0,0,0,0,0,0,0,0,0,0,0,0,0,0,0,0,0
2015-03-12 00:00:00.000,BNP Paribas Open CA; U.S.A. ATP World Tour Masters 1000,HARD,2,Denis Istomin,Austin Krajicek,Denis Istomin,7-6(5); 6-4,R128,95,10,1,40,63,31,40,19,23,3,3,11,50,63,5,3,40,82,27,40,25,42,4,5,11,52,82
2015-03-12 00:00:00.000,BNP Paribas Open CA; U.S.A. ATP World Tour Masters 1000,HARD,2,Jack Sock,Yen-Hsun Lu,Jack Sock,6-7(4); 6-2; 7-5,R128,122,13,7,48,87,42,48,20,39,1,4,16,62,87,4,5,50,97,34,50,26,47,5,11,16,60,97
2015-03-12 00:00:00.000,BNP Paribas Open CA; U.S.A. ATP World Tour Masters 1000,HARD,2,Gilles Muller,N/A Bye,Gilles Muller,,R128,0,0,0,0,0,0,0,0,0,0,0,0,0,0,0,0,0,0,0,0,0,0,0,0,0,0,0
2015-03-12 00:00:00.000,BNP Paribas Open CA; U.S.A. ATP World Tour Masters 1000,HARD,2,Andreas Seppi,N/A Bye,Andreas Seppi,,R128,0,0,0,0,0,0,0,0,0,0,0,0,0,0,0,0,0,0,0,0,0,0,0,0,0,0,0
2015-03-12 00:00:00.000,BNP Paribas Open CA; U.S.A. ATP World Tour Masters 1000,HARD,2,Victor Hanescu,Mikhail Youzhny,Victor Hanescu,6-3; 6-4,R128,71,10,0,34,51,29,34,12,17,1,1,10,41,51,3,3,35,58,24,35,11,23,2,4,9,35,58
2015-03-12 00:00:00.000,BNP Paribas Open CA; U.S.A. ATP World Tour Masters 1000,HARD,2,Diego Schwartzman,Jerzy Janowicz,Diego Schwartzman,6-4; 3-6; 7-6(3),R128,136,5,5,50,104,35,50,30,54,4,8,16,65,104,11,9,59,103,40,59,24,44,5,8,15,64,103
2015-03-12 00:00:00.000,BNP Paribas Open CA; U.S.A. ATP World Tour Masters 1000,HARD,2,Roger Federer,N/A Bye,Roger Federer,,R128,0,0,0,0,0,0,0,0,0,0,0,0,0,0,0,0,0,0,0,0,0,0,0,0,0,0,0
2015-03-12 00:00:00.000,BNP Paribas Open CA; U.S.A. ATP World Tour Masters 1000,HARD,2,Novak Djokovic,Marcos Baghdatis,Novak Djokovic,6-1; 6-3,R64,60,6,1,29,39,24,29,8,10,0,0,8,32,39,3,3,31,51,22,31,4,20,1,5,8,26,51
2015-03-12 00:00:00.000,BNP Paribas Open CA; U.S.A. ATP World Tour Masters 1000,HARD,2,Albert Ramos-Vinolas,Julien Benneteau,Albert Ramos-Vinolas,6-2; 6-3,R64,47,13,1,27,39,22,27,7,12,0,1,8,29,39,6,4,27,46,15,27,6,19,2,7,9,21,46
2015-03-12 00:00:00.000,BNP Paribas Open CA; U.S.A. ATP World Tour Masters 1000,HARD,2,John Isner,Jurgen Melzer,John Isner,6-3; 6-4,R64,69,13,0,26,45,24,26,16,19,0,0,10,40,45,3,3,47,71,34,47,8,24,9,11,9,42,71
2015-03-12 00:00:00.000,BNP Paribas Open CA; U.S.A. ATP World Tour Masters 1000,HARD,2,Kevin Anderson,Federico Delbonis,Kevin Anderson,7-5; 6-4,R64,91,10,2,38,60,29,38,16,22,2,2,11,45,60,2,3,39,72,26,39,19,33,4,6,11,45,72
2015-03-12 00:00:00.000,BNP Paribas Open CA; U.S.A. ATP World Tour Masters 1000,HARD,2,Juan Monaco,Marin Cilic,Juan Monaco,6-4; 6-4,R64,85,1,1,38,56,29,38,8,18,2,4,10,37,56,4,1,37,66,21,37,15,29,1,5,10,36,66
2015-03-12 00:00:00.000,BNP Paribas Open CA; U.S.A. ATP World Tour Masters 1000,HARD,2,Thanasi Kokkinakis,Guillermo Garcia-Lopez,Thanasi Kokkinakis,7-5; 5-7; 6-3,R64,175,13,4,70,119,46,70,22,49,5,10,17,68,119,5,8,56,112,38,56,22,56,9,15,16,60,112
2015-03-12 00:00:00.000,BNP Paribas Open CA; U.S.A. ATP World Tour Masters 1000,HARD,2,Bernard Tomic,Borna Coric,Bernard Tomic,6-3; 6-4,R64,81,9,1,40,53,32,40,9,13,3,3,10,41,53,6,3,37,66,26,37,13,29,2,4,9,39,66
2015-03-12 00:00:00.000,BNP Paribas Open CA; U.S.A. ATP World Tour Masters 1000,HARD,2,David Ferrer,Ivan Dodig,David Ferrer,4-6; 6-1; 7-6(6),R64,162,1,6,63,113,43,63,30,50,7,10,15,73,113,7,8,52,105,32,52,28,53,5,9,14,60,105
2015-03-12 00:00:00.000,BNP Paribas Open CA; U.S.A. ATP World Tour Masters 1000,HARD,2,Andy Murray,Vasek Pospisil,Andy Murray,6-1; 6-3,R64,80,4,3,32,50,23,32,11,18,1,2,8,34,50,6,3,25,54,15,25,10,29,4,9,8,25,54
2015-03-12 00:00:00.000,BNP Paribas Open CA; U.S.A. ATP World Tour Masters 1000,HARD,2,Philipp Kohlschreiber,Tim Smyczek,Philipp Kohlschreiber,6-3; 6-1,R64,52,5,1,28,40,23,28,9,12,0,0,8,32,40,0,0,28,43,15,28,8,15,2,6,8,23,43
2015-03-12 00:00:00.000,BNP Paribas Open CA; U.S.A. ATP World Tour Masters 1000,HARD,2,Adrian Mannarino,Fabio Fognini,Adrian Mannarino,7-6(8); 6-3,R64,96,6,1,47,70,38,47,12,23,7,8,11,50,70,1,8,45,78,31,45,14,33,4,6,10,45,78
2015-03-12 00:00:00.000,BNP Paribas Open CA; U.S.A. ATP World Tour Masters 1000,HARD,2,Ernests Gulbis,Daniel Gimeno-Traver,Ernests Gulbis,6-4; 6-1,R64,69,15,3,30,51,26,30,12,21,3,3,9,38,51,0,0,29,50,19,29,9,21,2,5,8,28,50
2015-03-12 00:00:00.000,BNP Paribas Open CA; U.S.A. ATP World Tour Masters 1000,HARD,2,Feliciano Lopez,Edouard Roger-Vasselin,Feliciano Lopez,6-7(3); 6-4; 6-4,R64,140,21,2,65,111,48,65,24,46,7,9,16,72,111,4,4,61,99,41,61,23,38,1,5,16,64,99
2015-03-12 00:00:00.000,BNP Paribas Open CA; U.S.A. ATP World Tour Masters 1000,HARD,2,Pablo Cuevas,Jarkko Nieminen,Pablo Cuevas,4-6; 7-5; 6-0,R64,121,4,1,52,84,35,52,11,32,7,13,14,46,84,5,4,56,99,28,56,16,43,9,18,14,44,99
2015-03-12 00:00:00.000,BNP Paribas Open CA; U.S.A. ATP World Tour Masters 1000,HARD,2,Fernando Verdasco,James Duckworth,Fernando Verdasco,6-2; 7-6(3),R64,78,7,3,45,62,38,45,9,17,0,0,10,47,62,4,2,42,69,33,42,11,27,3,5,10,44,69
2015-03-12 00:00:00.000,BNP Paribas Open CA; U.S.A. ATP World Tour Masters 1000,HARD,2,Kei Nishikori,Ryan Harrison,Kei Nishikori,6-4; 6-4,R64,88,3,5,35,62,22,35,17,27,5,8,10,39,62,5,5,40,65,26,40,8,25,5,10,10,34,65
2015-03-12 00:00:00.000,BNP Paribas Open CA; U.S.A. ATP World Tour Masters 1000,HARD,2,Milos Raonic,Simone Bolelli,Milos Raonic,6-3; 6-4,R64,67,13,1,28,48,25,28,15,20,0,0,10,40,48,3,1,31,52,26,31,9,21,1,3,9,35,52
2015-03-12 00:00:00.000,BNP Paribas Open CA; U.S.A. ATP World Tour Masters 1000,HARD,2,Alexandr Dolgopolov,Santiago Giraldo,Alexandr Dolgopolov,6-1; 7-6(4),R64,87,15,4,38,67,35,38,14,29,2,2,10,49,67,4,0,44,70,25,44,15,26,7,9,9,40,70
2015-03-12 00:00:00.000,BNP Paribas Open CA; U.S.A. ATP World Tour Masters 1000,HARD,2,Tommy Robredo,Andrey Golubev,Tommy Robredo,6-4; 6-7(5); 6-4,R64,130,5,6,69,107,58,69,20,38,5,5,16,78,107,7,5,52,90,42,52,24,38,2,4,16,66,90
2015-03-12 00:00:00.000,BNP Paribas Open CA; U.S.A. ATP World Tour Masters 1000,HARD,2,Grigor Dimitrov,Nick Kyrgios,Grigor Dimitrov,7-6(2); 3-6; 7-6(4),R64,130,16,4,64,100,53,64,20,36,4,6,16,73,100,12,4,76,122,59,76,22,46,1,2,17,81,122
2015-03-12 00:00:00.000,BNP Paribas Open CA; U.S.A. ATP World Tour Masters 1000,HARD,2,Gilles Simon,Malek Jaziri,Gilles Simon,6-3; 4-6; 6-2,R64,118,2,8,46,80,32,46,16,34,2,6,14,48,80,5,2,46,85,32,46,11,39,9,15,13,43,85
2015-03-12 00:00:00.000,BNP Paribas Open CA; U.S.A. ATP World Tour Masters 1000,HARD,2,Michael Berrer,Richard Gasquet,Michael Berrer,7-6(6); 4-6; 3-1 RET,R64,125,8,5,50,87,40,50,20,37,2,3,13,60,87,9,0,39,76,28,39,27,37,1,2,13,55,76
2015-03-12 00:00:00.000,BNP Paribas Open CA; U.S.A. ATP World Tour Masters 1000,HARD,2,Donald Young,Jeremy Chardy,Donald Young,6-4; 6-2,R64,84,4,3,31,64,20,31,22,33,3,4,9,42,64,3,8,35,71,22,35,14,36,7,11,9,36,71
2015-03-12 00:00:00.000,BNP Paribas Open CA; U.S.A. ATP World Tour Masters 1000,HARD,2,Rafael Nadal,Igor Sijsling,Rafael Nadal,6-4; 6-2,R64,73,1,1,23,44,22,23,15,21,1,1,9,37,44,2,4,29,57,24,29,10,28,6,9,9,34,57
2015-03-12 00:00:00.000,BNP Paribas Open CA; U.S.A. ATP World Tour Masters 1000,HARD,2,Robin Haase,Stan Wawrinka,Robin Haase,6-3; 3-6; 6-3,R64,108,4,0,54,91,38,54,18,37,2,4,13,56,91,3,3,37,80,26,37,24,43,1,5,14,50,80
2015-03-12 00:00:00.000,BNP Paribas Open CA; U.S.A. ATP World Tour Masters 1000,HARD,2,Lukas Rosol,Martin Klizan,Lukas Rosol,4-6; 6-0; 6-3,R64,112,4,7,57,100,43,57,19,43,9,11,13,62,100,3,1,40,75,21,40,19,35,2,7,12,40,75
2015-03-12 00:00:00.000,BNP Paribas Open CA; U.S.A. ATP World Tour Masters 1000,HARD,2,Steve Johnson,Ivo Karlovic,Steve Johnson,6-3; 7-6(5),R64,75,7,2,48,70,39,48,13,22,0,0,11,52,70,18,1,36,53,32,36,10,17,0,1,10,42,53
2015-03-12 00:00:00.000,BNP Paribas Open CA; U.S.A. ATP World Tour Masters 1000,HARD,2,Tomas Berdych,Sergiy Stakhovsky,Tomas Berdych,6-1; 6-4,R64,67,4,0,27,49,19,27,16,22,2,3,9,35,49,4,0,28,50,14,28,12,22,1,5,8,26,50
2015-03-12 00:00:00.000,BNP Paribas Open CA; U.S.A. ATP World Tour Masters 1000,HARD,2,Roberto Bautista Agut,Denis Istomin,Roberto Bautista Agut,6-4; 6-3,R64,80,0,1,39,57,27,39,12,18,3,4,10,39,57,3,1,37,59,24,37,9,22,5,8,9,33,59
2015-03-12 00:00:00.000,BNP Paribas Open CA; U.S.A. ATP World Tour Masters 1000,HARD,2,Jack Sock,Gilles Muller,Jack Sock,3-6; 6-3; 7-6(7),R64,144,12,7,56,107,42,56,30,51,3,4,15,72,107,16,5,53,101,45,53,26,48,6,7,15,71,101
2015-03-12 00:00:00.000,BNP Paribas Open CA; U.S.A. ATP World Tour Masters 1000,HARD,2,Andreas Seppi,Victor Hanescu,Andreas Seppi,6-4; 6-4,R64,73,6,4,37,61,29,37,14,24,2,2,10,43,61,6,2,34,58,26,34,12,24,3,5,10,38,58
2015-03-12 00:00:00.000,BNP Paribas Open CA; U.S.A. ATP World Tour Masters 1000,HARD,2,Roger Federer,Diego Schwartzman,Roger Federer,6-4; 6-2,R64,63,8,1,23,47,19,23,17,24,0,0,9,36,47,1,2,32,58,19,32,12,26,6,9,9,31,58
2015-03-12 00:00:00.000,BNP Paribas Open CA; U.S.A. ATP World Tour Masters 1000,HARD,2,Novak Djokovic,Albert Ramos-Vinolas,Novak Djokovic,7-5; 6-3,R32,85,1,3,37,62,29,37,15,25,3,5,11,44,62,2,4,39,58,25,39,8,19,5,9,10,33,58
2015-03-12 00:00:00.000,BNP Paribas Open CA; U.S.A. ATP World Tour Masters 1000,HARD,2,John Isner,Kevin Anderson,John Isner,7-6(6); 6-2,R32,79,18,1,35,52,32,35,13,17,0,0,10,45,52,11,4,39,65,29,39,14,26,4,6,10,43,65
2015-03-12 00:00:00.000,BNP Paribas Open CA; U.S.A. ATP World Tour Masters 1000,HARD,2,Thanasi Kokkinakis,Juan Monaco,Thanasi Kokkinakis,6-2; 5-7; 7-6(5),R32,166,8,3,55,103,40,55,21,48,10,15,16,61,103,4,2,94,113,52,94,10,19,9,15,16,62,113
2015-03-12 00:00:00.000,BNP Paribas Open CA; U.S.A. ATP World Tour Masters 1000,HARD,2,Bernard Tomic,David Ferrer,Bernard Tomic,7-5; 6-4,R32,98,3,1,56,86,38,56,15,30,11,13,11,53,86,2,7,38,62,30,38,8,24,4,8,11,38,62
2015-03-12 00:00:00.000,BNP Paribas Open CA; U.S.A. ATP World Tour Masters 1000,HARD,2,Andy Murray,Philipp Kohlschreiber,Andy Murray,6-1; 3-6; 6-1,R32,111,6,5,53,85,38,53,19,32,6,7,12,57,85,3,1,41,65,27,41,12,24,4,8,11,39,65
2015-03-12 00:00:00.000,BNP Paribas Open CA; U.S.A. ATP World Tour Masters 1000,HARD,2,Adrian Mannarino,Ernests Gulbis,Adrian Mannarino,6-4; 6-4,R32,89,1,0,38,51,30,38,9,13,0,1,10,39,51,8,6,42,72,32,42,10,30,5,8,10,42,72
2015-03-12 00:00:00.000,BNP Paribas Open CA; U.S.A. ATP World Tour Masters 1000,HARD,2,Feliciano Lopez,Pablo Cuevas,Feliciano Lopez,6-2; 4-6; 6-3,R32,107,13,4,48,85,36,48,22,37,6,7,14,58,85,5,2,51,78,32,51,17,27,3,6,13,49,78
2015-03-12 00:00:00.000,BNP Paribas Open CA; U.S.A. ATP World Tour Masters 1000,HARD,2,Kei Nishikori,Fernando Verdasco,Kei Nishikori,6-7(6); 6-1; 6-4,R32,136,4,5,52,99,40,52,29,47,3,3,15,69,99,5,2,64,89,41,64,16,25,3,6,14,57,89
2015-03-12 00:00:00.000,BNP Paribas Open CA; U.S.A. ATP World Tour Masters 1000,HARD,2,Milos Raonic,Alexandr Dolgopolov,Milos Raonic,7-6(2); 6-4,R32,89,12,2,37,64,32,37,19,27,2,2,11,51,64,0,4,47,71,33,47,14,24,1,2,11,47,71
2015-03-12 00:00:00.000,BNP Paribas Open CA; U.S.A. ATP World Tour Masters 1000,HARD,2,Tommy Robredo,Grigor Dimitrov,Tommy Robredo,6-4; 1-6; 7-5,R32,107,6,2,60,81,44,60,11,21,0,2,14,55,81,9,5,46,88,35,46,25,42,4,6,15,60,88
2015-03-12 00:00:00.000,BNP Paribas Open CA; U.S.A. ATP World Tour Masters 1000,HARD,2,Gilles Simon,Michael Berrer,Gilles Simon,6-2; 7-5,R32,84,4,1,35,61,23,35,16,26,4,6,10,39,61,3,2,36,56,20,36,8,20,7,12,10,28,56
2015-03-12 00:00:00.000,BNP Paribas Open CA; U.S.A. ATP World Tour Masters 1000,HARD,2,Rafael Nadal,Donald Young,Rafael Nadal,6-4; 6-2,R32,81,1,3,38,60,23,38,11,22,3,6,9,34,60,4,4,27,51,15,27,7,24,2,8,9,22,51
2015-03-12 00:00:00.000,BNP Paribas Open CA; U.S.A. ATP World Tour Masters 1000,HARD,2,Lukas Rosol,Robin Haase,Lukas Rosol,6-4; 6-7(4); 7-6(3),R32,153,8,7,64,118,51,64,28,54,4,5,17,79,118,9,4,56,115,44,56,33,59,6,8,17,77,115
2015-03-12 00:00:00.000,BNP Paribas Open CA; U.S.A. ATP World Tour Masters 1000,HARD,2,Tomas Berdych,Steve Johnson,Tomas Berdych,6-4; 6-2,R32,72,7,1,23,50,20,23,14,27,1,2,9,34,50,4,2,29,53,18,29,11,24,2,6,9,29,53
2015-03-12 00:00:00.000,BNP Paribas Open CA; U.S.A. ATP World Tour Masters 1000,HARD,2,Jack Sock,Roberto Bautista Agut,Jack Sock,3-6; 6-3; 6-2,R32,105,6,7,50,76,36,50,11,26,2,5,13,47,76,0,2,56,80,35,56,12,24,4,9,13,47,80
2015-03-12 00:00:00.000,BNP Paribas Open CA; U.S.A. ATP World Tour Masters 1000,HARD,2,Roger Federer,Andreas Seppi,Roger Federer,6-3; 6-4,R32,82,6,3,36,59,27,36,12,23,1,2,10,39,59,3,2,35,77,24,35,17,42,9,12,9,41,77
2015-03-12 00:00:00.000,BNP Paribas Open CA; U.S.A. ATP World Tour Masters 1000,HARD,2,Novak Djokovic,John Isner,Novak Djokovic,6-4; 7-6(5),R16,92,7,1,46,68,38,46,14,22,2,2,11,52,68,8,0,51,65,39,51,7,14,1,2,11,46,65
2015-03-12 00:00:00.000,BNP Paribas Open CA; U.S.A. ATP World Tour Masters 1000,HARD,2,Bernard Tomic,Thanasi Kokkinakis,Bernard Tomic,6-4; 4-6; 6-4,R16,125,8,1,79,107,53,79,15,28,8,10,15,68,107,10,1,51,88,39,51,17,37,3,6,15,56,88
2015-03-12 00:00:00.000,BNP Paribas Open CA; U.S.A. ATP World Tour Masters 1000,HARD,2,Andy Murray,Adrian Mannarino,Andy Murray,6-3; 6-3,R16,90,2,1,32,53,24,32,12,21,3,4,9,36,53,1,3,50,71,26,50,11,21,7,11,9,37,71
2015-03-12 00:00:00.000,BNP Paribas Open CA; U.S.A. ATP World Tour Masters 1000,HARD,2,Feliciano Lopez,Kei Nishikori,Feliciano Lopez,6-4; 7-6(2),R16,95,12,2,40,71,33,40,18,31,6,7,11,51,71,4,1,39,66,29,39,12,27,0,2,11,41,66
2015-03-12 00:00:00.000,BNP Paribas Open CA; U.S.A. ATP World Tour Masters 1000,HARD,2,Milos Raonic,Tommy Robredo,Milos Raonic,6-3; 6-2,R16,64,6,3,23,47,21,23,16,24,1,1,9,37,47,4,2,36,51,19,36,8,15,4,7,8,27,51
2015-03-12 00:00:00.000,BNP Paribas Open CA; U.S.A. ATP World Tour Masters 1000,HARD,2,Rafael Nadal,Gilles Simon,Rafael Nadal,6-2; 6-4,R16,79,4,0,33,47,24,33,8,14,2,4,9,32,47,5,4,29,61,16,29,15,32,6,11,9,31,61
2015-03-12 00:00:00.000,BNP Paribas Open CA; U.S.A. ATP World Tour Masters 1000,HARD,2,Tomas Berdych,Lukas Rosol,Tomas Berdych,6-2; 4-6; 6-4,R16,111,11,3,51,81,39,51,15,30,3,5,14,54,81,7,6,41,85,30,41,19,44,3,7,14,49,85
2015-03-12 00:00:00.000,BNP Paribas Open CA; U.S.A. ATP World Tour Masters 1000,HARD,2,Roger Federer,Jack Sock,Roger Federer,6-3; 6-2,R16,70,8,0,29,43,25,29,11,14,0,0,9,36,43,3,6,38,72,24,38,14,34,8,11,8,38,72
2015-03-12 00:00:00.000,BNP Paribas Open CA; U.S.A. ATP World Tour Masters 1000,HARD,2,Novak Djokovic,Bernard Tomic,Novak Djokovic,W/O,Q,0,0,0,0,0,0,0,0,0,0,0,0,0,0,0,0,0,0,0,0,0,0,0,0,0,0,0
2015-03-12 00:00:00.000,BNP Paribas Open CA; U.S.A. ATP World Tour Masters 1000,HARD,2,Andy Murray,Feliciano Lopez,Andy Murray,6-3; 6-4,Q,92,4,0,35,52,27,35,12,17,3,4,10,39,52,5,1,36,74,24,36,18,38,10,13,9,42,74
2015-03-12 00:00:00.000,BNP Paribas Open CA; U.S.A. ATP World Tour Masters 1000,HARD,2,Milos Raonic,Rafael Nadal,Milos Raonic,4-6; 7-6(10); 7-5,Q,178,19,6,73,119,59,73,22,46,6,7,17,81,119,7,1,66,103,54,66,24,37,3,4,17,78,103
2015-03-12 00:00:00.000,BNP Paribas Open CA; U.S.A. ATP World Tour Masters 1000,HARD,2,Roger Federer,Tomas Berdych,Roger Federer,6-4; 6-0,Q,69,1,1,26,40,23,26,9,14,0,0,8,32,40,2,5,26,57,16,26,12,31,4,8,8,28,57
2015-03-12 00:00:00.000,BNP Paribas Open CA; U.S.A. ATP World Tour Masters 1000,HARD,2,Novak Djokovic,Andy Murray,Novak Djokovic,6-2; 6-3,S,88,1,2,32,55,20,32,16,23,2,3,9,36,55,2,4,26,55,13,26,14,29,2,6,8,27,55
2015-03-12 00:00:00.000,BNP Paribas Open CA; U.S.A. ATP World Tour Masters 1000,HARD,2,Roger Federer,Milos Raonic,Roger Federer,7-5; 6-4,S,86,5,0,42,63,33,42,14,21,1,1,11,47,63,9,1,37,64,28,37,16,27,5,7,11,44,64
2015-03-12 00:00:00.000,BNP Paribas Open CA; U.S.A. ATP World Tour Masters 1000,HARD,2,Novak Djokovic,Roger Federer,Novak Djokovic,6-3; 6-7(5); 6-2,F,138,8,5,61,101,47,61,21,40,8,10,15,68,101,6,3,57,98,41,57,15,41,8,13,14,56,98
2015-03-25 00:00:00.000,Miami Open presented by Itaú FL; U.S.A. ATP World Tour Masters 1000,HARD,2,Novak Djokovic,N/A Bye,Novak Djokovic,,R128,0,0,0,0,0,0,0,0,0,0,0,0,0,0,0,0,0,0,0,0,0,0,0,0,0,0,0
2015-03-25 00:00:00.000,Miami Open presented by Itaú FL; U.S.A. ATP World Tour Masters 1000,HARD,2,Martin Klizan,Paolo Lorenzi,Martin Klizan,6-3; 6-4,R128,78,6,2,35,56,29,35,8,21,2,3,9,37,56,7,3,29,56,22,29,11,27,3,7,10,33,56
2015-03-25 00:00:00.000,Miami Open presented by Itaú FL; U.S.A. ATP World Tour Masters 1000,HARD,2,Steve Darcis,Malek Jaziri,Steve Darcis,2-6; 7-5; 7-5,R128,130,2,7,56,103,38,56,25,47,4,9,16,63,103,6,4,48,94,35,48,20,46,4,9,16,55,94
2015-03-25 00:00:00.000,Miami Open presented by Itaú FL; U.S.A. ATP World Tour Masters 1000,HARD,2,Gilles Muller,N/A Bye,Gilles Muller,,R128,0,0,0,0,0,0,0,0,0,0,0,0,0,0,0,0,0,0,0,0,0,0,0,0,0,0,0
2015-03-25 00:00:00.000,Miami Open presented by Itaú FL; U.S.A. ATP World Tour Masters 1000,HARD,2,Pablo Cuevas,N/A Bye,Pablo Cuevas,,R128,0,0,0,0,0,0,0,0,0,0,0,0,0,0,0,0,0,0,0,0,0,0,0,0,0,0,0
2015-03-25 00:00:00.000,Miami Open presented by Itaú FL; U.S.A. ATP World Tour Masters 1000,HARD,2,Thomaz Bellucci,Lleyton Hewitt,Thomaz Bellucci,7-5; 6-7(2); 6-4,R128,179,11,4,72,131,44,72,37,59,12,15,17,81,131,5,7,64,112,46,64,25,48,4,9,17,71,112
2015-03-25 00:00:00.000,Miami Open presented by Itaú FL; U.S.A. ATP World Tour Masters 1000,HARD,2,Alexandr Dolgopolov,Ricardas Berankis,Alexandr Dolgopolov,6-4; 6-1,R128,63,4,2,33,55,24,33,13,22,0,1,9,37,55,1,2,24,46,14,24,9,22,3,7,8,23,46
2015-03-25 00:00:00.000,Miami Open presented by Itaú FL; U.S.A. ATP World Tour Masters 1000,HARD,2,Tommy Robredo,N/A Bye,Tommy Robredo,,R128,0,0,0,0,0,0,0,0,0,0,0,0,0,0,0,0,0,0,0,0,0,0,0,0,0,0,0
2015-03-25 00:00:00.000,Miami Open presented by Itaú FL; U.S.A. ATP World Tour Masters 1000,HARD,2,Gilles Simon,N/A Bye,Gilles Simon,,R128,0,0,0,0,0,0,0,0,0,0,0,0,0,0,0,0,0,0,0,0,0,0,0,0,0,0,0
2015-03-25 00:00:00.000,Miami Open presented by Itaú FL; U.S.A. ATP World Tour Masters 1000,HARD,2,Mikhail Kukushkin,Steve Johnson,Mikhail Kukushkin,6-4; 3-6; 6-2,R128,116,6,0,41,85,28,41,27,44,2,4,13,55,85,15,5,42,77,32,42,14,35,1,5,14,46,77
2015-03-25 00:00:00.000,Miami Open presented by Itaú FL; U.S.A. ATP World Tour Masters 1000,HARD,2,Alejandro Falla,Michael Berrer,Alejandro Falla,6-7(5); 6-4; 6-4,R128,166,5,7,63,130,42,63,39,67,9,11,16,81,130,5,7,64,95,50,64,11,31,2,6,16,61,95
2015-03-25 00:00:00.000,Miami Open presented by Itaú FL; U.S.A. ATP World Tour Masters 1000,HARD,2,Ivo Karlovic,N/A Bye,Ivo Karlovic,,R128,0,0,0,0,0,0,0,0,0,0,0,0,0,0,0,0,0,0,0,0,0,0,0,0,0,0,0
2015-03-25 00:00:00.000,Miami Open presented by Itaú FL; U.S.A. ATP World Tour Masters 1000,HARD,2,Lukas Rosol,N/A Bye,Lukas Rosol,,R128,0,0,0,0,0,0,0,0,0,0,0,0,0,0,0,0,0,0,0,0,0,0,0,0,0,0,0
2015-03-25 00:00:00.000,Miami Open presented by Itaú FL; U.S.A. ATP World Tour Masters 1000,HARD,2,Alexander Zverev,Sam Groth,Alexander Zverev,7-5; 6-7(5); 6-4,R128,123,22,2,74,108,58,74,20,34,6,6,17,78,108,17,0,59,81,53,59,16,22,1,3,17,69,81
2015-03-25 00:00:00.000,Miami Open presented by Itaú FL; U.S.A. ATP World Tour Masters 1000,HARD,2,Federico Delbonis,Jiri Vesely,Federico Delbonis,7-6(4); 3-6; 7-5,R128,168,2,6,78,121,49,78,23,43,9,14,17,72,121,5,6,71,103,52,71,13,32,7,11,16,65,103
2015-03-25 00:00:00.000,Miami Open presented by Itaú FL; U.S.A. ATP World Tour Masters 1000,HARD,2,David Ferrer,N/A Bye,David Ferrer,,R128,0,0,0,0,0,0,0,0,0,0,0,0,0,0,0,0,0,0,0,0,0,0,0,0,0,0,0
2015-03-25 00:00:00.000,Miami Open presented by Itaú FL; U.S.A. ATP World Tour Masters 1000,HARD,2,Kei Nishikori,N/A Bye,Kei Nishikori,,R128,0,0,0,0,0,0,0,0,0,0,0,0,0,0,0,0,0,0,0,0,0,0,0,0,0,0,0
2015-03-25 00:00:00.000,Miami Open presented by Itaú FL; U.S.A. ATP World Tour Masters 1000,HARD,2,Mikhail Youzhny,Andrey Golubev,Mikhail Youzhny,4-6; 6-2; 6-3,R128,117,4,5,43,87,34,43,24,44,5,7,14,58,87,2,6,36,78,24,36,22,42,4,8,13,46,78
2015-03-25 00:00:00.000,Miami Open presented by Itaú FL; U.S.A. ATP World Tour Masters 1000,HARD,2,Simone Bolelli,Marcos Baghdatis,Simone Bolelli,6-2; 6-2,R128,64,3,0,29,41,27,29,7,12,3,3,8,34,41,4,5,23,52,13,23,12,29,1,5,8,25,52
2015-03-25 00:00:00.000,Miami Open presented by Itaú FL; U.S.A. ATP World Tour Masters 1000,HARD,2,Viktor Troicki,N/A Bye,Viktor Troicki,,R128,0,0,0,0,0,0,0,0,0,0,0,0,0,0,0,0,0,0,0,0,0,0,0,0,0,0,0
2015-03-25 00:00:00.000,Miami Open presented by Itaú FL; U.S.A. ATP World Tour Masters 1000,HARD,2,David Goffin,N/A Bye,David Goffin,,R128,0,0,0,0,0,0,0,0,0,0,0,0,0,0,0,0,0,0,0,0,0,0,0,0,0,0,0
2015-03-25 00:00:00.000,Miami Open presented by Itaú FL; U.S.A. ATP World Tour Masters 1000,HARD,2,Borna Coric,Andreas Haider-Maurer,Borna Coric,1-6; 6-3; 7-6(3),R128,150,9,1,56,99,40,56,18,43,1,5,14,58,99,5,6,43,79,33,43,17,36,2,5,14,50,79
2015-03-25 00:00:00.000,Miami Open presented by Itaú FL; U.S.A. ATP World Tour Masters 1000,HARD,2,Jerzy Janowicz,Edouard Roger-Vasselin,Jerzy Janowicz,6-4; 6-2,R128,71,8,4,31,46,28,31,10,15,1,1,9,38,46,1,1,42,60,26,42,9,18,2,5,9,35,60
2015-03-25 00:00:00.000,Miami Open presented by Itaú FL; U.S.A. ATP World Tour Masters 1000,HARD,2,Roberto Bautista Agut,N/A Bye,Roberto Bautista Agut,,R128,0,0,0,0,0,0,0,0,0,0,0,0,0,0,0,0,0,0,0,0,0,0,0,0,0,0,0
2015-03-25 00:00:00.000,Miami Open presented by Itaú FL; U.S.A. ATP World Tour Masters 1000,HARD,2,Grigor Dimitrov,N/A Bye,Grigor Dimitrov,,R128,0,0,0,0,0,0,0,0,0,0,0,0,0,0,0,0,0,0,0,0,0,0,0,0,0,0,0
2015-03-25 00:00:00.000,Miami Open presented by Itaú FL; U.S.A. ATP World Tour Masters 1000,HARD,2,Vasek Pospisil,Juan Martin Del Potro,Vasek Pospisil,6-4; 7-6(7),R128,117,13,7,35,71,32,35,20,36,5,6,11,52,71,6,7,39,73,29,39,18,34,1,3,11,47,73
2015-03-25 00:00:00.000,Miami Open presented by Itaú FL; U.S.A. ATP World Tour Masters 1000,HARD,2,Andrey Rublev,Pablo Carreno Busta,Andrey Rublev,1-6; 6-1; 6-4,R128,111,5,6,57,94,38,57,17,37,8,11,12,55,94,6,0,41,78,29,41,16,37,7,11,12,45,78
2015-03-25 00:00:00.000,Miami Open presented by Itaú FL; U.S.A. ATP World Tour Masters 1000,HARD,2,John Isner,N/A Bye,John Isner,,R128,0,0,0,0,0,0,0,0,0,0,0,0,0,0,0,0,0,0,0,0,0,0,0,0,0,0,0
2015-03-25 00:00:00.000,Miami Open presented by Itaú FL; U.S.A. ATP World Tour Masters 1000,HARD,2,Jeremy Chardy,N/A Bye,Jeremy Chardy,,R128,0,0,0,0,0,0,0,0,0,0,0,0,0,0,0,0,0,0,0,0,0,0,0,0,0,0,0
2015-03-25 00:00:00.000,Miami Open presented by Itaú FL; U.S.A. ATP World Tour Masters 1000,HARD,2,Jurgen Melzer,Ryan Harrison,Jurgen Melzer,7-6(3); 6-3,R128,103,5,3,37,70,32,37,17,33,2,3,11,49,70,4,2,40,72,28,40,16,32,2,4,10,44,72
2015-03-25 00:00:00.000,Miami Open presented by Itaú FL; U.S.A. ATP World Tour Masters 1000,HARD,2,Teymuraz Gabashvili,Pablo Andujar,Teymuraz Gabashvili,0-6; 7-6(4); 6-3,R128,132,8,8,49,81,32,49,12,32,6,12,13,44,81,13,6,72,111,48,72,15,39,7,12,14,63,111
2015-03-25 00:00:00.000,Miami Open presented by Itaú FL; U.S.A. ATP World Tour Masters 1000,HARD,2,Milos Raonic,N/A Bye,Milos Raonic,,R128,0,0,0,0,0,0,0,0,0,0,0,0,0,0,0,0,0,0,0,0,0,0,0,0,0,0,0
2015-03-25 00:00:00.000,Miami Open presented by Itaú FL; U.S.A. ATP World Tour Masters 1000,HARD,2,Stan Wawrinka,N/A Bye,Stan Wawrinka,,R128,0,0,0,0,0,0,0,0,0,0,0,0,0,0,0,0,0,0,0,0,0,0,0,0,0,0,0
2015-03-25 00:00:00.000,Miami Open presented by Itaú FL; U.S.A. ATP World Tour Masters 1000,HARD,2,Carlos Berlocq,Thanasi Kokkinakis,Carlos Berlocq,6-4; 3-6; 6-2,R128,143,3,5,60,95,41,60,13,35,6,10,13,54,95,6,3,52,79,32,52,10,27,4,10,14,42,79
2015-03-25 00:00:00.000,Miami Open presented by Itaú FL; U.S.A. ATP World Tour Masters 1000,HARD,2,Albert Ramos-Vinolas,Joao Sousa,Albert Ramos-Vinolas,6-2; 6-2,R128,73,3,4,33,54,26,33,11,21,5,5,8,37,54,2,6,29,57,15,29,14,28,4,8,8,29,57
2015-03-25 00:00:00.000,Miami Open presented by Itaú FL; U.S.A. ATP World Tour Masters 1000,HARD,2,Adrian Mannarino,N/A Bye,Adrian Mannarino,,R128,0,0,0,0,0,0,0,0,0,0,0,0,0,0,0,0,0,0,0,0,0,0,0,0,0,0,0
2015-03-25 00:00:00.000,Miami Open presented by Itaú FL; U.S.A. ATP World Tour Masters 1000,HARD,2,Fabio Fognini,N/A Bye,Fabio Fognini,,R128,0,0,0,0,0,0,0,0,0,0,0,0,0,0,0,0,0,0,0,0,0,0,0,0,0,0,0
2015-03-25 00:00:00.000,Miami Open presented by Itaú FL; U.S.A. ATP World Tour Masters 1000,HARD,2,Jack Sock,Go Soeda,Jack Sock,6-3; 6-4,R128,67,4,3,29,51,25,29,13,22,2,3,10,38,51,1,4,30,50,20,30,9,20,3,6,9,29,50
2015-03-25 00:00:00.000,Miami Open presented by Itaú FL; U.S.A. ATP World Tour Masters 1000,HARD,2,Dominic Thiem,Diego Schwartzman,Dominic Thiem,7-6(0); 7-5,R128,107,6,4,44,74,33,44,8,30,2,7,12,41,74,0,6,49,85,25,49,16,36,6,12,12,41,85
2015-03-25 00:00:00.000,Miami Open presented by Itaú FL; U.S.A. ATP World Tour Masters 1000,HARD,2,Feliciano Lopez,N/A Bye,Feliciano Lopez,,R128,0,0,0,0,0,0,0,0,0,0,0,0,0,0,0,0,0,0,0,0,0,0,0,0,0,0,0
2015-03-25 00:00:00.000,Miami Open presented by Itaú FL; U.S.A. ATP World Tour Masters 1000,HARD,2,Kevin Anderson,N/A Bye,Kevin Anderson,,R128,0,0,0,0,0,0,0,0,0,0,0,0,0,0,0,0,0,0,0,0,0,0,0,0,0,0,0
2015-03-25 00:00:00.000,Miami Open presented by Itaú FL; U.S.A. ATP World Tour Masters 1000,HARD,2,Sam Querrey,Victor Estrella Burgos,Sam Querrey,6-4; 6-3,R128,79,16,4,29,55,27,29,15,26,1,1,10,42,55,2,1,49,64,31,49,8,15,6,8,9,39,64
2015-03-25 00:00:00.000,Miami Open presented by Itaú FL; U.S.A. ATP World Tour Masters 1000,HARD,2,Jarkko Nieminen,Marinko Matosevic,Jarkko Nieminen,6-3; 6-3,R128,68,3,2,35,49,28,35,5,14,2,4,9,33,49,4,1,39,62,22,39,9,23,6,11,9,31,62
2015-03-25 00:00:00.000,Miami Open presented by Itaú FL; U.S.A. ATP World Tour Masters 1000,HARD,2,Leonardo Mayer,N/A Bye,Leonardo Mayer,,R128,0,0,0,0,0,0,0,0,0,0,0,0,0,0,0,0,0,0,0,0,0,0,0,0,0,0,0
2015-03-25 00:00:00.000,Miami Open presented by Itaú FL; U.S.A. ATP World Tour Masters 1000,HARD,2,Santiago Giraldo,N/A Bye,Santiago Giraldo,,R128,0,0,0,0,0,0,0,0,0,0,0,0,0,0,0,0,0,0,0,0,0,0,0,0,0,0,0
2015-03-25 00:00:00.000,Miami Open presented by Itaú FL; U.S.A. ATP World Tour Masters 1000,HARD,2,Robin Haase,Kyle Edmund,Robin Haase,6-2; 6-2,R128,69,4,1,31,52,24,31,13,21,2,2,8,37,52,1,1,25,47,13,25,10,22,0,4,8,23,47
2015-03-25 00:00:00.000,Miami Open presented by Itaú FL; U.S.A. ATP World Tour Masters 1000,HARD,2,Donald Young,Yen-Hsun Lu,Donald Young,5-1 RET,R128,23,2,2,9,14,8,9,2,5,0,1,3,10,14,0,1,12,23,4,12,3,11,3,6,3,7,23
2015-03-25 00:00:00.000,Miami Open presented by Itaú FL; U.S.A. ATP World Tour Masters 1000,HARD,2,Andy Murray,N/A Bye,Andy Murray,,R128,0,0,0,0,0,0,0,0,0,0,0,0,0,0,0,0,0,0,0,0,0,0,0,0,0,0,0
2015-03-25 00:00:00.000,Miami Open presented by Itaú FL; U.S.A. ATP World Tour Masters 1000,HARD,2,Tomas Berdych,N/A Bye,Tomas Berdych,,R128,0,0,0,0,0,0,0,0,0,0,0,0,0,0,0,0,0,0,0,0,0,0,0,0,0,0,0
2015-03-25 00:00:00.000,Miami Open presented by Itaú FL; U.S.A. ATP World Tour Masters 1000,HARD,2,Hyeon Chung,Marcel Granollers,Hyeon Chung,6-0; 4-6; 6-4,R128,134,3,2,48,78,38,48,15,30,1,3,13,53,78,10,1,42,80,26,42,20,38,5,10,13,46,80
2015-03-25 00:00:00.000,Miami Open presented by Itaú FL; U.S.A. ATP World Tour Masters 1000,HARD,2,Austin Krajicek,Denis Istomin,Austin Krajicek,6-4; 6-4,R128,73,4,2,29,53,24,29,16,24,0,0,10,40,53,4,2,31,56,23,31,12,25,0,2,10,35,56
2015-03-25 00:00:00.000,Miami Open presented by Itaú FL; U.S.A. ATP World Tour Masters 1000,HARD,2,Bernard Tomic,N/A Bye,Bernard Tomic,,R128,0,0,0,0,0,0,0,0,0,0,0,0,0,0,0,0,0,0,0,0,0,0,0,0,0,0,0
2015-03-25 00:00:00.000,Miami Open presented by Itaú FL; U.S.A. ATP World Tour Masters 1000,HARD,2,Gael Monfils,N/A Bye,Gael Monfils,,R128,0,0,0,0,0,0,0,0,0,0,0,0,0,0,0,0,0,0,0,0,0,0,0,0,0,0,0
2015-03-25 00:00:00.000,Miami Open presented by Itaú FL; U.S.A. ATP World Tour Masters 1000,HARD,2,Filip Krajinovic,Dusan Lajovic,Filip Krajinovic,2-6; 7-6(5); 4-2 RET,R128,106,3,1,50,74,33,50,15,24,3,7,13,48,74,9,5,52,90,37,52,17,38,4,7,13,54,90
2015-03-25 00:00:00.000,Miami Open presented by Itaú FL; U.S.A. ATP World Tour Masters 1000,HARD,2,Tim Smyczek,Adrian Menendez-Maceiras,Tim Smyczek,4-6; 6-3; 6-4,R128,112,7,4,48,82,37,48,23,34,3,4,15,60,82,4,3,53,83,38,53,18,30,3,5,14,56,83
2015-03-25 00:00:00.000,Miami Open presented by Itaú FL; U.S.A. ATP World Tour Masters 1000,HARD,2,Jo-Wilfried Tsonga,N/A Bye,Jo-Wilfried Tsonga,,R128,0,0,0,0,0,0,0,0,0,0,0,0,0,0,0,0,0,0,0,0,0,0,0,0,0,0,0
2015-03-25 00:00:00.000,Miami Open presented by Itaú FL; U.S.A. ATP World Tour Masters 1000,HARD,2,Ernests Gulbis,N/A Bye,Ernests Gulbis,,R128,0,0,0,0,0,0,0,0,0,0,0,0,0,0,0,0,0,0,0,0,0,0,0,0,0,0,0
2015-03-25 00:00:00.000,Miami Open presented by Itaú FL; U.S.A. ATP World Tour Masters 1000,HARD,2,Juan Monaco,Ruben Bemelmans,Juan Monaco,7-5; 6-7(4); 6-4,R128,155,1,1,80,105,56,80,10,25,6,10,17,66,105,5,2,65,109,43,65,22,44,10,16,17,65,109
2015-03-25 00:00:00.000,Miami Open presented by Itaú FL; U.S.A. ATP World Tour Masters 1000,HARD,2,Jan-Lennard Struff,Benjamin Becker,Jan-Lennard Struff,3-6; 7-6(10); 6-4,R128,124,12,8,53,109,39,53,24,56,6,12,16,63,109,7,3,55,92,36,55,20,37,2,7,15,56,92
2015-03-25 00:00:00.000,Miami Open presented by Itaú FL; U.S.A. ATP World Tour Masters 1000,HARD,2,Guillermo Garcia-Lopez,N/A Bye,Guillermo Garcia-Lopez,,R128,0,0,0,0,0,0,0,0,0,0,0,0,0,0,0,0,0,0,0,0,0,0,0,0,0,0,0
2015-03-25 00:00:00.000,Miami Open presented by Itaú FL; U.S.A. ATP World Tour Masters 1000,HARD,2,Fernando Verdasco,N/A Bye,Fernando Verdasco,,R128,0,0,0,0,0,0,0,0,0,0,0,0,0,0,0,0,0,0,0,0,0,0,0,0,0,0,0
2015-03-25 00:00:00.000,Miami Open presented by Itaú FL; U.S.A. ATP World Tour Masters 1000,HARD,2,James Duckworth,Damir Dzumhur,James Duckworth,6-3; 3-6; 6-3,R128,102,7,1,48,81,35,48,18,33,2,4,14,53,81,1,4,47,71,34,47,11,24,3,6,13,45,71
2015-03-25 00:00:00.000,Miami Open presented by Itaú FL; U.S.A. ATP World Tour Masters 1000,HARD,2,Nicolas Almagro,Sergiy Stakhovsky,Nicolas Almagro,6-3; 6-7(3); 6-4,R128,140,16,5,65,113,48,65,27,48,5,6,16,75,113,6,4,60,112,45,60,24,52,9,12,15,69,112
2015-03-25 00:00:00.000,Miami Open presented by Itaú FL; U.S.A. ATP World Tour Masters 1000,HARD,2,Rafael Nadal,N/A Bye,Rafael Nadal,,R128,0,0,0,0,0,0,0,0,0,0,0,0,0,0,0,0,0,0,0,0,0,0,0,0,0,0,0
2015-03-25 00:00:00.000,Miami Open presented by Itaú FL; U.S.A. ATP World Tour Masters 1000,HARD,2,Novak Djokovic,Martin Klizan,Novak Djokovic,6-0; 5-7; 6-1,R64,116,4,2,53,77,35,53,13,24,1,4,13,48,77,0,3,50,92,26,50,17,42,12,19,12,43,92
2015-03-25 00:00:00.000,Miami Open presented by Itaú FL; U.S.A. ATP World Tour Masters 1000,HARD,2,Steve Darcis,Gilles Muller,Steve Darcis,6-4; 6-7(2); 6-3,R64,140,4,5,54,100,42,54,32,46,5,5,16,74,100,7,2,56,108,44,56,27,52,2,4,15,71,108
2015-03-25 00:00:00.000,Miami Open presented by Itaú FL; U.S.A. ATP World Tour Masters 1000,HARD,2,Thomaz Bellucci,Pablo Cuevas,Thomaz Bellucci,2-6; 6-2; 7-5,R64,157,4,7,56,103,38,56,23,47,8,11,14,61,103,5,6,54,102,39,54,20,48,4,8,14,59,102
2015-03-25 00:00:00.000,Miami Open presented by Itaú FL; U.S.A. ATP World Tour Masters 1000,HARD,2,Alexandr Dolgopolov,Tommy Robredo,Alexandr Dolgopolov,6-7(1); 6-3; 7-5,R64,138,2,4,73,100,51,73,13,27,3,6,16,64,100,5,4,63,122,47,63,24,59,8,14,17,71,122
2015-03-25 00:00:00.000,Miami Open presented by Itaú FL; U.S.A. ATP World Tour Masters 1000,HARD,2,Gilles Simon,Mikhail Kukushkin,Gilles Simon,6-3; 6-7(5); 6-0,R64,134,5,5,50,100,32,50,30,50,6,9,14,62,100,1,2,55,94,30,55,19,39,5,12,13,49,94
2015-03-25 00:00:00.000,Miami Open presented by Itaú FL; U.S.A. ATP World Tour Masters 1000,HARD,2,Alejandro Falla,Ivo Karlovic,Alejandro Falla,6-4; 6-2,R64,65,1,5,28,53,23,28,16,25,1,1,9,39,53,4,3,29,53,24,29,10,24,7,10,9,34,53
2015-03-25 00:00:00.000,Miami Open presented by Itaú FL; U.S.A. ATP World Tour Masters 1000,HARD,2,Lukas Rosol,Alexander Zverev,Lukas Rosol,7-6(0); 6-3,R64,90,3,1,36,75,29,36,22,39,2,3,11,51,75,3,2,39,69,27,39,16,30,3,5,10,43,69
2015-03-25 00:00:00.000,Miami Open presented by Itaú FL; U.S.A. ATP World Tour Masters 1000,HARD,2,David Ferrer,Federico Delbonis,David Ferrer,6-1; 6-1,R64,58,1,2,28,39,22,28,7,11,1,1,7,29,39,2,2,35,50,16,35,6,15,6,11,7,22,50
2015-03-25 00:00:00.000,Miami Open presented by Itaú FL; U.S.A. ATP World Tour Masters 1000,HARD,2,Kei Nishikori,Mikhail Youzhny,Kei Nishikori,6-2; 6-1,R64,69,3,2,23,47,20,23,13,24,0,0,7,33,47,0,6,44,64,20,44,9,20,11,16,8,29,64
2015-03-25 00:00:00.000,Miami Open presented by Itaú FL; U.S.A. ATP World Tour Masters 1000,HARD,2,Viktor Troicki,Simone Bolelli,Viktor Troicki,7-5; 3-6; 6-4,R64,131,9,1,49,92,35,49,24,43,1,4,16,59,92,2,2,52,104,32,52,30,52,5,8,15,62,104
2015-03-25 00:00:00.000,Miami Open presented by Itaú FL; U.S.A. ATP World Tour Masters 1000,HARD,2,David Goffin,Borna Coric,David Goffin,6-0; 6-4,R64,70,4,4,19,42,18,19,14,23,0,0,8,32,42,0,3,37,66,24,37,9,29,9,13,8,33,66
2015-03-25 00:00:00.000,Miami Open presented by Itaú FL; U.S.A. ATP World Tour Masters 1000,HARD,2,Jerzy Janowicz,Roberto Bautista Agut,Jerzy Janowicz,6-4; 1-6; 6-4,R64,130,2,4,54,86,36,54,15,32,6,9,13,51,86,2,2,68,102,47,68,17,34,10,13,14,64,102
2015-03-25 00:00:00.000,Miami Open presented by Itaú FL; U.S.A. ATP World Tour Masters 1000,HARD,2,Grigor Dimitrov,Vasek Pospisil,Grigor Dimitrov,6-2; 6-2,R64,59,4,1,23,40,21,23,12,17,2,2,8,33,40,2,5,24,47,14,24,8,23,0,4,8,22,47
2015-03-25 00:00:00.000,Miami Open presented by Itaú FL; U.S.A. ATP World Tour Masters 1000,HARD,2,John Isner,Andrey Rublev,John Isner,6-3; 6-4,R64,62,7,3,28,46,27,28,13,18,0,0,10,40,46,2,2,31,52,24,31,10,21,0,2,9,34,52
2015-03-25 00:00:00.000,Miami Open presented by Itaú FL; U.S.A. ATP World Tour Masters 1000,HARD,2,Jeremy Chardy,Jurgen Melzer,Jeremy Chardy,6-4; 6-1,R64,68,5,0,34,54,24,34,9,20,2,4,9,33,54,2,2,33,60,20,33,8,27,3,8,8,28,60
2015-03-25 00:00:00.000,Miami Open presented by Itaú FL; U.S.A. ATP World Tour Masters 1000,HARD,2,Milos Raonic,Teymuraz Gabashvili,Milos Raonic,6-1; 6-4,R64,59,11,3,28,49,25,28,11,21,0,0,9,36,49,3,0,25,37,18,25,6,12,1,4,8,24,37
2015-03-25 00:00:00.000,Miami Open presented by Itaú FL; U.S.A. ATP World Tour Masters 1000,HARD,2,Stan Wawrinka,Carlos Berlocq,Stan Wawrinka,6-7(9); 7-5; 6-2,R64,170,5,8,44,114,36,44,37,70,4,6,16,73,114,4,3,68,112,44,68,18,44,7,12,16,62,112
2015-03-25 00:00:00.000,Miami Open presented by Itaú FL; U.S.A. ATP World Tour Masters 1000,HARD,2,Adrian Mannarino,Albert Ramos-Vinolas,Adrian Mannarino,6-4; 3-6; 6-2,R64,157,3,1,50,92,36,50,20,42,10,12,13,56,92,2,3,59,92,37,59,17,33,5,9,14,54,92
2015-03-25 00:00:00.000,Miami Open presented by Itaú FL; U.S.A. ATP World Tour Masters 1000,HARD,2,Jack Sock,Fabio Fognini,Jack Sock,7-6(4); 6-1,R64,79,6,3,33,63,28,33,21,30,3,3,10,49,63,4,4,34,67,25,34,16,33,7,9,9,41,67
2015-03-25 00:00:00.000,Miami Open presented by Itaú FL; U.S.A. ATP World Tour Masters 1000,HARD,2,Dominic Thiem,Feliciano Lopez,Dominic Thiem,7-6(4); 4-6; 6-3,R64,128,11,2,58,101,44,58,25,43,5,7,16,69,101,10,5,42,89,36,42,28,47,4,6,15,64,89
2015-03-25 00:00:00.000,Miami Open presented by Itaú FL; U.S.A. ATP World Tour Masters 1000,HARD,2,Kevin Anderson,Sam Querrey,Kevin Anderson,6-7(5); 7-6(3); 6-4,R64,152,14,10,68,115,48,68,28,47,2,4,17,76,115,19,1,62,95,49,62,19,33,3,6,17,68,95
2015-03-25 00:00:00.000,Miami Open presented by Itaú FL; U.S.A. ATP World Tour Masters 1000,HARD,2,Leonardo Mayer,Jarkko Nieminen,Leonardo Mayer,6-4; 7-6(5),R64,95,3,5,43,67,33,43,15,24,0,1,11,48,67,7,2,44,74,32,44,15,30,5,7,11,47,74
2015-03-25 00:00:00.000,Miami Open presented by Itaú FL; U.S.A. ATP World Tour Masters 1000,HARD,2,Santiago Giraldo,Robin Haase,Santiago Giraldo,6-2; 3-6; 6-0,R64,92,8,2,38,65,32,38,14,27,2,3,11,46,65,3,3,45,82,30,45,15,37,4,9,12,45,82
2015-03-25 00:00:00.000,Miami Open presented by Itaú FL; U.S.A. ATP World Tour Masters 1000,HARD,2,Andy Murray,Donald Young,Andy Murray,6-4; 6-2,R64,82,3,2,28,49,23,28,14,21,3,4,9,37,49,3,4,34,67,22,34,13,33,3,7,9,35,67
2015-03-25 00:00:00.000,Miami Open presented by Itaú FL; U.S.A. ATP World Tour Masters 1000,HARD,2,Tomas Berdych,Hyeon Chung,Tomas Berdych,6-3; 6-4,R64,85,9,1,29,47,23,29,13,18,2,4,10,36,47,1,3,32,55,21,32,9,23,1,5,9,30,55
2015-03-25 00:00:00.000,Miami Open presented by Itaú FL; U.S.A. ATP World Tour Masters 1000,HARD,2,Bernard Tomic,Austin Krajicek,Bernard Tomic,7-6(6); 7-5,R64,134,11,2,43,70,39,43,14,27,1,2,12,53,70,10,3,47,86,33,47,24,39,8,10,12,57,86
2015-03-25 00:00:00.000,Miami Open presented by Itaú FL; U.S.A. ATP World Tour Masters 1000,HARD,2,Gael Monfils,Filip Krajinovic,Gael Monfils,3-6; 6-2; 7-6(4),R64,118,4,3,52,92,36,52,22,40,4,7,14,58,92,2,6,64,110,38,64,26,46,8,12,15,64,110
2015-03-25 00:00:00.000,Miami Open presented by Itaú FL; U.S.A. ATP World Tour Masters 1000,HARD,2,Jo-Wilfried Tsonga,Tim Smyczek,Jo-Wilfried Tsonga,6-4; 3-6; 6-3,R64,111,11,1,37,72,28,37,26,35,0,1,14,54,72,0,5,61,94,41,61,19,33,3,5,14,60,94
2015-03-25 00:00:00.000,Miami Open presented by Itaú FL; U.S.A. ATP World Tour Masters 1000,HARD,2,Juan Monaco,Ernests Gulbis,Juan Monaco,6-2; 6-4,R64,78,0,1,49,62,33,49,8,13,0,1,9,41,62,5,9,23,59,17,23,12,36,5,9,9,29,59
2015-03-25 00:00:00.000,Miami Open presented by Itaú FL; U.S.A. ATP World Tour Masters 1000,HARD,2,Guillermo Garcia-Lopez,Jan-Lennard Struff,Guillermo Garcia-Lopez,6-4; 6-4,R64,88,2,2,26,62,17,26,23,36,4,6,10,40,62,6,5,36,62,25,36,7,26,1,5,10,32,62
2015-03-25 00:00:00.000,Miami Open presented by Itaú FL; U.S.A. ATP World Tour Masters 1000,HARD,2,Fernando Verdasco,James Duckworth,Fernando Verdasco,4-6; 6-2; 6-1,R64,108,3,4,50,76,39,50,13,26,2,3,13,52,76,6,4,45,87,28,45,21,42,7,11,12,49,87
2015-03-25 00:00:00.000,Miami Open presented by Itaú FL; U.S.A. ATP World Tour Masters 1000,HARD,2,Rafael Nadal,Nicolas Almagro,Rafael Nadal,6-4; 6-2,R64,90,0,4,37,57,29,37,12,20,3,3,9,41,57,5,4,31,57,20,31,13,26,1,4,9,33,57
2015-03-25 00:00:00.000,Miami Open presented by Itaú FL; U.S.A. ATP World Tour Masters 1000,HARD,2,Novak Djokovic,Steve Darcis,Novak Djokovic,6-0; 7-5,R32,89,5,0,40,52,29,40,8,12,0,1,9,37,52,1,0,49,87,23,49,18,38,9,14,9,41,87
2015-03-25 00:00:00.000,Miami Open presented by Itaú FL; U.S.A. ATP World Tour Masters 1000,HARD,2,Alexandr Dolgopolov,Thomaz Bellucci,Alexandr Dolgopolov,7-5; 6-4,R32,88,5,2,42,64,34,42,8,22,1,3,11,42,64,7,7,40,71,26,40,14,31,0,4,11,40,71
2015-03-25 00:00:00.000,Miami Open presented by Itaú FL; U.S.A. ATP World Tour Masters 1000,HARD,2,Gilles Simon,Alejandro Falla,Gilles Simon,6-3; 6-4,R32,83,0,1,30,55,25,30,14,25,0,1,10,39,55,1,2,29,55,18,29,11,26,1,4,9,29,55
2015-03-25 00:00:00.000,Miami Open presented by Itaú FL; U.S.A. ATP World Tour Masters 1000,HARD,2,David Ferrer,Lukas Rosol,David Ferrer,6-4; 7-5,R32,93,2,2,44,62,36,44,11,18,6,7,11,47,62,4,2,44,80,29,44,19,36,8,11,11,48,80
2015-03-25 00:00:00.000,Miami Open presented by Itaú FL; U.S.A. ATP World Tour Masters 1000,HARD,2,Kei Nishikori,Viktor Troicki,Kei Nishikori,6-2; 6-2,R32,64,5,3,22,40,19,22,11,18,1,2,8,30,40,4,2,24,49,14,24,9,25,1,6,8,23,49
2015-03-25 00:00:00.000,Miami Open presented by Itaú FL; U.S.A. ATP World Tour Masters 1000,HARD,2,David Goffin,Jerzy Janowicz,David Goffin,6-4; 6-3,R32,76,0,5,39,56,29,39,7,17,3,5,9,36,56,7,3,34,60,22,34,8,26,6,11,10,30,60
2015-03-25 00:00:00.000,Miami Open presented by Itaú FL; U.S.A. ATP World Tour Masters 1000,HARD,2,John Isner,Grigor Dimitrov,John Isner,7-6(2); 6-2,R32,77,15,4,50,68,41,50,9,18,2,2,10,50,68,3,3,31,57,21,31,17,26,0,2,10,38,57
2015-03-25 00:00:00.000,Miami Open presented by Itaú FL; U.S.A. ATP World Tour Masters 1000,HARD,2,Milos Raonic,Jeremy Chardy,Milos Raonic,6-1; 5-7; 7-6(3),R32,130,20,1,76,106,56,76,19,30,6,8,16,75,106,6,10,52,98,41,52,24,46,7,10,15,65,98
2015-03-25 00:00:00.000,Miami Open presented by Itaú FL; U.S.A. ATP World Tour Masters 1000,HARD,2,Adrian Mannarino,Stan Wawrinka,Adrian Mannarino,7-6(4); 7-6(5),R32,132,2,2,59,98,41,59,18,39,4,7,12,59,98,3,7,43,91,30,43,23,48,5,8,12,53,91
2015-03-25 00:00:00.000,Miami Open presented by Itaú FL; U.S.A. ATP World Tour Masters 1000,HARD,2,Dominic Thiem,Jack Sock,Dominic Thiem,6-4; 6-3,R32,84,1,2,31,57,25,31,17,26,1,1,10,42,57,2,5,45,68,34,45,7,23,6,8,9,41,68
2015-03-25 00:00:00.000,Miami Open presented by Itaú FL; U.S.A. ATP World Tour Masters 1000,HARD,2,Kevin Anderson,Leonardo Mayer,Kevin Anderson,6-4; 6-4,R32,89,12,3,40,62,33,40,9,22,1,2,10,42,62,2,4,26,53,20,26,12,27,0,3,10,32,53
2015-03-25 00:00:00.000,Miami Open presented by Itaú FL; U.S.A. ATP World Tour Masters 1000,HARD,2,Andy Murray,Santiago Giraldo,Andy Murray,6-3; 6-4,R32,84,6,3,28,56,24,28,15,28,0,1,10,39,56,0,1,40,62,26,40,9,22,2,5,9,35,62
2015-03-25 00:00:00.000,Miami Open presented by Itaú FL; U.S.A. ATP World Tour Masters 1000,HARD,2,Tomas Berdych,Bernard Tomic,Tomas Berdych,6-7(4); 7-6(3); 6-1,R32,156,10,9,57,124,44,57,33,67,4,7,16,77,124,8,1,68,106,42,68,20,38,4,9,15,62,106
2015-03-25 00:00:00.000,Miami Open presented by Itaú FL; U.S.A. ATP World Tour Masters 1000,HARD,2,Gael Monfils,Jo-Wilfried Tsonga,Gael Monfils,6-4; 7-6(4),R32,94,2,2,48,75,33,48,17,27,4,5,11,50,75,5,4,37,68,33,37,13,31,1,3,11,46,68
2015-03-25 00:00:00.000,Miami Open presented by Itaú FL; U.S.A. ATP World Tour Masters 1000,HARD,2,Juan Monaco,Guillermo Garcia-Lopez,Juan Monaco,7-5; 6-4,R32,99,2,2,51,66,36,51,7,15,3,5,11,43,66,2,3,40,72,27,40,13,32,6,10,11,40,72
2015-03-25 00:00:00.000,Miami Open presented by Itaú FL; U.S.A. ATP World Tour Masters 1000,HARD,2,Fernando Verdasco,Rafael Nadal,Fernando Verdasco,6-4; 2-6; 6-3,R32,135,3,3,58,88,41,58,15,30,9,12,14,56,88,2,3,55,79,38,55,13,24,3,6,13,51,79
2015-03-25 00:00:00.000,Miami Open presented by Itaú FL; U.S.A. ATP World Tour Masters 1000,HARD,2,Novak Djokovic,Alexandr Dolgopolov,Novak Djokovic,6-7(3); 7-5; 6-0,R16,119,10,2,54,89,39,54,21,35,6,9,15,60,89,1,4,47,85,34,47,11,38,3,10,15,45,85
2015-03-25 00:00:00.000,Miami Open presented by Itaú FL; U.S.A. ATP World Tour Masters 1000,HARD,2,David Ferrer,Gilles Simon,David Ferrer,7-6(5); 6-0,R16,95,2,2,33,53,23,33,8,20,1,4,9,31,53,2,3,29,68,11,29,18,39,5,11,9,29,68
2015-03-25 00:00:00.000,Miami Open presented by Itaú FL; U.S.A. ATP World Tour Masters 1000,HARD,2,Kei Nishikori,David Goffin,Kei Nishikori,6-1; 6-2,R16,69,5,3,27,53,20,27,14,26,3,4,8,34,53,2,3,27,47,15,27,6,20,1,6,7,21,47
2015-03-25 00:00:00.000,Miami Open presented by Itaú FL; U.S.A. ATP World Tour Masters 1000,HARD,2,John Isner,Milos Raonic,John Isner,6-7(3); 7-6(6); 7-6(5),R16,163,25,2,75,115,61,75,27,40,3,3,18,88,115,13,4,72,118,61,72,28,46,1,1,18,89,118
2015-03-25 00:00:00.000,Miami Open presented by Itaú FL; U.S.A. ATP World Tour Masters 1000,HARD,2,Dominic Thiem,Adrian Mannarino,Dominic Thiem,7-6(5); 4-6; 7-5,R16,133,5,6,53,92,40,53,26,39,0,2,17,66,92,4,3,66,96,52,66,16,30,1,3,17,68,96
2015-03-25 00:00:00.000,Miami Open presented by Itaú FL; U.S.A. ATP World Tour Masters 1000,HARD,2,Andy Murray,Kevin Anderson,Andy Murray,6-4; 3-6; 6-3,R16,125,2,2,49,81,41,49,15,32,3,6,14,56,81,11,4,47,83,36,47,16,36,7,11,14,52,83
2015-03-25 00:00:00.000,Miami Open presented by Itaú FL; U.S.A. ATP World Tour Masters 1000,HARD,2,Tomas Berdych,Gael Monfils,Tomas Berdych,6-3; 3-2 RET,R16,66,6,0,28,42,21,28,10,14,1,1,7,31,42,7,4,31,53,21,31,8,22,10,12,7,29,53
2015-03-25 00:00:00.000,Miami Open presented by Itaú FL; U.S.A. ATP World Tour Masters 1000,HARD,2,Juan Monaco,Fernando Verdasco,Juan Monaco,6-3; 6-3,R16,83,4,2,48,66,32,48,8,18,4,5,9,40,66,1,4,35,58,20,35,10,23,5,9,9,30,58
2015-03-25 00:00:00.000,Miami Open presented by Itaú FL; U.S.A. ATP World Tour Masters 1000,HARD,2,Novak Djokovic,David Ferrer,Novak Djokovic,7-5; 7-5,Q,113,2,4,35,64,29,35,14,29,0,2,12,43,64,1,3,48,85,28,48,18,37,3,7,12,46,85
2015-03-25 00:00:00.000,Miami Open presented by Itaú FL; U.S.A. ATP World Tour Masters 1000,HARD,2,John Isner,Kei Nishikori,John Isner,6-4; 6-3,Q,71,13,0,36,52,28,36,13,16,0,0,10,41,52,1,1,38,57,22,38,11,19,3,5,9,33,57
2015-03-25 00:00:00.000,Miami Open presented by Itaú FL; U.S.A. ATP World Tour Masters 1000,HARD,2,Andy Murray,Dominic Thiem,Andy Murray,3-6; 6-4; 6-1,Q,105,6,2,37,65,30,37,17,28,1,3,13,47,65,3,5,52,82,35,52,13,30,3,7,13,48,82
2015-03-25 00:00:00.000,Miami Open presented by Itaú FL; U.S.A. ATP World Tour Masters 1000,HARD,2,Tomas Berdych,Juan Monaco,Tomas Berdych,6-3; 6-4,Q,92,3,4,31,65,25,31,20,34,3,4,10,45,65,0,0,45,60,30,45,6,15,5,8,9,36,60
2015-03-25 00:00:00.000,Miami Open presented by Itaú FL; U.S.A. ATP World Tour Masters 1000,HARD,2,Novak Djokovic,John Isner,Novak Djokovic,7-6(3); 6-2,S,91,10,1,36,58,29,36,16,22,0,0,10,45,58,9,1,55,82,39,55,8,27,2,4,10,47,82
2015-03-25 00:00:00.000,Miami Open presented by Itaú FL; U.S.A. ATP World Tour Masters 1000,HARD,2,Andy Murray,Tomas Berdych,Andy Murray,6-4; 6-4,S,102,3,3,40,57,32,40,6,17,0,2,10,38,57,2,4,39,68,23,39,13,29,2,6,10,36,68
2015-03-25 00:00:00.000,Miami Open presented by Itaú FL; U.S.A. ATP World Tour Masters 1000,HARD,2,Novak Djokovic,Andy Murray,Novak Djokovic,7-6(3); 4-6; 6-0,F,167,4,4,57,92,36,57,19,35,3,6,14,55,92,8,3,63,107,40,63,19,44,13,18,14,59,107
2015-04-06 00:00:00.000,Grand Prix Hassan II Morocco ATP World Tour 250,CLAY,2,Guillermo Garcia-Lopez,N/A Bye,Guillermo Garcia-Lopez,,R32,0,0,0,0,0,0,0,0,0,0,0,0,0,0,0,0,0,0,0,0,0,0,0,0,0,0,0
2015-04-06 00:00:00.000,Grand Prix Hassan II Morocco ATP World Tour 250,CLAY,2,Lamine Ouahab,Robin Haase,Lamine Ouahab,6-2; 6-4,R32,66,6,0,24,51,20,24,15,27,3,4,9,35,51,2,5,37,57,22,37,7,20,1,5,9,29,57
2015-04-06 00:00:00.000,Grand Prix Hassan II Morocco ATP World Tour 250,CLAY,2,Daniel Gimeno-Traver,Malek Jaziri,Daniel Gimeno-Traver,6-4; 6-3,R32,84,3,3,38,69,24,38,17,31,4,6,9,41,69,3,1,23,64,16,23,16,41,7,12,10,32,64
2015-04-06 00:00:00.000,Grand Prix Hassan II Morocco ATP World Tour 250,CLAY,2,Mikhail Kukushkin,Albert Ramos-Vinolas,Mikhail Kukushkin,6-1; 2-6; 6-3,R32,125,2,2,55,99,39,55,21,44,12,14,12,60,99,2,1,32,66,23,32,18,34,2,6,12,41,66
2015-04-06 00:00:00.000,Grand Prix Hassan II Morocco ATP World Tour 250,CLAY,2,Jiri Vesely,N/A Bye,Jiri Vesely,,R32,0,0,0,0,0,0,0,0,0,0,0,0,0,0,0,0,0,0,0,0,0,0,0,0,0,0,0
2015-04-06 00:00:00.000,Grand Prix Hassan II Morocco ATP World Tour 250,CLAY,2,Mikhail Youzhny,Yassine Idmbarek,Mikhail Youzhny,6-3; 6-1,R32,70,6,2,29,49,25,29,10,20,1,1,8,35,49,0,7,39,76,18,39,19,37,8,12,8,37,76
2015-04-06 00:00:00.000,Grand Prix Hassan II Morocco ATP World Tour 250,CLAY,2,Aljaz Bedene,Maximo Gonzalez,Aljaz Bedene,6-3; 3-6; 6-3,R32,117,7,4,38,86,33,38,26,48,3,4,14,59,86,1,3,41,73,31,41,19,32,0,2,13,50,73
2015-04-06 00:00:00.000,Grand Prix Hassan II Morocco ATP World Tour 250,CLAY,2,Arthur De Greef,Diego Schwartzman,Arthur De Greef,4-6; 7-5; 6-4,R32,135,7,4,45,97,34,45,25,52,3,7,16,59,97,1,4,56,100,35,56,24,44,5,10,16,59,100
2015-04-06 00:00:00.000,Grand Prix Hassan II Morocco ATP World Tour 250,CLAY,2,Andreas Haider-Maurer,Jan-Lennard Struff,Andreas Haider-Maurer,6-2; 6-7(0); 7-6(5),R32,153,5,6,55,104,46,55,24,49,1,2,16,70,104,15,3,72,123,50,72,25,51,6,9,16,75,123
2015-04-06 00:00:00.000,Grand Prix Hassan II Morocco ATP World Tour 250,CLAY,2,Pablo Andujar,Tobias Kamke,Pablo Andujar,6-3; 6-4,R32,82,0,1,36,55,23,36,8,19,1,4,10,31,55,1,4,28,58,18,28,10,30,4,9,9,28,58
2015-04-06 00:00:00.000,Grand Prix Hassan II Morocco ATP World Tour 250,CLAY,2,Damir Dzumhur,Paul-Henri Mathieu,Damir Dzumhur,6-2; 7-6(2),R32,78,9,0,35,58,25,35,15,23,1,3,10,40,58,0,6,45,71,26,45,11,26,6,10,10,37,71
2015-04-06 00:00:00.000,Grand Prix Hassan II Morocco ATP World Tour 250,CLAY,2,Marcel Granollers,N/A Bye,Marcel Granollers,,R32,0,0,0,0,0,0,0,0,0,0,0,0,0,0,0,0,0,0,0,0,0,0,0,0,0,0,0
2015-04-06 00:00:00.000,Grand Prix Hassan II Morocco ATP World Tour 250,CLAY,2,Carlos Berlocq,Pablo Carreno Busta,Carlos Berlocq,4-6; 7-6(8); 6-4,R32,187,9,2,75,118,56,75,17,43,6,10,16,73,118,8,3,76,140,50,76,31,64,10,14,16,81,140
2015-04-06 00:00:00.000,Grand Prix Hassan II Morocco ATP World Tour 250,CLAY,2,Nicolas Almagro,Taro Daniel,Nicolas Almagro,6-4; 6-1,R32,63,7,1,31,48,23,31,11,17,2,3,9,34,48,2,0,23,45,12,23,9,22,6,10,8,21,45
2015-04-06 00:00:00.000,Grand Prix Hassan II Morocco ATP World Tour 250,CLAY,2,Dustin Brown,Andrey Kuznetsov,Dustin Brown,6-2; 6-4,R32,61,0,3,34,53,28,34,7,19,2,3,9,35,53,3,3,32,62,21,32,11,30,4,8,9,32,62
2015-04-06 00:00:00.000,Grand Prix Hassan II Morocco ATP World Tour 250,CLAY,2,Martin Klizan,N/A Bye,Martin Klizan,,R32,0,0,0,0,0,0,0,0,0,0,0,0,0,0,0,0,0,0,0,0,0,0,0,0,0,0,0
2015-04-06 00:00:00.000,Grand Prix Hassan II Morocco ATP World Tour 250,CLAY,2,Lamine Ouahab,Guillermo Garcia-Lopez,Lamine Ouahab,6-3; 6-3,R16,89,0,2,33,56,27,33,12,23,4,5,9,39,56,2,1,39,63,23,39,12,24,9,13,9,35,63
2015-04-06 00:00:00.000,Grand Prix Hassan II Morocco ATP World Tour 250,CLAY,2,Daniel Gimeno-Traver,Mikhail Kukushkin,Daniel Gimeno-Traver,6-1; 4-1 RET,R16,54,1,0,15,29,14,15,10,14,0,0,6,24,29,1,4,33,51,17,33,6,18,6,10,6,23,51
2015-04-06 00:00:00.000,Grand Prix Hassan II Morocco ATP World Tour 250,CLAY,2,Jiri Vesely,Mikhail Youzhny,Jiri Vesely,7-6(7); 6-3,R16,99,9,2,43,68,34,43,16,25,1,2,11,50,68,3,2,52,74,34,52,15,22,2,4,10,49,74
2015-04-06 00:00:00.000,Grand Prix Hassan II Morocco ATP World Tour 250,CLAY,2,Aljaz Bedene,Arthur De Greef,Aljaz Bedene,6-2; 6-3,R16,70,4,0,24,43,21,24,15,19,0,0,9,36,43,2,4,25,57,10,25,20,32,2,5,8,30,57
2015-04-06 00:00:00.000,Grand Prix Hassan II Morocco ATP World Tour 250,CLAY,2,Andreas Haider-Maurer,Pablo Andujar,Andreas Haider-Maurer,7-5; 6-3,R16,86,9,4,36,71,26,36,23,35,4,4,11,49,71,1,0,38,53,29,38,6,15,2,4,10,35,53
2015-04-06 00:00:00.000,Grand Prix Hassan II Morocco ATP World Tour 250,CLAY,2,Damir Dzumhur,Marcel Granollers,Damir Dzumhur,3-0 RET,R16,24,1,0,6,8,6,6,1,2,0,0,1,7,8,0,2,5,18,2,5,4,13,1,3,2,6,18
2015-04-06 00:00:00.000,Grand Prix Hassan II Morocco ATP World Tour 250,CLAY,2,Nicolas Almagro,Carlos Berlocq,Nicolas Almagro,7-5; 7-5,R16,101,1,2,34,65,28,34,21,31,0,0,12,49,65,3,3,47,79,37,47,14,32,4,6,12,51,79
2015-04-06 00:00:00.000,Grand Prix Hassan II Morocco ATP World Tour 250,CLAY,2,Martin Klizan,Dustin Brown,Martin Klizan,6-4; 4-6; 7-6(5),R16,126,3,3,49,109,33,49,32,60,6,10,16,65,109,3,3,54,93,38,54,22,39,5,9,16,60,93
2015-04-06 00:00:00.000,Grand Prix Hassan II Morocco ATP World Tour 250,CLAY,2,Daniel Gimeno-Traver,Lamine Ouahab,Daniel Gimeno-Traver,6-4; 6-3,Q,70,2,3,34,55,28,34,9,21,1,2,9,37,55,1,0,32,61,20,32,12,29,6,10,10,32,61
2015-04-06 00:00:00.000,Grand Prix Hassan II Morocco ATP World Tour 250,CLAY,2,Jiri Vesely,Aljaz Bedene,Jiri Vesely,6-1; 6-4,Q,80,4,2,46,59,35,46,6,13,2,2,9,41,59,3,2,33,58,22,33,11,25,6,9,8,33,58
2015-04-06 00:00:00.000,Grand Prix Hassan II Morocco ATP World Tour 250,CLAY,2,Damir Dzumhur,Andreas Haider-Maurer,Damir Dzumhur,6-3; 6-3,Q,66,6,1,40,54,28,40,10,14,2,3,9,38,54,3,4,38,60,22,38,10,22,7,11,9,32,60
2015-04-06 00:00:00.000,Grand Prix Hassan II Morocco ATP World Tour 250,CLAY,2,Martin Klizan,Nicolas Almagro,Martin Klizan,6-4; 7-6(3),Q,95,7,5,35,64,30,35,18,29,6,7,11,48,64,13,5,42,83,32,42,20,41,4,6,11,52,83
2015-04-06 00:00:00.000,Grand Prix Hassan II Morocco ATP World Tour 250,CLAY,2,Daniel Gimeno-Traver,Jiri Vesely,Daniel Gimeno-Traver,6-7(3); 6-4; 6-4,S,149,6,1,66,97,47,66,22,31,0,0,16,69,97,4,0,66,101,46,66,23,35,3,5,16,69,101
2015-04-06 00:00:00.000,Grand Prix Hassan II Morocco ATP World Tour 250,CLAY,2,Martin Klizan,Damir Dzumhur,Martin Klizan,4-6; 6-4; 6-0,S,111,0,3,64,89,43,64,12,25,5,7,13,55,89,3,2,45,71,28,45,14,26,2,7,13,42,71
2015-04-06 00:00:00.000,Grand Prix Hassan II Morocco ATP World Tour 250,CLAY,2,Martin Klizan,Daniel Gimeno-Traver,Martin Klizan,6-2; 6-2,F,76,2,3,29,56,23,29,15,27,7,7,8,38,56,2,3,36,54,23,36,7,18,2,6,8,30,54
2015-04-06 00:00:00.000,Fayez Sarofim & Co. U.S. Men's Clay Court Championship TX; U.S.A. ATP World Tour 250,CLAY,2,Feliciano Lopez,N/A Bye,Feliciano Lopez,,R32,0,0,0,0,0,0,0,0,0,0,0,0,0,0,0,0,0,0,0,0,0,0,0,0,0,0,0
2015-04-06 00:00:00.000,Fayez Sarofim & Co. U.S. Men's Clay Court Championship TX; U.S.A. ATP World Tour 250,CLAY,2,Sam Groth,Victor Estrella Burgos,Sam Groth,7-6(3); 6-4,R32,89,17,5,41,69,33,41,18,28,1,1,11,51,69,2,0,61,77,38,61,12,16,3,4,11,50,77
2015-04-06 00:00:00.000,Fayez Sarofim & Co. U.S. Men's Clay Court Championship TX; U.S.A. ATP World Tour 250,CLAY,2,Steve Johnson,Donald Young,Steve Johnson,7-5; 6-4,R32,86,7,2,35,70,29,35,19,35,4,5,11,48,70,2,6,38,67,25,38,15,29,6,9,11,40,67
2015-04-06 00:00:00.000,Fayez Sarofim & Co. U.S. Men's Clay Court Championship TX; U.S.A. ATP World Tour 250,CLAY,2,Sam Querrey,Marinko Matosevic,Sam Querrey,4-1 RET,R32,19,7,1,9,14,9,9,3,5,0,0,3,12,14,0,0,9,13,3,9,4,4,0,1,2,7,13
2015-04-06 00:00:00.000,Fayez Sarofim & Co. U.S. Men's Clay Court Championship TX; U.S.A. ATP World Tour 250,CLAY,2,John Isner,N/A Bye,John Isner,,R32,0,0,0,0,0,0,0,0,0,0,0,0,0,0,0,0,0,0,0,0,0,0,0,0,0,0,0
2015-04-06 00:00:00.000,Fayez Sarofim & Co. U.S. Men's Clay Court Championship TX; U.S.A. ATP World Tour 250,CLAY,2,Teymuraz Gabashvili,Tim Smyczek,Teymuraz Gabashvili,6-3; 6-3,R32,64,4,2,30,48,24,30,13,18,0,0,9,37,48,3,0,45,64,25,45,12,19,12,15,9,37,64
2015-04-06 00:00:00.000,Fayez Sarofim & Co. U.S. Men's Clay Court Championship TX; U.S.A. ATP World Tour 250,CLAY,2,Hyeon Chung,Facundo Arguello,Hyeon Chung,6-3; 7-5,R32,93,3,1,34,55,25,34,13,21,0,1,10,38,55,3,4,49,76,30,49,10,27,4,8,11,40,76
2015-04-06 00:00:00.000,Fayez Sarofim & Co. U.S. Men's Clay Court Championship TX; U.S.A. ATP World Tour 250,CLAY,2,Fernando Verdasco,Paolo Lorenzi,Fernando Verdasco,6-3; 4-3 RET,R32,78,2,1,25,42,20,25,15,17,0,0,8,35,42,3,2,30,62,19,30,17,32,3,5,8,36,62
2015-04-06 00:00:00.000,Fayez Sarofim & Co. U.S. Men's Clay Court Championship TX; U.S.A. ATP World Tour 250,CLAY,2,Jeremy Chardy,Dusan Lajovic,Jeremy Chardy,6-4; 6-4,R32,74,7,1,36,53,28,36,9,17,1,3,10,37,53,1,4,31,58,17,31,16,27,5,9,10,33,58
2015-04-06 00:00:00.000,Fayez Sarofim & Co. U.S. Men's Clay Court Championship TX; U.S.A. ATP World Tour 250,CLAY,2,Go Soeda,Lleyton Hewitt,Go Soeda,4-6; 7-6(3); 6-3,R32,156,1,1,57,100,38,57,15,43,9,16,15,53,100,3,8,62,114,38,62,20,52,9,17,16,58,114
2015-04-06 00:00:00.000,Fayez Sarofim & Co. U.S. Men's Clay Court Championship TX; U.S.A. ATP World Tour 250,CLAY,2,Federico Delbonis,Ricardas Berankis,Federico Delbonis,6-2; 7-6(5),R32,86,2,7,27,66,21,27,23,39,2,3,10,44,66,1,2,39,65,27,39,12,26,5,8,10,39,65
2015-04-06 00:00:00.000,Fayez Sarofim & Co. U.S. Men's Clay Court Championship TX; U.S.A. ATP World Tour 250,CLAY,2,Kevin Anderson,N/A Bye,Kevin Anderson,,R32,0,0,0,0,0,0,0,0,0,0,0,0,0,0,0,0,0,0,0,0,0,0,0,0,0,0,0
2015-04-06 00:00:00.000,Fayez Sarofim & Co. U.S. Men's Clay Court Championship TX; U.S.A. ATP World Tour 250,CLAY,2,Santiago Giraldo,Rogerio Dutra Silva,Santiago Giraldo,6-2; 6-2,R32,59,3,1,36,50,28,36,6,14,1,2,8,34,50,2,4,21,47,12,21,10,26,3,8,8,22,47
2015-04-06 00:00:00.000,Fayez Sarofim & Co. U.S. Men's Clay Court Championship TX; U.S.A. ATP World Tour 250,CLAY,2,Janko Tipsarevic,Guilherme Clezar,Janko Tipsarevic,6-4; 3-6; 7-6(7),R32,158,18,12,52,107,42,52,21,55,7,11,15,63,107,8,3,67,106,49,67,13,39,3,7,16,62,106
2015-04-06 00:00:00.000,Fayez Sarofim & Co. U.S. Men's Clay Court Championship TX; U.S.A. ATP World Tour 250,CLAY,2,Jack Sock,Joao Souza,Jack Sock,5-7; 6-4; 6-2,R32,117,6,7,42,78,34,42,20,36,1,3,15,54,78,3,0,55,80,42,55,11,25,2,6,15,53,80
2015-04-06 00:00:00.000,Fayez Sarofim & Co. U.S. Men's Clay Court Championship TX; U.S.A. ATP World Tour 250,CLAY,2,Roberto Bautista Agut,N/A Bye,Roberto Bautista Agut,,R32,0,0,0,0,0,0,0,0,0,0,0,0,0,0,0,0,0,0,0,0,0,0,0,0,0,0,0
2015-04-06 00:00:00.000,Fayez Sarofim & Co. U.S. Men's Clay Court Championship TX; U.S.A. ATP World Tour 250,CLAY,2,Feliciano Lopez,Sam Groth,Feliciano Lopez,6-3; 6-3,R16,67,4,4,28,50,23,28,15,22,1,1,9,38,50,9,6,30,60,22,30,12,30,4,7,9,34,60
2015-04-06 00:00:00.000,Fayez Sarofim & Co. U.S. Men's Clay Court Championship TX; U.S.A. ATP World Tour 250,CLAY,2,Sam Querrey,Steve Johnson,Sam Querrey,6-1; 4-6; 6-0,R16,83,15,2,40,75,34,40,15,35,6,8,12,49,75,5,2,34,64,19,34,11,30,2,8,11,30,64
2015-04-06 00:00:00.000,Fayez Sarofim & Co. U.S. Men's Clay Court Championship TX; U.S.A. ATP World Tour 250,CLAY,2,Teymuraz Gabashvili,John Isner,Teymuraz Gabashvili,6-2; 7-6(2),R16,77,1,2,39,62,31,39,15,23,4,4,10,46,62,8,3,38,63,25,38,15,25,1,3,10,40,63
2015-04-06 00:00:00.000,Fayez Sarofim & Co. U.S. Men's Clay Court Championship TX; U.S.A. ATP World Tour 250,CLAY,2,Fernando Verdasco,Hyeon Chung,Fernando Verdasco,7-6(5); 6-2,R16,93,2,1,46,64,37,46,11,18,2,2,10,48,64,0,2,34,59,25,34,15,25,3,5,10,40,59
2015-04-06 00:00:00.000,Fayez Sarofim & Co. U.S. Men's Clay Court Championship TX; U.S.A. ATP World Tour 250,CLAY,2,Jeremy Chardy,Go Soeda,Jeremy Chardy,6-3; 6-3,R16,78,2,3,35,58,23,35,14,23,1,2,9,37,58,2,4,28,57,15,28,12,29,3,7,9,27,57
2015-04-06 00:00:00.000,Fayez Sarofim & Co. U.S. Men's Clay Court Championship TX; U.S.A. ATP World Tour 250,CLAY,2,Kevin Anderson,Federico Delbonis,Kevin Anderson,6-7(4); 6-0; 6-3,R16,126,8,5,53,86,40,53,13,33,2,5,14,53,86,2,9,43,82,22,43,16,39,2,9,13,38,82
2015-04-06 00:00:00.000,Fayez Sarofim & Co. U.S. Men's Clay Court Championship TX; U.S.A. ATP World Tour 250,CLAY,2,Santiago Giraldo,Janko Tipsarevic,Santiago Giraldo,7-6(2); 6-3,R16,93,6,1,47,76,37,47,15,29,1,2,11,52,76,3,4,33,57,28,33,10,24,1,3,10,38,57
2015-04-06 00:00:00.000,Fayez Sarofim & Co. U.S. Men's Clay Court Championship TX; U.S.A. ATP World Tour 250,CLAY,2,Jack Sock,Roberto Bautista Agut,Jack Sock,6-4; 6-4,R16,82,3,9,42,67,32,42,12,25,2,2,10,44,67,0,2,36,55,25,36,13,19,5,7,10,38,55
2015-04-06 00:00:00.000,Fayez Sarofim & Co. U.S. Men's Clay Court Championship TX; U.S.A. ATP World Tour 250,CLAY,2,Sam Querrey,Feliciano Lopez,Sam Querrey,6-4; 6-1,Q,64,11,3,27,49,23,27,12,22,2,3,9,35,49,4,2,19,50,10,19,15,31,7,11,8,25,50
2015-04-06 00:00:00.000,Fayez Sarofim & Co. U.S. Men's Clay Court Championship TX; U.S.A. ATP World Tour 250,CLAY,2,Fernando Verdasco,Teymuraz Gabashvili,Fernando Verdasco,6-2; 6-3,Q,73,6,1,44,54,34,44,5,10,1,2,9,39,54,2,2,31,62,15,31,17,31,7,11,8,32,62
2015-04-06 00:00:00.000,Fayez Sarofim & Co. U.S. Men's Clay Court Championship TX; U.S.A. ATP World Tour 250,CLAY,2,Kevin Anderson,Jeremy Chardy,Kevin Anderson,7-5; 6-7(6); 7-6(3),Q,188,18,3,82,122,61,82,19,40,5,8,18,80,122,6,8,94,138,62,94,21,44,6,10,18,83,138
2015-04-06 00:00:00.000,Fayez Sarofim & Co. U.S. Men's Clay Court Championship TX; U.S.A. ATP World Tour 250,CLAY,2,Jack Sock,Santiago Giraldo,Jack Sock,6-4; 6-4,Q,93,3,3,37,62,31,37,14,25,7,7,10,45,62,0,1,43,61,28,43,12,18,1,3,10,40,61
2015-04-06 00:00:00.000,Fayez Sarofim & Co. U.S. Men's Clay Court Championship TX; U.S.A. ATP World Tour 250,CLAY,2,Sam Querrey,Fernando Verdasco,Sam Querrey,7-5; 2-6; 6-4,S,125,16,1,53,86,43,53,18,33,1,3,15,61,86,5,2,71,90,51,71,10,19,7,9,15,61,90
2015-04-06 00:00:00.000,Fayez Sarofim & Co. U.S. Men's Clay Court Championship TX; U.S.A. ATP World Tour 250,CLAY,2,Jack Sock,Kevin Anderson,Jack Sock,7-6(3); 6-3,S,93,7,4,33,66,27,33,24,33,1,1,11,51,66,14,1,44,69,31,44,14,25,8,9,10,45,69
2015-04-06 00:00:00.000,Fayez Sarofim & Co. U.S. Men's Clay Court Championship TX; U.S.A. ATP World Tour 250,CLAY,2,Jack Sock,Sam Querrey,Jack Sock,7-6(9); 7-6(2),F,106,5,11,44,88,34,44,25,44,3,5,12,59,88,8,6,34,74,27,34,26,40,1,3,12,53,74
2015-04-12 00:00:00.000,Monte-Carlo Rolex Masters Monaco ATP World Tour Masters 1000,CLAY,2,Novak Djokovic,N/A Bye,Novak Djokovic,,R64,0,0,0,0,0,0,0,0,0,0,0,0,0,0,0,0,0,0,0,0,0,0,0,0,0,0,0
2015-04-12 00:00:00.000,Monte-Carlo Rolex Masters Monaco ATP World Tour Masters 1000,CLAY,2,Albert Ramos-Vinolas,Robin Haase,Albert Ramos-Vinolas,6-1; 6-1,R64,60,1,2,27,43,22,27,9,16,1,1,7,31,43,0,3,30,51,13,30,10,21,8,13,7,23,51
2015-04-12 00:00:00.000,Monte-Carlo Rolex Masters Monaco ATP World Tour Masters 1000,CLAY,2,Bernard Tomic,Lukas Rosol,Bernard Tomic,4-6; 6-2; 6-3,R64,90,2,1,47,73,31,47,11,26,5,10,13,42,73,4,5,35,83,21,35,19,48,3,11,14,40,83
2015-04-12 00:00:00.000,Monte-Carlo Rolex Masters Monaco ATP World Tour Masters 1000,CLAY,2,Andreas Haider-Maurer,Ernests Gulbis,Andreas Haider-Maurer,6-1; 6-0,R64,58,1,0,26,39,19,26,10,13,3,3,7,29,39,1,6,22,48,13,22,7,26,8,13,6,20,48
2015-04-12 00:00:00.000,Monte-Carlo Rolex Masters Monaco ATP World Tour Masters 1000,CLAY,2,Jo-Wilfried Tsonga,Jan-Lennard Struff,Jo-Wilfried Tsonga,6-4; 6-4,R64,77,4,1,32,66,25,32,21,34,7,7,10,46,66,2,4,39,59,29,39,10,20,1,3,10,39,59
2015-04-12 00:00:00.000,Monte-Carlo Rolex Masters Monaco ATP World Tour Masters 1000,CLAY,2,David Goffin,Norbert Gombos,David Goffin,6-1; 6-4,R64,73,5,5,27,53,18,27,14,26,2,4,8,32,53,1,4,28,58,14,28,10,30,6,12,9,24,58
2015-04-12 00:00:00.000,Monte-Carlo Rolex Masters Monaco ATP World Tour Masters 1000,CLAY,2,Florian Mayer,Mikhail Youzhny,Florian Mayer,7-6(8); 6-4,R64,92,6,0,43,68,31,43,16,25,1,2,11,47,68,1,0,42,72,28,42,16,30,2,4,11,44,72
2015-04-12 00:00:00.000,Monte-Carlo Rolex Masters Monaco ATP World Tour Masters 1000,CLAY,2,Marin Cilic,N/A Bye,Marin Cilic,,R64,0,0,0,0,0,0,0,0,0,0,0,0,0,0,0,0,0,0,0,0,0,0,0,0,0,0,0
2015-04-12 00:00:00.000,Monte-Carlo Rolex Masters Monaco ATP World Tour Masters 1000,CLAY,2,Rafael Nadal,N/A Bye,Rafael Nadal,,R64,0,0,0,0,0,0,0,0,0,0,0,0,0,0,0,0,0,0,0,0,0,0,0,0,0,0,0
2015-04-12 00:00:00.000,Monte-Carlo Rolex Masters Monaco ATP World Tour Masters 1000,CLAY,2,Lucas Pouille,Dominic Thiem,Lucas Pouille,6-4; 6-4,R64,84,2,5,27,63,17,27,17,36,6,10,10,34,63,3,1,32,63,17,32,14,31,6,12,10,31,63
2015-04-12 00:00:00.000,Monte-Carlo Rolex Masters Monaco ATP World Tour Masters 1000,CLAY,2,Viktor Troicki,Martin Klizan,Viktor Troicki,7-6(5); 5-7; 6-2,R64,156,7,0,65,116,48,65,27,51,9,11,16,75,116,6,2,54,95,40,54,20,41,0,3,16,60,95
2015-04-12 00:00:00.000,Monte-Carlo Rolex Masters Monaco ATP World Tour Masters 1000,CLAY,2,John Isner,Steve Johnson,John Isner,6-4; 6-4,R64,71,13,1,34,46,30,34,8,12,0,1,10,38,46,2,3,44,76,28,44,15,32,3,6,10,43,76
2015-04-12 00:00:00.000,Monte-Carlo Rolex Masters Monaco ATP World Tour Masters 1000,CLAY,2,Gilles Simon,Benjamin Balleret,Gilles Simon,6-4; 6-2,R64,72,4,1,30,53,24,30,12,23,1,2,9,36,53,4,1,28,50,18,28,10,22,2,6,9,28,50
2015-04-12 00:00:00.000,Monte-Carlo Rolex Masters Monaco ATP World Tour Masters 1000,CLAY,2,Benoit Paire,Denis Kudla,Benoit Paire,6-3; 7-6(3),R64,96,9,1,41,84,28,41,22,43,7,9,11,50,84,1,0,57,82,36,57,11,25,7,10,10,47,82
2015-04-12 00:00:00.000,Monte-Carlo Rolex Masters Monaco ATP World Tour Masters 1000,CLAY,2,Victor Estrella Burgos,Simone Bolelli,Victor Estrella Burgos,6-4; 7-6(5),R64,99,1,1,50,74,32,50,16,24,0,2,11,48,74,2,0,45,72,34,45,12,27,1,4,11,46,72
2015-04-12 00:00:00.000,Monte-Carlo Rolex Masters Monaco ATP World Tour Masters 1000,CLAY,2,David Ferrer,N/A Bye,David Ferrer,,R64,0,0,0,0,0,0,0,0,0,0,0,0,0,0,0,0,0,0,0,0,0,0,0,0,0,0,0
2015-04-12 00:00:00.000,Monte-Carlo Rolex Masters Monaco ATP World Tour Masters 1000,CLAY,2,Tomas Berdych,N/A Bye,Tomas Berdych,,R64,0,0,0,0,0,0,0,0,0,0,0,0,0,0,0,0,0,0,0,0,0,0,0,0,0,0,0
2015-04-12 00:00:00.000,Monte-Carlo Rolex Masters Monaco ATP World Tour Masters 1000,CLAY,2,Sergiy Stakhovsky,Pablo Carreno Busta,Sergiy Stakhovsky,7-6(3); 4-6; 6-4,R64,139,11,3,70,113,52,70,21,43,5,7,16,73,113,6,3,60,105,42,60,25,45,8,10,16,67,105
2015-04-12 00:00:00.000,Monte-Carlo Rolex Masters Monaco ATP World Tour Masters 1000,CLAY,2,Philipp Kohlschreiber,Mikhail Kukushkin,Philipp Kohlschreiber,6-4; 6-4,R64,76,3,0,34,53,24,34,9,19,1,4,10,33,53,2,4,31,60,20,31,9,29,3,8,10,29,60
2015-04-12 00:00:00.000,Monte-Carlo Rolex Masters Monaco ATP World Tour Masters 1000,CLAY,2,Roberto Bautista Agut,Benjamin Becker,Roberto Bautista Agut,6-0; 6-2,R64,53,3,0,20,35,16,20,10,15,2,3,7,26,35,5,1,21,40,13,21,2,19,3,9,7,15,40
2015-04-12 00:00:00.000,Monte-Carlo Rolex Masters Monaco ATP World Tour Masters 1000,CLAY,2,Tommy Robredo,Andreas Seppi,Tommy Robredo,6-3; 1-6; 6-4,R64,107,7,4,42,76,31,42,14,34,4,8,13,45,76,0,2,41,85,27,41,21,44,6,10,13,48,85
2015-04-12 00:00:00.000,Monte-Carlo Rolex Masters Monaco ATP World Tour Masters 1000,CLAY,2,Marcel Granollers,Adrian Mannarino,Marcel Granollers,6-3; 6-0,R64,63,3,2,31,44,23,31,8,13,2,3,8,31,44,0,2,30,47,14,30,7,17,5,10,7,21,47
2015-04-12 00:00:00.000,Monte-Carlo Rolex Masters Monaco ATP World Tour Masters 1000,CLAY,2,Joao Sousa,Edouard Roger-Vasselin,Joao Sousa,6-1; 3-6; 6-0,R64,97,4,6,41,72,30,41,13,31,7,10,11,43,72,0,1,49,72,26,49,8,23,9,16,11,34,72
2015-04-12 00:00:00.000,Monte-Carlo Rolex Masters Monaco ATP World Tour Masters 1000,CLAY,2,Milos Raonic,N/A Bye,Milos Raonic,,R64,0,0,0,0,0,0,0,0,0,0,0,0,0,0,0,0,0,0,0,0,0,0,0,0,0,0,0
2015-04-12 00:00:00.000,Monte-Carlo Rolex Masters Monaco ATP World Tour Masters 1000,CLAY,2,Stan Wawrinka,N/A Bye,Stan Wawrinka,,R64,0,0,0,0,0,0,0,0,0,0,0,0,0,0,0,0,0,0,0,0,0,0,0,0,0,0,0
2015-04-12 00:00:00.000,Monte-Carlo Rolex Masters Monaco ATP World Tour Masters 1000,CLAY,2,Juan Monaco,Jiri Vesely,Juan Monaco,6-4; 6-2,R64,93,0,1,53,70,31,53,11,17,4,6,9,42,70,2,5,37,67,17,37,16,30,7,12,9,33,67
2015-04-12 00:00:00.000,Monte-Carlo Rolex Masters Monaco ATP World Tour Masters 1000,CLAY,2,Fabio Fognini,Jerzy Janowicz,Fabio Fognini,6-3; 6-1,R64,58,5,2,24,50,18,24,13,26,4,6,8,31,50,1,5,27,51,13,27,9,24,5,11,8,22,51
2015-04-12 00:00:00.000,Monte-Carlo Rolex Masters Monaco ATP World Tour Masters 1000,CLAY,2,Grigor Dimitrov,Fernando Verdasco,Grigor Dimitrov,6-4; 4-6; 6-4,R64,147,6,2,68,112,48,68,22,44,15,17,15,70,112,2,4,66,94,45,66,15,28,7,10,15,60,94
2015-04-12 00:00:00.000,Monte-Carlo Rolex Masters Monaco ATP World Tour Masters 1000,CLAY,2,Gael Monfils,Andrey Kuznetsov,Gael Monfils,4-6; 6-3; 6-4,R64,112,6,0,55,97,41,55,17,42,6,10,15,58,97,1,2,48,85,33,48,18,37,6,11,14,51,85
2015-04-12 00:00:00.000,Monte-Carlo Rolex Masters Monaco ATP World Tour Masters 1000,CLAY,2,Alexandr Dolgopolov,Borna Coric,Alexandr Dolgopolov,7-5; 5-7; 6-2,R64,133,10,4,46,101,40,46,25,55,10,14,16,65,101,3,9,42,88,28,42,22,46,2,8,16,50,88
2015-04-12 00:00:00.000,Monte-Carlo Rolex Masters Monaco ATP World Tour Masters 1000,CLAY,2,Jeremy Chardy,Diego Schwartzman,Jeremy Chardy,7-5; 6-2,R64,74,6,0,37,60,24,37,15,23,3,5,10,39,60,1,4,37,58,20,37,8,21,5,10,10,28,58
2015-04-12 00:00:00.000,Monte-Carlo Rolex Masters Monaco ATP World Tour Masters 1000,CLAY,2,Roger Federer,N/A Bye,Roger Federer,,R64,0,0,0,0,0,0,0,0,0,0,0,0,0,0,0,0,0,0,0,0,0,0,0,0,0,0,0
2015-04-12 00:00:00.000,Monte-Carlo Rolex Masters Monaco ATP World Tour Masters 1000,CLAY,2,Novak Djokovic,Albert Ramos-Vinolas,Novak Djokovic,6-1; 6-4,R32,87,3,2,29,54,23,29,16,25,3,4,9,39,54,0,3,35,62,18,35,14,27,9,13,8,32,62
2015-04-12 00:00:00.000,Monte-Carlo Rolex Masters Monaco ATP World Tour Masters 1000,CLAY,2,Andreas Haider-Maurer,Bernard Tomic,Andreas Haider-Maurer,6-7(4); 7-6(5); 6-4,R32,168,15,5,77,134,54,77,31,57,13,15,17,85,134,9,1,100,138,66,100,19,38,6,9,17,85,138
2015-04-12 00:00:00.000,Monte-Carlo Rolex Masters Monaco ATP World Tour Masters 1000,CLAY,2,Jo-Wilfried Tsonga,David Goffin,Jo-Wilfried Tsonga,6-3; 6-4,R32,85,5,3,41,71,29,41,19,30,4,4,10,48,71,4,2,31,60,21,31,16,29,7,9,9,37,60
2015-04-12 00:00:00.000,Monte-Carlo Rolex Masters Monaco ATP World Tour Masters 1000,CLAY,2,Marin Cilic,Florian Mayer,Marin Cilic,6-3; 3-6; 6-3,R32,100,8,1,54,87,41,54,18,33,4,6,14,59,87,5,3,53,80,36,53,17,27,2,5,13,53,80
2015-04-12 00:00:00.000,Monte-Carlo Rolex Masters Monaco ATP World Tour Masters 1000,CLAY,2,Rafael Nadal,Lucas Pouille,Rafael Nadal,6-2; 6-1,R32,69,0,0,28,44,25,28,8,16,0,0,8,33,44,0,0,21,43,11,21,9,22,3,7,7,20,43
2015-04-12 00:00:00.000,Monte-Carlo Rolex Masters Monaco ATP World Tour Masters 1000,CLAY,2,John Isner,Viktor Troicki,John Isner,7-6(4); 7-6(5),R32,101,16,1,67,86,52,67,12,19,7,7,12,64,86,5,0,60,86,45,60,16,26,3,3,12,61,86
2015-04-12 00:00:00.000,Monte-Carlo Rolex Masters Monaco ATP World Tour Masters 1000,CLAY,2,Gilles Simon,Benoit Paire,Gilles Simon,6-4; 7-5,R32,108,1,6,64,96,37,64,13,32,10,15,11,50,96,4,8,35,68,21,35,8,33,2,9,11,29,68
2015-04-12 00:00:00.000,Monte-Carlo Rolex Masters Monaco ATP World Tour Masters 1000,CLAY,2,David Ferrer,Victor Estrella Burgos,David Ferrer,6-2; 2-0 RET,R32,49,1,2,16,26,13,16,4,10,0,1,5,17,26,1,0,23,40,10,23,5,17,7,11,5,15,40
2015-04-12 00:00:00.000,Monte-Carlo Rolex Masters Monaco ATP World Tour Masters 1000,CLAY,2,Tomas Berdych,Sergiy Stakhovsky,Tomas Berdych,6-4; 7-6(2),R32,104,1,3,40,71,32,40,18,31,3,4,11,50,71,4,2,40,79,27,40,21,39,7,9,11,48,79
2015-04-12 00:00:00.000,Monte-Carlo Rolex Masters Monaco ATP World Tour Masters 1000,CLAY,2,Roberto Bautista Agut,Philipp Kohlschreiber,Roberto Bautista Agut,6-7(3); 6-3; 7-6(4),R32,161,3,3,68,107,52,68,16,39,5,9,16,68,107,3,3,94,136,55,94,21,42,8,14,17,76,136
2015-04-12 00:00:00.000,Monte-Carlo Rolex Masters Monaco ATP World Tour Masters 1000,CLAY,2,Tommy Robredo,Marcel Granollers,Tommy Robredo,6-1; 6-1,R32,76,1,0,38,56,24,38,10,18,5,6,7,34,56,1,1,39,53,20,39,2,14,3,9,7,22,53
2015-04-12 00:00:00.000,Monte-Carlo Rolex Masters Monaco ATP World Tour Masters 1000,CLAY,2,Milos Raonic,Joao Sousa,Milos Raonic,6-3; 7-6(4),R32,86,12,2,35,61,31,35,20,26,0,0,11,51,61,4,1,40,67,32,40,13,27,1,2,10,45,67
2015-04-12 00:00:00.000,Monte-Carlo Rolex Masters Monaco ATP World Tour Masters 1000,CLAY,2,Stan Wawrinka,Juan Monaco,Stan Wawrinka,6-1; 6-4,R32,72,2,2,21,48,19,21,14,27,2,4,9,33,48,1,2,42,64,19,42,11,22,9,14,8,30,64
2015-04-12 00:00:00.000,Monte-Carlo Rolex Masters Monaco ATP World Tour Masters 1000,CLAY,2,Grigor Dimitrov,Fabio Fognini,Grigor Dimitrov,6-3; 6-4,R32,71,4,0,41,55,34,41,8,14,1,1,10,42,55,3,1,35,57,24,35,11,22,3,5,9,35,57
2015-04-12 00:00:00.000,Monte-Carlo Rolex Masters Monaco ATP World Tour Masters 1000,CLAY,2,Gael Monfils,Alexandr Dolgopolov,Gael Monfils,7-6(5); 7-6(6),R32,112,8,1,60,90,40,60,14,30,3,6,12,54,90,2,4,60,89,44,60,9,29,9,12,12,53,89
2015-04-12 00:00:00.000,Monte-Carlo Rolex Masters Monaco ATP World Tour Masters 1000,CLAY,2,Roger Federer,Jeremy Chardy,Roger Federer,6-2; 6-1,R32,55,5,1,31,41,22,31,7,10,0,1,8,29,41,1,5,26,50,14,26,8,24,5,10,7,22,50
2015-04-12 00:00:00.000,Monte-Carlo Rolex Masters Monaco ATP World Tour Masters 1000,CLAY,2,Novak Djokovic,Andreas Haider-Maurer,Novak Djokovic,6-4; 6-0,R16,57,2,0,26,41,20,26,12,15,0,0,8,32,41,3,3,26,42,15,26,5,16,1,5,8,20,42
2015-04-12 00:00:00.000,Monte-Carlo Rolex Masters Monaco ATP World Tour Masters 1000,CLAY,2,Marin Cilic,Jo-Wilfried Tsonga,Marin Cilic,6-3; 7-6(5),R16,85,5,2,43,69,36,43,16,26,1,1,11,52,69,4,0,47,62,36,47,6,15,2,3,10,42,62
2015-04-12 00:00:00.000,Monte-Carlo Rolex Masters Monaco ATP World Tour Masters 1000,CLAY,2,Rafael Nadal,John Isner,Rafael Nadal,7-6(6); 4-6; 6-3,R16,140,7,0,66,90,51,66,18,24,2,3,16,69,90,12,1,62,102,47,62,19,40,4,5,15,66,102
2015-04-12 00:00:00.000,Monte-Carlo Rolex Masters Monaco ATP World Tour Masters 1000,CLAY,2,David Ferrer,Gilles Simon,David Ferrer,6-2; 6-7(3); 6-1,R16,153,3,4,60,89,45,60,15,29,4,5,13,60,89,3,3,71,111,43,71,17,40,14,20,14,60,111
2015-04-12 00:00:00.000,Monte-Carlo Rolex Masters Monaco ATP World Tour Masters 1000,CLAY,2,Tomas Berdych,Roberto Bautista Agut,Tomas Berdych,7-6(7); 6-4,R16,100,12,4,39,66,34,39,14,27,3,5,11,48,66,2,1,46,73,32,46,12,27,0,3,11,44,73
2015-04-12 00:00:00.000,Monte-Carlo Rolex Masters Monaco ATP World Tour Masters 1000,CLAY,2,Milos Raonic,Tommy Robredo,Milos Raonic,6-3; 3-6; 6-3,R16,102,4,1,54,78,43,54,12,24,1,2,14,55,78,1,2,66,80,45,66,8,14,8,10,13,53,80
2015-04-12 00:00:00.000,Monte-Carlo Rolex Masters Monaco ATP World Tour Masters 1000,CLAY,2,Grigor Dimitrov,Stan Wawrinka,Grigor Dimitrov,6-1; 6-2,R16,55,1,2,29,50,23,29,12,21,6,6,7,35,50,0,0,34,47,16,34,6,13,4,9,8,22,47
2015-04-12 00:00:00.000,Monte-Carlo Rolex Masters Monaco ATP World Tour Masters 1000,CLAY,2,Gael Monfils,Roger Federer,Gael Monfils,6-4; 7-6(5),R16,105,3,0,44,81,30,44,23,37,2,3,11,53,81,4,1,45,87,30,45,21,42,6,8,11,51,87
2015-04-12 00:00:00.000,Monte-Carlo Rolex Masters Monaco ATP World Tour Masters 1000,CLAY,2,Novak Djokovic,Marin Cilic,Novak Djokovic,6-0; 6-3,Q,66,1,0,27,44,23,27,8,17,2,2,7,31,44,3,1,32,56,18,32,8,24,5,10,8,26,56
2015-04-12 00:00:00.000,Monte-Carlo Rolex Masters Monaco ATP World Tour Masters 1000,CLAY,2,Rafael Nadal,David Ferrer,Rafael Nadal,6-4; 5-7; 6-2,Q,165,0,2,73,99,44,73,14,26,3,7,15,58,99,1,4,62,99,36,62,16,37,4,10,15,52,99
2015-04-12 00:00:00.000,Monte-Carlo Rolex Masters Monaco ATP World Tour Masters 1000,CLAY,2,Tomas Berdych,Milos Raonic,Tomas Berdych,5-2 RET,Q,32,1,0,8,15,7,8,5,7,0,0,3,12,15,0,0,18,28,9,18,5,10,2,4,4,14,28
2015-04-12 00:00:00.000,Monte-Carlo Rolex Masters Monaco ATP World Tour Masters 1000,CLAY,2,Gael Monfils,Grigor Dimitrov,Gael Monfils,6-1; 6-3,Q,59,0,0,36,53,26,36,10,17,2,2,8,36,53,1,1,21,37,13,21,5,16,0,4,8,18,37
2015-04-12 00:00:00.000,Monte-Carlo Rolex Masters Monaco ATP World Tour Masters 1000,CLAY,2,Novak Djokovic,Rafael Nadal,Novak Djokovic,6-3; 6-3,S,98,1,0,43,57,31,43,8,14,2,3,9,39,57,2,3,43,66,25,43,11,23,6,10,9,36,66
2015-04-12 00:00:00.000,Monte-Carlo Rolex Masters Monaco ATP World Tour Masters 1000,CLAY,2,Tomas Berdych,Gael Monfils,Tomas Berdych,6-1; 6-4,S,68,3,1,28,50,23,28,12,22,4,5,9,35,50,0,0,21,46,9,21,14,25,2,6,8,23,46
2015-04-12 00:00:00.000,Monte-Carlo Rolex Masters Monaco ATP World Tour Masters 1000,CLAY,2,Novak Djokovic,Tomas Berdych,Novak Djokovic,7-5; 4-6; 6-3,F,163,2,5,60,102,40,60,21,42,6,10,16,61,102,1,0,48,108,36,48,27,60,9,14,15,63,108
2015-04-20 00:00:00.000,Barcelona Open Banc Sabadell Spain ATP World Tour 500,CLAY,2,Kei Nishikori,N/A Bye,Kei Nishikori,,R64,0,0,0,0,0,0,0,0,0,0,0,0,0,0,0,0,0,0,0,0,0,0,0,0,0,0,0
2015-04-20 00:00:00.000,Barcelona Open Banc Sabadell Spain ATP World Tour 500,CLAY,2,Teymuraz Gabashvili,Pablo Carreno Busta,Teymuraz Gabashvili,7-5; 6-4,R64,97,4,3,40,69,30,40,17,29,1,2,11,47,69,3,5,41,75,30,41,15,34,6,9,11,45,75
2015-04-20 00:00:00.000,Barcelona Open Banc Sabadell Spain ATP World Tour 500,CLAY,2,Joao Sousa,Kenny De Schepper,Joao Sousa,6-4; 3-6; 6-3,R64,121,1,2,75,100,49,75,14,25,7,9,14,63,100,7,5,64,85,47,64,6,21,7,10,14,53,85
2015-04-20 00:00:00.000,Barcelona Open Banc Sabadell Spain ATP World Tour 500,CLAY,2,Santiago Giraldo,N/A Bye,Santiago Giraldo,,R64,0,0,0,0,0,0,0,0,0,0,0,0,0,0,0,0,0,0,0,0,0,0,0,0,0,0,0
2015-04-20 00:00:00.000,Barcelona Open Banc Sabadell Spain ATP World Tour 500,CLAY,2,Pablo Cuevas,N/A Bye,Pablo Cuevas,,R64,0,0,0,0,0,0,0,0,0,0,0,0,0,0,0,0,0,0,0,0,0,0,0,0,0,0,0
2015-04-20 00:00:00.000,Barcelona Open Banc Sabadell Spain ATP World Tour 500,CLAY,2,Roberto Carballes Baena,Jan-Lennard Struff,Roberto Carballes Baena,5-7; 7-5; 6-2,R64,141,5,3,72,110,52,72,18,38,7,9,16,70,110,7,4,50,85,36,50,15,35,1,5,16,51,85
2015-04-20 00:00:00.000,Barcelona Open Banc Sabadell Spain ATP World Tour 500,CLAY,2,Thomaz Bellucci,Yuichi Sugita,Thomaz Bellucci,6-1; 6-0,R64,50,4,2,21,39,16,21,9,18,1,2,7,25,39,0,2,21,36,6,21,3,15,3,9,6,9,36
2015-04-20 00:00:00.000,Barcelona Open Banc Sabadell Spain ATP World Tour 500,CLAY,2,Roberto Bautista Agut,N/A Bye,Roberto Bautista Agut,,R64,0,0,0,0,0,0,0,0,0,0,0,0,0,0,0,0,0,0,0,0,0,0,0,0,0,0,0
2015-04-20 00:00:00.000,Barcelona Open Banc Sabadell Spain ATP World Tour 500,CLAY,2,Marin Cilic,N/A Bye,Marin Cilic,,R64,0,0,0,0,0,0,0,0,0,0,0,0,0,0,0,0,0,0,0,0,0,0,0,0,0,0,0
2015-04-20 00:00:00.000,Barcelona Open Banc Sabadell Spain ATP World Tour 500,CLAY,2,Victor Estrella Burgos,Dominic Thiem,Victor Estrella Burgos,6-3; 7-6(3),R64,80,6,0,59,78,42,59,11,19,8,10,11,53,78,4,2,36,60,27,36,9,24,1,4,10,36,60
2015-04-20 00:00:00.000,Barcelona Open Banc Sabadell Spain ATP World Tour 500,CLAY,2,Juan Monaco,Alejandro Gonzalez,Juan Monaco,7-5; 6-1,R64,99,1,4,67,88,40,67,11,21,11,14,10,51,88,2,1,39,58,19,39,8,19,5,11,9,27,58
2015-04-20 00:00:00.000,Barcelona Open Banc Sabadell Spain ATP World Tour 500,CLAY,2,Martin Klizan,N/A Bye,Martin Klizan,,R64,0,0,0,0,0,0,0,0,0,0,0,0,0,0,0,0,0,0,0,0,0,0,0,0,0,0,0
2015-04-20 00:00:00.000,Barcelona Open Banc Sabadell Spain ATP World Tour 500,CLAY,2,Tommy Robredo,N/A Bye,Tommy Robredo,,R64,0,0,0,0,0,0,0,0,0,0,0,0,0,0,0,0,0,0,0,0,0,0,0,0,0,0,0
2015-04-20 00:00:00.000,Barcelona Open Banc Sabadell Spain ATP World Tour 500,CLAY,2,Mikhail Kukushkin,Joao Souza,Mikhail Kukushkin,6-1; 6-0,R64,54,0,0,34,39,26,34,3,5,0,0,7,29,39,0,2,22,37,9,22,5,15,3,8,6,14,37
2015-04-20 00:00:00.000,Barcelona Open Banc Sabadell Spain ATP World Tour 500,CLAY,2,Marcel Granollers,Marinko Matosevic,Marcel Granollers,6-2; 6-3,R64,89,0,1,30,49,19,30,11,19,5,7,8,30,49,1,1,37,61,18,37,7,24,5,11,9,25,61
2015-04-20 00:00:00.000,Barcelona Open Banc Sabadell Spain ATP World Tour 500,CLAY,2,Jo-Wilfried Tsonga,N/A Bye,Jo-Wilfried Tsonga,,R64,0,0,0,0,0,0,0,0,0,0,0,0,0,0,0,0,0,0,0,0,0,0,0,0,0,0,0
2015-04-20 00:00:00.000,Barcelona Open Banc Sabadell Spain ATP World Tour 500,CLAY,2,Ernests Gulbis,N/A Bye,Ernests Gulbis,,R64,0,0,0,0,0,0,0,0,0,0,0,0,0,0,0,0,0,0,0,0,0,0,0,0,0,0,0
2015-04-20 00:00:00.000,Barcelona Open Banc Sabadell Spain ATP World Tour 500,CLAY,2,Benoit Paire,Jaume Munar,Benoit Paire,6-2; 6-2,R64,62,6,1,29,51,20,29,11,22,0,2,8,31,51,1,0,42,64,20,42,6,22,9,15,8,26,64
2015-04-20 00:00:00.000,Barcelona Open Banc Sabadell Spain ATP World Tour 500,CLAY,2,Andrey Kuznetsov,Marton Fucsovics,Andrey Kuznetsov,6-4; 6-2,R64,61,1,0,32,48,26,32,9,16,1,2,9,35,48,2,2,31,50,20,31,8,19,1,5,9,28,50
2015-04-20 00:00:00.000,Barcelona Open Banc Sabadell Spain ATP World Tour 500,CLAY,2,Philipp Kohlschreiber,N/A Bye,Philipp Kohlschreiber,,R64,0,0,0,0,0,0,0,0,0,0,0,0,0,0,0,0,0,0,0,0,0,0,0,0,0,0,0
2015-04-20 00:00:00.000,Barcelona Open Banc Sabadell Spain ATP World Tour 500,CLAY,2,Nick Kyrgios,N/A Bye,Nick Kyrgios,,R64,0,0,0,0,0,0,0,0,0,0,0,0,0,0,0,0,0,0,0,0,0,0,0,0,0,0,0
2015-04-20 00:00:00.000,Barcelona Open Banc Sabadell Spain ATP World Tour 500,CLAY,2,Elias Ymer,Thiemo de Bakker,Elias Ymer,6-7(4); 7-5; 6-4,R64,146,3,1,62,95,46,62,19,33,1,4,17,65,95,5,3,66,118,46,66,22,52,11,16,17,68,118
2015-04-20 00:00:00.000,Barcelona Open Banc Sabadell Spain ATP World Tour 500,CLAY,2,Albert Montanes,Ricardas Berankis,Albert Montanes,1-6; 6-4; 7-5,R64,128,3,5,55,90,39,55,18,35,6,9,14,57,90,4,9,62,109,46,62,22,47,14,17,15,68,109
2015-04-20 00:00:00.000,Barcelona Open Banc Sabadell Spain ATP World Tour 500,CLAY,2,David Ferrer,N/A Bye,David Ferrer,,R64,0,0,0,0,0,0,0,0,0,0,0,0,0,0,0,0,0,0,0,0,0,0,0,0,0,0,0
2015-04-20 00:00:00.000,Barcelona Open Banc Sabadell Spain ATP World Tour 500,CLAY,2,Feliciano Lopez,N/A Bye,Feliciano Lopez,,R64,0,0,0,0,0,0,0,0,0,0,0,0,0,0,0,0,0,0,0,0,0,0,0,0,0,0,0
2015-04-20 00:00:00.000,Barcelona Open Banc Sabadell Spain ATP World Tour 500,CLAY,2,Marsel Ilhan,James Ward,Marsel Ilhan,7-6(2); 3-6; 6-1,R64,129,5,1,52,88,33,52,21,36,2,5,14,54,88,6,10,65,115,43,65,19,50,9,13,14,62,115
2015-04-20 00:00:00.000,Barcelona Open Banc Sabadell Spain ATP World Tour 500,CLAY,2,Pablo Andujar,Albert Ramos-Vinolas,Pablo Andujar,6-4; 6-1,R64,85,1,0,31,41,22,31,7,10,0,1,8,29,41,2,4,47,78,25,47,13,31,11,16,9,38,78
2015-04-20 00:00:00.000,Barcelona Open Banc Sabadell Spain ATP World Tour 500,CLAY,2,Leonardo Mayer,N/A Bye,Leonardo Mayer,,R64,0,0,0,0,0,0,0,0,0,0,0,0,0,0,0,0,0,0,0,0,0,0,0,0,0,0,0
2015-04-20 00:00:00.000,Barcelona Open Banc Sabadell Spain ATP World Tour 500,CLAY,2,Fabio Fognini,N/A Bye,Fabio Fognini,,R64,0,0,0,0,0,0,0,0,0,0,0,0,0,0,0,0,0,0,0,0,0,0,0,0,0,0,0
2015-04-20 00:00:00.000,Barcelona Open Banc Sabadell Spain ATP World Tour 500,CLAY,2,Andrey Rublev,Fernando Verdasco,Andrey Rublev,7-6(4); 6-3,R64,93,1,1,53,72,38,53,12,19,5,7,11,50,72,6,4,62,85,41,62,6,23,6,9,10,47,85
2015-04-20 00:00:00.000,Barcelona Open Banc Sabadell Spain ATP World Tour 500,CLAY,2,Nicolas Almagro,Paolo Lorenzi,Nicolas Almagro,3-0 RET,R64,10,2,0,3,8,3,3,5,5,0,0,2,8,8,0,0,6,8,1,6,1,2,2,3,1,2,8
2015-04-20 00:00:00.000,Barcelona Open Banc Sabadell Spain ATP World Tour 500,CLAY,2,Rafael Nadal,N/A Bye,Rafael Nadal,,R64,0,0,0,0,0,0,0,0,0,0,0,0,0,0,0,0,0,0,0,0,0,0,0,0,0,0,0
2015-04-20 00:00:00.000,Barcelona Open Banc Sabadell Spain ATP World Tour 500,CLAY,2,Kei Nishikori,Teymuraz Gabashvili,Kei Nishikori,6-3; 6-4,R32,68,2,0,29,49,23,29,18,20,1,1,10,41,49,1,4,26,49,20,26,12,23,1,3,9,32,49
2015-04-20 00:00:00.000,Barcelona Open Banc Sabadell Spain ATP World Tour 500,CLAY,2,Santiago Giraldo,Joao Sousa,Santiago Giraldo,6-3; 3-6; 6-1,R32,99,5,0,60,80,41,60,12,20,1,2,13,53,80,4,0,43,69,30,43,13,26,2,5,12,43,69
2015-04-20 00:00:00.000,Barcelona Open Banc Sabadell Spain ATP World Tour 500,CLAY,2,Pablo Cuevas,Roberto Carballes Baena,Pablo Cuevas,6-4; 7-5,R32,100,1,3,38,70,27,38,18,32,5,7,11,45,70,1,4,36,61,22,36,13,25,4,8,11,35,61
2015-04-20 00:00:00.000,Barcelona Open Banc Sabadell Spain ATP World Tour 500,CLAY,2,Roberto Bautista Agut,Thomaz Bellucci,Roberto Bautista Agut,6-3; 6-4,R32,78,1,1,43,59,36,43,7,16,1,1,10,43,59,0,1,32,52,24,32,10,20,1,3,9,34,52
2015-04-20 00:00:00.000,Barcelona Open Banc Sabadell Spain ATP World Tour 500,CLAY,2,Victor Estrella Burgos,Marin Cilic,Victor Estrella Burgos,6-4; 6-4,R32,80,0,0,32,53,22,32,15,21,2,4,10,37,53,4,1,35,61,23,35,11,26,5,9,10,34,61
2015-04-20 00:00:00.000,Barcelona Open Banc Sabadell Spain ATP World Tour 500,CLAY,2,Martin Klizan,Juan Monaco,Martin Klizan,5-7; 6-0; 6-3,R32,107,4,2,50,76,36,50,15,26,3,5,13,51,76,3,3,61,86,33,61,11,25,5,11,14,44,86
2015-04-20 00:00:00.000,Barcelona Open Banc Sabadell Spain ATP World Tour 500,CLAY,2,Tommy Robredo,Mikhail Kukushkin,Tommy Robredo,6-3; 6-2,R32,59,7,1,35,53,28,35,12,18,1,1,9,40,53,0,0,29,40,19,29,7,11,1,4,8,26,40
2015-04-20 00:00:00.000,Barcelona Open Banc Sabadell Spain ATP World Tour 500,CLAY,2,Marcel Granollers,Jo-Wilfried Tsonga,Marcel Granollers,6-4; 6-2,R32,84,1,2,44,64,30,44,10,20,2,3,9,40,64,0,1,31,57,15,31,15,26,5,9,9,30,57
2015-04-20 00:00:00.000,Barcelona Open Banc Sabadell Spain ATP World Tour 500,CLAY,2,Benoit Paire,Ernests Gulbis,Benoit Paire,1-6; 6-2; 6-3,R32,92,3,3,39,70,27,39,17,31,3,6,12,44,70,8,9,39,70,28,39,11,31,1,5,12,39,70
2015-04-20 00:00:00.000,Barcelona Open Banc Sabadell Spain ATP World Tour 500,CLAY,2,Philipp Kohlschreiber,Andrey Kuznetsov,Philipp Kohlschreiber,7-6(1); 6-3,R32,83,2,2,42,67,28,42,16,25,4,6,10,44,67,4,5,40,71,25,40,13,31,5,9,11,38,71
2015-04-20 00:00:00.000,Barcelona Open Banc Sabadell Spain ATP World Tour 500,CLAY,2,Elias Ymer,Nick Kyrgios,Elias Ymer,2-6; 7-5; 7-6(7),R32,147,8,4,61,119,43,61,28,58,10,13,16,71,119,6,2,71,107,52,71,16,36,5,7,16,68,107
2015-04-20 00:00:00.000,Barcelona Open Banc Sabadell Spain ATP World Tour 500,CLAY,2,David Ferrer,Albert Montanes,David Ferrer,6-2; 6-3,R32,85,2,4,34,64,22,34,19,30,3,4,9,41,64,1,3,34,55,20,34,8,21,4,8,8,28,55
2015-04-20 00:00:00.000,Barcelona Open Banc Sabadell Spain ATP World Tour 500,CLAY,2,Feliciano Lopez,Marsel Ilhan,Feliciano Lopez,6-2; 5-7; 7-6(5),R32,111,10,3,60,89,45,60,16,29,1,4,16,61,89,14,2,55,91,40,55,18,36,3,7,16,58,91
2015-04-20 00:00:00.000,Barcelona Open Banc Sabadell Spain ATP World Tour 500,CLAY,2,Pablo Andujar,Leonardo Mayer,Pablo Andujar,2-6; 6-1; 6-2,R32,113,2,1,68,81,42,68,8,13,7,9,12,50,81,2,5,44,72,27,44,10,28,3,7,11,37,72
2015-04-20 00:00:00.000,Barcelona Open Banc Sabadell Spain ATP World Tour 500,CLAY,2,Fabio Fognini,Andrey Rublev,Fabio Fognini,3-6; 6-4; 6-1,R32,104,7,3,50,85,35,50,15,35,6,10,13,50,85,1,2,40,81,26,40,16,41,4,10,13,42,81
2015-04-20 00:00:00.000,Barcelona Open Banc Sabadell Spain ATP World Tour 500,CLAY,2,Rafael Nadal,Nicolas Almagro,Rafael Nadal,6-3; 6-1,R32,99,3,0,40,65,25,40,15,25,8,9,8,40,65,2,1,35,58,18,35,8,23,5,10,8,26,58
2015-04-20 00:00:00.000,Barcelona Open Banc Sabadell Spain ATP World Tour 500,CLAY,2,Kei Nishikori,Santiago Giraldo,Kei Nishikori,6-2; 6-1,R16,83,4,3,37,64,25,37,14,27,6,7,8,39,64,3,1,36,51,20,36,3,15,4,9,7,23,51
2015-04-20 00:00:00.000,Barcelona Open Banc Sabadell Spain ATP World Tour 500,CLAY,2,Roberto Bautista Agut,Pablo Cuevas,Roberto Bautista Agut,7-6(5); 6-2,R16,97,5,2,46,73,35,46,13,27,4,5,10,48,73,5,1,36,63,26,36,11,27,0,3,10,37,63
2015-04-20 00:00:00.000,Barcelona Open Banc Sabadell Spain ATP World Tour 500,CLAY,2,Martin Klizan,Victor Estrella Burgos,Martin Klizan,6-4; 6-3,R16,79,4,1,41,55,28,41,8,14,2,4,10,36,55,3,1,39,58,21,39,8,19,3,7,9,29,58
2015-04-20 00:00:00.000,Barcelona Open Banc Sabadell Spain ATP World Tour 500,CLAY,2,Tommy Robredo,Marcel Granollers,Tommy Robredo,6-2; 6-2,R16,69,4,3,36,54,25,36,9,18,2,3,8,34,54,0,1,23,44,11,23,12,21,1,6,8,23,44
2015-04-20 00:00:00.000,Barcelona Open Banc Sabadell Spain ATP World Tour 500,CLAY,2,Philipp Kohlschreiber,Benoit Paire,Philipp Kohlschreiber,6-4; 7-6(6),R16,84,2,0,48,68,32,48,9,20,2,5,11,41,68,6,2,43,77,27,43,17,34,5,9,11,44,77
2015-04-20 00:00:00.000,Barcelona Open Banc Sabadell Spain ATP World Tour 500,CLAY,2,David Ferrer,Elias Ymer,David Ferrer,6-3; 6-4,R16,87,1,5,46,67,30,46,8,21,3,6,10,38,67,1,1,28,53,17,28,7,25,1,6,9,24,53
2015-04-20 00:00:00.000,Barcelona Open Banc Sabadell Spain ATP World Tour 500,CLAY,2,Pablo Andujar,Feliciano Lopez,Pablo Andujar,6-3; 6-4,R16,72,0,0,50,59,32,50,6,9,4,6,10,38,59,5,1,25,48,18,25,6,23,2,6,9,24,48
2015-04-20 00:00:00.000,Barcelona Open Banc Sabadell Spain ATP World Tour 500,CLAY,2,Fabio Fognini,Rafael Nadal,Fabio Fognini,6-4; 7-6(6),R16,121,1,1,47,87,33,47,20,40,11,14,11,53,87,1,0,50,71,29,50,11,21,4,8,11,40,71
2015-04-20 00:00:00.000,Barcelona Open Banc Sabadell Spain ATP World Tour 500,CLAY,2,Kei Nishikori,Roberto Bautista Agut,Kei Nishikori,6-2; 3-6; 6-1,Q,101,5,0,35,61,28,35,18,26,1,2,12,46,61,2,4,49,80,30,49,12,31,7,11,12,42,80
2015-04-20 00:00:00.000,Barcelona Open Banc Sabadell Spain ATP World Tour 500,CLAY,2,Martin Klizan,Tommy Robredo,Martin Klizan,7-6(5); 6-4,Q,97,3,5,47,77,42,47,13,30,6,6,11,55,77,8,1,48,67,37,48,11,19,2,3,11,48,67
2015-04-20 00:00:00.000,Barcelona Open Banc Sabadell Spain ATP World Tour 500,CLAY,2,David Ferrer,Philipp Kohlschreiber,David Ferrer,6-3; 7-6(5),Q,105,0,0,58,84,31,58,18,26,5,9,11,49,84,0,0,33,62,15,33,15,29,5,10,10,30,62
2015-04-20 00:00:00.000,Barcelona Open Banc Sabadell Spain ATP World Tour 500,CLAY,2,Pablo Andujar,Fabio Fognini,Pablo Andujar,6-1; 6-3,Q,66,1,0,30,48,22,30,10,18,2,3,8,32,48,1,2,29,54,14,29,11,25,2,7,8,25,54
2015-04-20 00:00:00.000,Barcelona Open Banc Sabadell Spain ATP World Tour 500,CLAY,2,Kei Nishikori,Martin Klizan,Kei Nishikori,6-1; 6-2,S,78,2,3,28,52,22,28,14,24,6,6,8,36,52,3,4,32,57,17,32,10,25,6,10,7,27,57
2015-04-20 00:00:00.000,Barcelona Open Banc Sabadell Spain ATP World Tour 500,CLAY,2,Pablo Andujar,David Ferrer,Pablo Andujar,7-6(6); 6-3,S,106,0,2,51,79,33,51,17,28,2,4,11,50,79,2,3,45,67,29,45,11,22,4,7,10,40,67
2015-04-20 00:00:00.000,Barcelona Open Banc Sabadell Spain ATP World Tour 500,CLAY,2,Kei Nishikori,Pablo Andujar,Kei Nishikori,6-4; 6-4,F,95,1,3,37,67,26,37,15,30,2,4,10,41,67,1,1,44,66,28,44,7,22,2,6,10,35,66
2015-04-20 00:00:00.000,BRD Nastase Tiriac Trophy Romania ATP World Tour 250,CLAY,2,Gilles Simon,N/A Bye,Gilles Simon,,R32,0,0,0,0,0,0,0,0,0,0,0,0,0,0,0,0,0,0,0,0,0,0,0,0,0,0,0
2015-04-20 00:00:00.000,BRD Nastase Tiriac Trophy Romania ATP World Tour 250,CLAY,2,Janko Tipsarevic,Thomas Fabbiano,Janko Tipsarevic,6-4; 6-3,R32,87,6,0,27,58,21,27,17,31,5,6,9,38,58,3,4,49,67,30,49,7,18,3,7,10,37,67
2015-04-20 00:00:00.000,BRD Nastase Tiriac Trophy Romania ATP World Tour 250,CLAY,2,Nikola Mektic,Denis Istomin,Nikola Mektic,6-3; 6-4,R32,83,3,1,43,64,29,43,12,21,6,7,10,41,64,6,0,34,59,25,34,10,25,7,10,9,35,59
2015-04-20 00:00:00.000,BRD Nastase Tiriac Trophy Romania ATP World Tour 250,CLAY,2,Daniel Gimeno-Traver,Viktor Troicki,Daniel Gimeno-Traver,5-7; 6-3; 6-1,R32,120,2,1,56,87,38,56,15,31,5,9,14,53,87,1,2,52,81,27,52,13,29,3,10,14,40,81
2015-04-20 00:00:00.000,BRD Nastase Tiriac Trophy Romania ATP World Tour 250,CLAY,2,Ivo Karlovic,N/A Bye,Ivo Karlovic,,R32,0,0,0,0,0,0,0,0,0,0,0,0,0,0,0,0,0,0,0,0,0,0,0,0,0,0,0
2015-04-20 00:00:00.000,BRD Nastase Tiriac Trophy Romania ATP World Tour 250,CLAY,2,Borna Coric,Sergiy Stakhovsky,Borna Coric,6-2; 6-7(4); 7-6(2),R32,160,2,2,80,118,53,80,22,38,8,11,16,75,118,5,0,83,124,53,83,19,41,12,17,16,72,124
2015-04-20 00:00:00.000,BRD Nastase Tiriac Trophy Romania ATP World Tour 250,CLAY,2,Malek Jaziri,Florian Mayer,Malek Jaziri,4-6; 6-4; 7-5,R32,125,4,2,54,95,41,54,25,41,6,9,16,66,95,3,0,79,117,52,79,18,38,13,17,16,70,117
2015-04-20 00:00:00.000,BRD Nastase Tiriac Trophy Romania ATP World Tour 250,CLAY,2,Jiri Vesely,Diego Schwartzman,Jiri Vesely,6-3; 7-6(9),R32,115,8,0,53,73,37,53,10,20,0,2,11,47,73,1,5,51,83,32,51,14,32,2,5,10,46,83
2015-04-20 00:00:00.000,BRD Nastase Tiriac Trophy Romania ATP World Tour 250,CLAY,2,Guillermo Garcia-Lopez,Lorenzo Giustino,Guillermo Garcia-Lopez,6-2; 6-0,R32,56,2,0,21,33,16,21,12,12,0,0,7,28,33,1,0,22,39,10,22,6,17,2,7,7,16,39
2015-04-20 00:00:00.000,BRD Nastase Tiriac Trophy Romania ATP World Tour 250,CLAY,2,Marcos Baghdatis,Steve Darcis,Marcos Baghdatis,6-4; 6-2,R32,85,1,1,38,65,28,38,16,27,7,7,9,44,65,0,1,48,67,28,48,8,19,6,9,9,36,67
2015-04-20 00:00:00.000,BRD Nastase Tiriac Trophy Romania ATP World Tour 250,CLAY,2,Dusan Lajovic,Jurgen Zopp,Dusan Lajovic,7-5; 6-1,R32,70,2,0,29,52,20,29,21,23,2,2,10,41,52,3,0,37,54,24,37,9,17,7,10,9,33,54
2015-04-20 00:00:00.000,BRD Nastase Tiriac Trophy Romania ATP World Tour 250,CLAY,2,Lukas Rosol,N/A Bye,Lukas Rosol,,R32,0,0,0,0,0,0,0,0,0,0,0,0,0,0,0,0,0,0,0,0,0,0,0,0,0,0,0
2015-04-20 00:00:00.000,BRD Nastase Tiriac Trophy Romania ATP World Tour 250,CLAY,2,Simone Bolelli,Andrey Golubev,Simone Bolelli,7-6(3); 6-4,R32,92,0,0,47,66,37,47,10,19,5,7,11,47,66,3,2,30,66,23,30,18,36,0,3,11,41,66
2015-04-20 00:00:00.000,BRD Nastase Tiriac Trophy Romania ATP World Tour 250,CLAY,2,Andreas Haider-Maurer,Ivan Dodig,Andreas Haider-Maurer,7-5; 0-6; 6-4,R32,146,6,5,65,102,37,65,22,37,7,11,14,59,102,11,2,54,85,38,54,18,31,6,9,14,56,85
2015-04-20 00:00:00.000,BRD Nastase Tiriac Trophy Romania ATP World Tour 250,CLAY,2,Mikhail Youzhny,Marius Copil,Mikhail Youzhny,1-6; 6-4; 6-3,R32,94,3,1,53,76,34,53,14,23,4,7,13,48,76,8,2,40,67,31,40,15,27,2,5,13,46,67
2015-04-20 00:00:00.000,BRD Nastase Tiriac Trophy Romania ATP World Tour 250,CLAY,2,Gael Monfils,N/A Bye,Gael Monfils,,R32,0,0,0,0,0,0,0,0,0,0,0,0,0,0,0,0,0,0,0,0,0,0,0,0,0,0,0
2015-04-20 00:00:00.000,BRD Nastase Tiriac Trophy Romania ATP World Tour 250,CLAY,2,Gilles Simon,Janko Tipsarevic,Gilles Simon,7-5; 6-4,R16,118,3,1,50,77,33,50,18,27,4,5,11,51,77,0,0,42,73,27,42,17,31,2,5,11,44,73
2015-04-20 00:00:00.000,BRD Nastase Tiriac Trophy Romania ATP World Tour 250,CLAY,2,Daniel Gimeno-Traver,Nikola Mektic,Daniel Gimeno-Traver,7-5; 6-2,R16,84,3,3,43,74,27,43,14,31,5,8,10,41,74,0,0,32,53,14,32,10,21,3,9,10,24,53
2015-04-20 00:00:00.000,BRD Nastase Tiriac Trophy Romania ATP World Tour 250,CLAY,2,Ivo Karlovic,Borna Coric,Ivo Karlovic,3-6; 6-3; 6-4,R16,97,12,2,53,68,47,53,6,15,0,1,14,53,68,2,0,57,81,43,57,13,24,4,6,14,56,81
2015-04-20 00:00:00.000,BRD Nastase Tiriac Trophy Romania ATP World Tour 250,CLAY,2,Jiri Vesely,Malek Jaziri,Jiri Vesely,6-3; 6-1,R16,70,6,1,33,46,25,33,9,13,1,1,8,34,46,2,4,20,46,14,20,10,26,3,7,8,24,46
2015-04-20 00:00:00.000,BRD Nastase Tiriac Trophy Romania ATP World Tour 250,CLAY,2,Guillermo Garcia-Lopez,Marcos Baghdatis,Guillermo Garcia-Lopez,7-5; 6-2,R16,87,1,2,45,65,30,45,12,20,6,8,10,42,65,1,1,34,63,21,34,13,29,9,14,10,34,63
2015-04-20 00:00:00.000,BRD Nastase Tiriac Trophy Romania ATP World Tour 250,CLAY,2,Lukas Rosol,Dusan Lajovic,Lukas Rosol,4-6; 6-4; 6-3,R16,158,1,1,61,106,39,61,23,45,14,18,15,62,106,4,1,60,91,36,60,14,31,5,10,14,50,91
2015-04-20 00:00:00.000,BRD Nastase Tiriac Trophy Romania ATP World Tour 250,CLAY,2,Simone Bolelli,Andreas Haider-Maurer,Simone Bolelli,6-4; 6-4,R16,87,4,0,37,53,26,37,14,16,0,0,10,40,53,9,3,41,68,30,41,12,27,6,8,10,42,68
2015-04-20 00:00:00.000,BRD Nastase Tiriac Trophy Romania ATP World Tour 250,CLAY,2,Gael Monfils,Mikhail Youzhny,Gael Monfils,6-1; 6-2,R16,55,3,0,35,41,30,35,3,6,2,2,8,33,41,1,1,31,41,15,31,4,10,2,6,7,19,41
2015-04-20 00:00:00.000,BRD Nastase Tiriac Trophy Romania ATP World Tour 250,CLAY,2,Daniel Gimeno-Traver,Gilles Simon,Daniel Gimeno-Traver,6-7(5); 6-4; 6-2,Q,140,5,1,60,98,44,60,18,38,4,7,15,62,98,3,2,64,101,40,64,15,37,4,10,15,55,101
2015-04-20 00:00:00.000,BRD Nastase Tiriac Trophy Romania ATP World Tour 250,CLAY,2,Jiri Vesely,Ivo Karlovic,Jiri Vesely,6-4; 6-4,Q,79,2,2,38,56,32,38,10,18,3,3,10,42,56,11,2,34,54,28,34,9,20,1,3,10,37,54
2015-04-20 00:00:00.000,BRD Nastase Tiriac Trophy Romania ATP World Tour 250,CLAY,2,Guillermo Garcia-Lopez,Lukas Rosol,Guillermo Garcia-Lopez,6-4; 7-6(7),Q,113,3,3,48,86,32,48,21,38,3,4,11,53,86,0,4,52,81,34,52,14,29,3,5,11,48,81
2015-04-20 00:00:00.000,BRD Nastase Tiriac Trophy Romania ATP World Tour 250,CLAY,2,Gael Monfils,Simone Bolelli,Gael Monfils,6-3; 7-6(4),Q,93,6,2,49,79,34,49,21,30,7,7,11,55,79,0,0,49,63,30,49,10,14,1,2,10,40,63
2015-04-20 00:00:00.000,BRD Nastase Tiriac Trophy Romania ATP World Tour 250,CLAY,2,Jiri Vesely,Daniel Gimeno-Traver,Jiri Vesely,2-6; 6-1; 6-4,S,104,6,0,42,64,34,42,11,22,0,3,13,45,64,2,5,50,82,34,50,12,32,5,9,12,46,82
2015-04-20 00:00:00.000,BRD Nastase Tiriac Trophy Romania ATP World Tour 250,CLAY,2,Guillermo Garcia-Lopez,Gael Monfils,Guillermo Garcia-Lopez,6-7(2); 6-4; 6-2,S,130,4,2,55,87,44,55,19,32,1,2,15,63,87,6,2,77,111,52,77,15,34,10,14,15,67,111
2015-04-20 00:00:00.000,BRD Nastase Tiriac Trophy Romania ATP World Tour 250,CLAY,2,Guillermo Garcia-Lopez,Jiri Vesely,Guillermo Garcia-Lopez,7-6(5); 7-6(11),F,135,6,1,49,84,38,49,18,35,2,5,12,56,84,5,1,60,81,42,60,10,21,1,4,12,52,81
2015-04-27 00:00:00.000,Millennium Estoril Open Portugal ATP World Tour 250,CLAY,2,Feliciano Lopez,N/A Bye,Feliciano Lopez,,R32,0,0,0,0,0,0,0,0,0,0,0,0,0,0,0,0,0,0,0,0,0,0,0,0,0,0,0
2015-04-27 00:00:00.000,Millennium Estoril Open Portugal ATP World Tour 250,CLAY,2,Robin Haase,Ricardas Berankis,Robin Haase,6-3; 6-7(6); 6-4,R32,143,4,1,53,102,40,53,26,49,4,6,15,66,102,3,7,54,115,35,54,34,61,12,17,16,69,115
2015-04-27 00:00:00.000,Millennium Estoril Open Portugal ATP World Tour 250,CLAY,2,Filip Krajinovic,Alejandro Gonzalez,Filip Krajinovic,6-3; 6-3,R32,67,4,1,35,52,26,35,10,17,2,3,9,36,52,3,1,31,54,17,31,11,23,3,7,9,28,54
2015-04-27 00:00:00.000,Millennium Estoril Open Portugal ATP World Tour 250,CLAY,2,Nick Kyrgios,Albert Ramos-Vinolas,Nick Kyrgios,6-3; 6-7(5); 7-6(3),R32,134,15,0,73,102,55,73,20,29,0,1,17,75,102,7,3,66,108,45,66,27,42,9,11,16,72,108
2015-04-27 00:00:00.000,Millennium Estoril Open Portugal ATP World Tour 250,CLAY,2,David Vega Hernandez,N/A Bye,David Vega Hernandez,,R32,0,0,0,0,0,0,0,0,0,0,0,0,0,0,0,0,0,0,0,0,0,0,0,0,0,0,0
2015-04-27 00:00:00.000,Millennium Estoril Open Portugal ATP World Tour 250,CLAY,2,Pablo Carreno Busta,Constant Lestienne,Pablo Carreno Busta,6-3; 6-1,R32,65,1,2,21,47,14,21,14,26,3,5,8,28,47,1,4,34,57,16,34,8,23,4,10,8,24,57
2015-04-27 00:00:00.000,Millennium Estoril Open Portugal ATP World Tour 250,CLAY,2,Albert Montanes,Martin Fischer,Albert Montanes,6-4; 4-6; 6-3,R32,118,3,3,50,82,34,50,18,32,3,6,14,52,82,2,4,57,107,36,57,26,50,15,20,15,62,107
2015-04-27 00:00:00.000,Millennium Estoril Open Portugal ATP World Tour 250,CLAY,2,Gilles Muller,Frederico Ferreira Silva,Gilles Muller,6-3; 3-6; 6-1,R32,104,6,5,38,76,31,38,23,38,3,4,13,54,76,2,4,39,79,28,39,19,40,3,6,12,47,79
2015-04-27 00:00:00.000,Millennium Estoril Open Portugal ATP World Tour 250,CLAY,2,Richard Gasquet,Marinko Matosevic,Richard Gasquet,7-6(7); 6-1,R32,87,9,1,55,77,42,55,10,22,1,2,10,52,77,4,2,34,53,23,34,8,19,0,3,9,31,53
2015-04-27 00:00:00.000,Millennium Estoril Open Portugal ATP World Tour 250,CLAY,2,Kenny De Schepper,Gastao Elias,Kenny De Schepper,6-2; 2-6; 6-3,R32,95,3,2,58,79,38,58,12,21,3,5,13,50,79,0,1,30,62,21,30,19,32,1,4,12,40,62
2015-04-27 00:00:00.000,Millennium Estoril Open Portugal ATP World Tour 250,CLAY,2,Nicolas Almagro,Stephane Robert,Nicolas Almagro,6-3; 7-6(4),R32,76,8,6,34,75,25,34,25,41,2,3,11,50,75,3,2,26,64,18,26,21,38,4,6,10,39,64
2015-04-27 00:00:00.000,Millennium Estoril Open Portugal ATP World Tour 250,CLAY,2,Leonardo Mayer,N/A Bye,Leonardo Mayer,,R32,0,0,0,0,0,0,0,0,0,0,0,0,0,0,0,0,0,0,0,0,0,0,0,0,0,0,0
2015-04-27 00:00:00.000,Millennium Estoril Open Portugal ATP World Tour 250,CLAY,2,Borna Coric,Jeremy Chardy,Borna Coric,6-2; 6-4,R32,84,2,4,32,59,23,32,15,27,2,3,9,38,59,1,1,39,60,21,39,10,21,3,7,9,31,60
2015-04-27 00:00:00.000,Millennium Estoril Open Portugal ATP World Tour 250,CLAY,2,Rui Machado,Joao Sousa,Rui Machado,7-6(5); 6-3,R32,92,0,4,53,71,39,53,6,18,3,5,11,45,71,0,2,37,67,25,37,13,30,3,6,10,38,67
2015-04-27 00:00:00.000,Millennium Estoril Open Portugal ATP World Tour 250,CLAY,2,Guillermo Garcia-Lopez,Roberto Carballes Baena,Guillermo Garcia-Lopez,6-2; 6-2,R32,72,0,1,26,43,22,26,8,17,0,1,8,30,43,2,1,39,64,21,39,9,25,7,12,8,30,64
2015-04-27 00:00:00.000,Millennium Estoril Open Portugal ATP World Tour 250,CLAY,2,Kevin Anderson,N/A Bye,Kevin Anderson,,R32,0,0,0,0,0,0,0,0,0,0,0,0,0,0,0,0,0,0,0,0,0,0,0,0,0,0,0
2015-04-27 00:00:00.000,Millennium Estoril Open Portugal ATP World Tour 250,CLAY,2,Robin Haase,Feliciano Lopez,Robin Haase,4-6; 7-6(2); 6-4,R16,123,3,3,58,93,41,58,20,35,2,6,16,61,93,10,1,56,102,41,56,24,46,6,10,16,65,102
2015-04-27 00:00:00.000,Millennium Estoril Open Portugal ATP World Tour 250,CLAY,2,Nick Kyrgios,Filip Krajinovic,Nick Kyrgios,6-3; 6-3,R16,70,6,4,42,63,26,42,14,21,5,6,9,40,63,2,2,34,56,18,34,13,22,4,8,9,31,56
2015-04-27 00:00:00.000,Millennium Estoril Open Portugal ATP World Tour 250,CLAY,2,Pablo Carreno Busta,David Vega Hernandez,Pablo Carreno Busta,6-1; 6-2,R16,62,0,2,26,44,20,26,12,18,0,0,8,32,44,1,1,33,50,17,33,7,17,3,7,7,24,50
2015-04-27 00:00:00.000,Millennium Estoril Open Portugal ATP World Tour 250,CLAY,2,Gilles Muller,Albert Montanes,Gilles Muller,4-6; 6-3; 7-6(7),R16,121,18,2,62,103,50,62,23,41,4,6,16,73,103,8,5,61,95,46,61,17,34,4,6,15,63,95
2015-04-27 00:00:00.000,Millennium Estoril Open Portugal ATP World Tour 250,CLAY,2,Richard Gasquet,Kenny De Schepper,Richard Gasquet,6-2; 6-3,R16,64,0,0,31,52,27,31,11,21,2,2,9,38,52,1,2,33,47,22,33,4,14,2,5,8,26,47
2015-04-27 00:00:00.000,Millennium Estoril Open Portugal ATP World Tour 250,CLAY,2,Nicolas Almagro,Leonardo Mayer,Nicolas Almagro,7-6(4); 6-2,R16,90,7,1,43,64,37,43,9,21,1,2,10,46,64,3,1,54,72,34,54,7,18,5,8,10,41,72
2015-04-27 00:00:00.000,Millennium Estoril Open Portugal ATP World Tour 250,CLAY,2,Borna Coric,Rui Machado,Borna Coric,6-4; 5-7; 6-1,R16,147,4,0,45,79,34,45,22,34,3,5,15,56,79,0,3,77,105,44,77,15,28,10,14,14,59,105
2015-04-27 00:00:00.000,Millennium Estoril Open Portugal ATP World Tour 250,CLAY,2,Guillermo Garcia-Lopez,Kevin Anderson,Guillermo Garcia-Lopez,6-4; 3-6; 6-1,R16,123,1,2,45,75,34,45,20,30,2,3,13,54,75,4,9,56,96,39,56,17,40,5,8,13,56,96
2015-04-27 00:00:00.000,Millennium Estoril Open Portugal ATP World Tour 250,CLAY,2,Nick Kyrgios,Robin Haase,Nick Kyrgios,6-3; 6-4,Q,57,7,3,37,56,29,37,10,19,1,2,10,39,56,1,2,32,45,21,32,6,13,4,7,9,27,45
2015-04-27 00:00:00.000,Millennium Estoril Open Portugal ATP World Tour 250,CLAY,2,Pablo Carreno Busta,Gilles Muller,Pablo Carreno Busta,6-2; 6-4,Q,77,4,2,40,64,26,40,13,24,4,7,9,39,64,3,3,31,54,16,31,6,23,3,9,9,22,54
2015-04-27 00:00:00.000,Millennium Estoril Open Portugal ATP World Tour 250,CLAY,2,Richard Gasquet,Nicolas Almagro,Richard Gasquet,6-1; 7-6(4),Q,85,4,3,39,68,31,39,16,29,4,5,10,47,68,2,2,27,58,18,27,16,31,2,5,9,34,58
2015-04-27 00:00:00.000,Millennium Estoril Open Portugal ATP World Tour 250,CLAY,2,Guillermo Garcia-Lopez,Borna Coric,Guillermo Garcia-Lopez,6-3; 7-6(4),Q,119,6,3,45,75,30,45,15,30,3,6,11,45,75,0,1,45,73,23,45,13,28,3,7,10,36,73
2015-04-27 00:00:00.000,Millennium Estoril Open Portugal ATP World Tour 250,CLAY,2,Nick Kyrgios,Pablo Carreno Busta,Nick Kyrgios,5-7; 7-6(2); 6-3,S,120,15,4,66,96,57,66,13,30,1,2,16,70,96,4,2,56,106,41,56,31,50,5,7,17,72,106
2015-04-27 00:00:00.000,Millennium Estoril Open Portugal ATP World Tour 250,CLAY,2,Richard Gasquet,Guillermo Garcia-Lopez,Richard Gasquet,3-6; 6-2; 7-6(1),S,136,0,2,60,89,43,60,14,29,2,5,15,57,89,3,1,66,92,48,66,9,26,3,6,14,57,92
2015-04-27 00:00:00.000,Millennium Estoril Open Portugal ATP World Tour 250,CLAY,2,Richard Gasquet,Nick Kyrgios,Richard Gasquet,6-3; 6-2,F,65,4,2,32,49,30,32,9,17,3,3,9,39,49,2,3,35,50,22,35,8,15,3,6,8,30,50
2015-04-27 00:00:00.000,TEB BNP Paribas Istanbul Open Turkey ATP World Tour 250,CLAY,2,Roger Federer,N/A Bye,Roger Federer,,R32,0,0,0,0,0,0,0,0,0,0,0,0,0,0,0,0,0,0,0,0,0,0,0,0,0,0,0
2015-04-27 00:00:00.000,TEB BNP Paribas Istanbul Open Turkey ATP World Tour 250,CLAY,2,Jarkko Nieminen,Marsel Ilhan,Jarkko Nieminen,6-3; 6-4,R32,77,1,2,60,76,40,60,11,16,8,8,10,51,76,6,1,39,59,27,39,9,20,5,7,9,36,59
2015-04-27 00:00:00.000,TEB BNP Paribas Istanbul Open Turkey ATP World Tour 250,CLAY,2,Daniel Gimeno-Traver,Cem Ilkel,Daniel Gimeno-Traver,6-1; 6-4,R32,74,5,2,29,44,24,29,7,15,1,2,8,31,44,3,3,36,67,18,36,14,31,4,9,9,32,67
2015-04-27 00:00:00.000,TEB BNP Paribas Istanbul Open Turkey ATP World Tour 250,CLAY,2,Mikhail Kukushkin,Aleksandr Nedovyesov,Mikhail Kukushkin,6-3; 6-4,R32,92,0,0,35,68,24,35,20,33,7,8,10,44,68,2,0,35,57,22,35,12,22,4,7,9,34,57
2015-04-27 00:00:00.000,TEB BNP Paribas Istanbul Open Turkey ATP World Tour 250,CLAY,2,Santiago Giraldo,N/A Bye,Santiago Giraldo,,R32,0,0,0,0,0,0,0,0,0,0,0,0,0,0,0,0,0,0,0,0,0,0,0,0,0,0,0
2015-04-27 00:00:00.000,TEB BNP Paribas Istanbul Open Turkey ATP World Tour 250,CLAY,2,Andrey Rublev,Damir Dzumhur,Andrey Rublev,6-3; 6-3,R32,72,2,1,43,57,29,43,8,14,2,3,9,37,57,1,1,48,68,29,48,8,20,5,9,9,37,68
2015-04-27 00:00:00.000,TEB BNP Paribas Istanbul Open Turkey ATP World Tour 250,CLAY,2,Jurgen Melzer,Steve Darcis,Jurgen Melzer,5-2 RET,R32,26,0,1,19,28,13,19,6,9,3,3,4,19,28,0,0,13,20,8,13,4,7,4,5,3,12,20
2015-04-27 00:00:00.000,TEB BNP Paribas Istanbul Open Turkey ATP World Tour 250,CLAY,2,Diego Schwartzman,Blaz Kavcic,Diego Schwartzman,6-2; 6-1,R32,67,3,0,27,47,16,27,12,20,1,3,7,28,47,0,3,39,59,14,39,7,20,3,10,8,21,59
2015-04-27 00:00:00.000,TEB BNP Paribas Istanbul Open Turkey ATP World Tour 250,CLAY,2,Thomaz Bellucci,Mikhail Youzhny,Thomaz Bellucci,7-6(5); 6-3,R32,87,6,1,38,61,30,38,15,23,1,3,11,45,61,2,0,40,66,25,40,15,26,4,7,10,40,66
2015-04-27 00:00:00.000,TEB BNP Paribas Istanbul Open Turkey ATP World Tour 250,CLAY,2,Denis Istomin,Benoit Paire,Denis Istomin,6-3; 6-4,R32,60,5,0,43,65,30,43,13,22,3,4,10,43,65,2,2,32,52,19,32,12,20,3,6,9,31,52
2015-04-27 00:00:00.000,TEB BNP Paribas Istanbul Open Turkey ATP World Tour 250,CLAY,2,Teymuraz Gabashvili,Andrey Kuznetsov,Teymuraz Gabashvili,7-6(1); 6-4,R32,107,3,3,37,66,31,37,19,29,2,2,11,50,66,9,1,56,93,37,56,18,37,6,7,11,55,93
2015-04-27 00:00:00.000,TEB BNP Paribas Istanbul Open Turkey ATP World Tour 250,CLAY,2,Pablo Cuevas,N/A Bye,Pablo Cuevas,,R32,0,0,0,0,0,0,0,0,0,0,0,0,0,0,0,0,0,0,0,0,0,0,0,0,0,0,0
2015-04-27 00:00:00.000,TEB BNP Paribas Istanbul Open Turkey ATP World Tour 250,CLAY,2,Ivan Dodig,Andreas Haider-Maurer,Ivan Dodig,7-5; 6-3,R32,96,9,2,42,72,30,42,17,30,6,7,10,47,72,5,4,39,69,24,39,15,30,1,5,11,39,69
2015-04-27 00:00:00.000,TEB BNP Paribas Istanbul Open Turkey ATP World Tour 250,CLAY,2,Dusan Lajovic,Thanasi Kokkinakis,Dusan Lajovic,6-4; 7-5,R32,93,1,0,43,62,33,43,11,19,0,2,11,44,62,5,1,44,75,23,44,18,31,10,14,11,41,75
2015-04-27 00:00:00.000,TEB BNP Paribas Istanbul Open Turkey ATP World Tour 250,CLAY,2,Andrey Golubev,Nikoloz Basilashvili,Andrey Golubev,6-1; 6-3,R32,73,4,1,36,63,26,36,14,27,5,5,8,40,63,2,4,40,55,21,40,7,15,4,8,8,28,55
2015-04-27 00:00:00.000,TEB BNP Paribas Istanbul Open Turkey ATP World Tour 250,CLAY,2,Grigor Dimitrov,N/A Bye,Grigor Dimitrov,,R32,0,0,0,0,0,0,0,0,0,0,0,0,0,0,0,0,0,0,0,0,0,0,0,0,0,0,0
2015-04-27 00:00:00.000,TEB BNP Paribas Istanbul Open Turkey ATP World Tour 250,CLAY,2,Roger Federer,Jarkko Nieminen,Roger Federer,6-2; 7-5,R16,61,9,2,31,49,29,31,11,18,0,0,10,40,49,0,0,43,64,27,43,12,21,4,7,10,39,64
2015-04-27 00:00:00.000,TEB BNP Paribas Istanbul Open Turkey ATP World Tour 250,CLAY,2,Daniel Gimeno-Traver,Mikhail Kukushkin,Daniel Gimeno-Traver,6-3; 6-3,R16,70,5,4,29,54,23,29,13,25,0,1,9,36,54,1,1,28,50,14,28,12,22,3,7,9,26,50
2015-04-27 00:00:00.000,TEB BNP Paribas Istanbul Open Turkey ATP World Tour 250,CLAY,2,Santiago Giraldo,Andrey Rublev,Santiago Giraldo,6-4; 1-6; 6-3,R16,111,3,0,67,82,42,67,9,15,2,5,13,51,82,7,2,57,80,36,57,13,23,4,7,13,49,80
2015-04-27 00:00:00.000,TEB BNP Paribas Istanbul Open Turkey ATP World Tour 250,CLAY,2,Diego Schwartzman,Jurgen Melzer,Diego Schwartzman,6-0; 6-2,R16,52,4,0,34,47,22,34,11,13,4,4,7,33,47,1,2,27,41,11,27,6,14,5,10,7,17,41
2015-04-27 00:00:00.000,TEB BNP Paribas Istanbul Open Turkey ATP World Tour 250,CLAY,2,Thomaz Bellucci,Denis Istomin,Thomaz Bellucci,7-6(4); 6-3,R16,93,6,0,41,66,36,41,17,25,3,3,11,53,66,0,0,48,71,31,48,15,23,4,5,10,46,71
2015-04-27 00:00:00.000,TEB BNP Paribas Istanbul Open Turkey ATP World Tour 250,CLAY,2,Pablo Cuevas,Teymuraz Gabashvili,Pablo Cuevas,4-6; 6-4; 6-4,R16,119,5,1,62,88,45,62,11,26,4,8,15,56,88,6,3,58,90,41,58,13,32,4,9,15,54,90
2015-04-27 00:00:00.000,TEB BNP Paribas Istanbul Open Turkey ATP World Tour 250,CLAY,2,Ivan Dodig,Dusan Lajovic,Ivan Dodig,5-7; 7-6(1); 6-4,R16,158,6,4,60,117,44,60,28,57,7,11,17,72,117,2,0,78,118,48,78,21,40,11,15,17,69,118
2015-04-27 00:00:00.000,TEB BNP Paribas Istanbul Open Turkey ATP World Tour 250,CLAY,2,Grigor Dimitrov,Andrey Golubev,Grigor Dimitrov,6-3; 6-2,R16,65,2,0,35,45,31,35,6,10,0,0,9,37,45,2,1,44,67,27,44,9,23,8,11,8,36,67
2015-04-27 00:00:00.000,TEB BNP Paribas Istanbul Open Turkey ATP World Tour 250,CLAY,2,Roger Federer,Daniel Gimeno-Traver,Roger Federer,7-6(3); 6-7(5); 6-3,Q,148,11,2,68,106,54,68,22,38,6,8,17,76,106,2,2,76,127,52,76,25,51,10,13,16,77,127
2015-04-27 00:00:00.000,TEB BNP Paribas Istanbul Open Turkey ATP World Tour 250,CLAY,2,Diego Schwartzman,Santiago Giraldo,Diego Schwartzman,0-6; 6-2; 6-2,Q,111,3,4,35,65,24,35,9,30,3,9,11,33,65,3,2,56,85,28,56,12,29,4,11,11,40,85
2015-04-27 00:00:00.000,TEB BNP Paribas Istanbul Open Turkey ATP World Tour 250,CLAY,2,Pablo Cuevas,Thomaz Bellucci,Pablo Cuevas,7-5; 6-3,Q,90,2,0,45,64,29,45,11,19,3,5,11,40,64,0,3,38,66,22,38,13,28,4,8,10,35,66
2015-04-27 00:00:00.000,TEB BNP Paribas Istanbul Open Turkey ATP World Tour 250,CLAY,2,Grigor Dimitrov,Ivan Dodig,Grigor Dimitrov,6-4; 6-3,Q,74,2,1,31,54,20,31,14,23,2,5,10,34,54,4,2,31,55,13,31,13,24,5,10,9,26,55
2015-04-27 00:00:00.000,TEB BNP Paribas Istanbul Open Turkey ATP World Tour 250,CLAY,2,Roger Federer,Diego Schwartzman,Roger Federer,2-6; 6-2; 7-5,S,115,6,1,44,83,34,44,23,39,3,5,14,57,83,4,1,57,102,42,57,18,45,8,11,14,60,102
2015-04-27 00:00:00.000,TEB BNP Paribas Istanbul Open Turkey ATP World Tour 250,CLAY,2,Pablo Cuevas,Grigor Dimitrov,Pablo Cuevas,6-2; 6-4,S,76,1,0,31,50,22,31,10,19,3,5,9,32,50,5,1,40,57,23,40,4,17,1,6,9,27,57
2015-04-27 00:00:00.000,TEB BNP Paribas Istanbul Open Turkey ATP World Tour 250,CLAY,2,Roger Federer,Pablo Cuevas,Roger Federer,6-3; 7-6(11),F,96,7,2,51,72,38,51,13,21,0,1,11,51,72,3,1,52,78,30,52,15,26,7,9,10,45,78
2015-04-27 00:00:00.000,BMW Open by FWU AG Germany ATP World Tour 250,CLAY,2,Andy Murray,N/A Bye,Andy Murray,,R32,0,0,0,0,0,0,0,0,0,0,0,0,0,0,0,0,0,0,0,0,0,0,0,0,0,0,0
2015-04-27 00:00:00.000,BMW Open by FWU AG Germany ATP World Tour 250,CLAY,2,Mischa Zverev,Jan-Lennard Struff,Mischa Zverev,7-6(6); 3-6; 6-4,R32,125,4,2,61,91,37,61,15,30,7,13,15,52,91,7,8,61,110,40,61,21,49,6,12,16,61,110
2015-04-27 00:00:00.000,BMW Open by FWU AG Germany ATP World Tour 250,CLAY,2,Sergiy Stakhovsky,Mikhail Ledovskikh,Sergiy Stakhovsky,6-0; 6-0,R32,36,11,1,24,34,21,24,6,10,3,3,6,27,34,0,2,23,35,8,23,3,12,4,10,6,11,35
2015-04-27 00:00:00.000,BMW Open by FWU AG Germany ATP World Tour 250,CLAY,2,Lukas Rosol,Florian Mayer,Lukas Rosol,6-2; 6-2,R32,54,5,2,25,46,19,25,12,21,2,3,8,31,46,1,2,33,54,17,33,7,21,5,10,8,24,54
2015-04-27 00:00:00.000,BMW Open by FWU AG Germany ATP World Tour 250,CLAY,2,Roberto Bautista Agut,N/A Bye,Roberto Bautista Agut,,R32,0,0,0,0,0,0,0,0,0,0,0,0,0,0,0,0,0,0,0,0,0,0,0,0,0,0,0
2015-04-27 00:00:00.000,BMW Open by FWU AG Germany ATP World Tour 250,CLAY,2,Radek Stepanek,Farrukh Dustov,Radek Stepanek,6-1; 4-1 RET,R32,57,0,1,28,38,20,28,5,10,4,5,6,25,38,2,0,16,28,5,16,2,12,1,6,6,7,28
2015-04-27 00:00:00.000,BMW Open by FWU AG Germany ATP World Tour 250,CLAY,2,Victor Estrella Burgos,Viktor Troicki,Victor Estrella Burgos,7-6(4); 6-4,R32,98,3,0,51,70,40,51,12,19,2,2,11,52,70,8,1,40,61,33,40,13,21,1,2,11,46,61
2015-04-27 00:00:00.000,BMW Open by FWU AG Germany ATP World Tour 250,CLAY,2,Janko Tipsarevic,Bernard Tomic,Janko Tipsarevic,5-7; 6-1; 7-6(3),R32,128,11,1,51,106,37,51,33,55,7,10,16,70,106,5,2,67,105,47,67,16,38,7,11,15,63,105
2015-04-27 00:00:00.000,BMW Open by FWU AG Germany ATP World Tour 250,CLAY,2,Philipp Kohlschreiber,Jiri Vesely,Philipp Kohlschreiber,6-1; 6-2,R32,56,1,0,23,38,17,23,11,15,0,0,7,28,38,2,2,36,50,15,36,7,14,6,11,8,22,50
2015-04-27 00:00:00.000,BMW Open by FWU AG Germany ATP World Tour 250,CLAY,2,Alexander Zverev,Benjamin Becker,Alexander Zverev,4-6; 6-1; 6-2,R32,83,11,1,42,63,37,42,13,21,1,2,13,50,63,4,1,45,73,34,45,8,28,3,7,12,42,73
2015-04-27 00:00:00.000,BMW Open by FWU AG Germany ATP World Tour 250,CLAY,2,Simone Bolelli,Dustin Brown,Simone Bolelli,6-1; 7-6(2),R32,64,5,0,40,54,32,40,9,14,0,0,9,41,54,1,3,47,68,29,47,12,21,4,7,10,41,68
2015-04-27 00:00:00.000,BMW Open by FWU AG Germany ATP World Tour 250,CLAY,2,David Goffin,N/A Bye,David Goffin,,R32,0,0,0,0,0,0,0,0,0,0,0,0,0,0,0,0,0,0,0,0,0,0,0,0,0,0,0
2015-04-27 00:00:00.000,BMW Open by FWU AG Germany ATP World Tour 250,CLAY,2,Fabio Fognini,Bastian Trinker,Fabio Fognini,6-2; 7-6(3),R32,63,2,2,46,55,40,46,3,9,0,1,10,43,55,3,3,41,63,30,41,8,22,2,5,10,38,63
2015-04-27 00:00:00.000,BMW Open by FWU AG Germany ATP World Tour 250,CLAY,2,Dominic Thiem,Vasek Pospisil,Dominic Thiem,5-7; 6-4; 7-6(9),R32,128,4,0,59,95,45,59,26,36,1,4,17,71,95,13,1,67,101,52,67,19,34,3,6,17,71,101
2015-04-27 00:00:00.000,BMW Open by FWU AG Germany ATP World Tour 250,CLAY,2,Pablo Andujar,Joao Souza,Pablo Andujar,6-4; 6-4,R32,94,2,1,40,54,31,40,10,14,1,1,10,41,54,11,3,56,84,41,56,9,28,8,10,10,50,84
2015-04-27 00:00:00.000,BMW Open by FWU AG Germany ATP World Tour 250,CLAY,2,Gerald Melzer,N/A Bye,Gerald Melzer,,R32,0,0,0,0,0,0,0,0,0,0,0,0,0,0,0,0,0,0,0,0,0,0,0,0,0,0,0
2015-04-27 00:00:00.000,BMW Open by FWU AG Germany ATP World Tour 250,CLAY,2,Andy Murray,Mischa Zverev,Andy Murray,6-2; 6-2,R16,75,1,1,32,53,24,32,14,21,6,6,8,38,53,1,2,30,47,15,30,9,17,3,7,8,24,47
2015-04-27 00:00:00.000,BMW Open by FWU AG Germany ATP World Tour 250,CLAY,2,Lukas Rosol,Sergiy Stakhovsky,Lukas Rosol,7-5; 6-2,R16,85,4,4,39,67,31,39,13,28,5,6,10,44,67,3,4,35,67,25,35,12,32,5,9,10,37,67
2015-04-27 00:00:00.000,BMW Open by FWU AG Germany ATP World Tour 250,CLAY,2,Roberto Bautista Agut,Radek Stepanek,Roberto Bautista Agut,6-0; 6-3,R16,63,6,1,33,50,26,33,10,17,4,4,8,36,50,3,1,31,43,17,31,5,12,4,8,7,22,43
2015-04-27 00:00:00.000,BMW Open by FWU AG Germany ATP World Tour 250,CLAY,2,Victor Estrella Burgos,Janko Tipsarevic,Victor Estrella Burgos,6-4; 6-7(1); 7-5,R16,140,7,2,74,105,50,74,17,31,3,6,17,67,105,10,5,63,105,48,63,18,42,4,9,17,66,105
2015-04-27 00:00:00.000,BMW Open by FWU AG Germany ATP World Tour 250,CLAY,2,Philipp Kohlschreiber,Alexander Zverev,Philipp Kohlschreiber,6-2; 6-4,R16,63,5,0,38,46,29,38,7,8,1,2,9,36,46,3,3,31,51,18,31,9,20,0,4,9,27,51
2015-04-27 00:00:00.000,BMW Open by FWU AG Germany ATP World Tour 250,CLAY,2,David Goffin,Simone Bolelli,David Goffin,7-6(5); 6-7(4); 6-1,R16,136,6,2,62,101,47,62,28,39,3,4,16,75,101,5,1,76,107,54,76,16,31,7,10,15,70,107
2015-04-27 00:00:00.000,BMW Open by FWU AG Germany ATP World Tour 250,CLAY,2,Dominic Thiem,Fabio Fognini,Dominic Thiem,6-3; 6-0,R16,56,4,0,29,47,19,29,8,18,7,9,7,27,47,1,2,33,50,14,33,5,17,5,12,8,19,50
2015-04-27 00:00:00.000,BMW Open by FWU AG Germany ATP World Tour 250,CLAY,2,Gerald Melzer,Pablo Andujar,Gerald Melzer,4-1 RET,R16,26,1,1,10,18,8,10,5,8,1,1,3,13,18,0,0,13,20,5,13,5,7,3,4,2,10,20
2015-04-27 00:00:00.000,BMW Open by FWU AG Germany ATP World Tour 250,CLAY,2,Andy Murray,Lukas Rosol,Andy Murray,4-6; 6-3; 6-2,Q,120,5,0,43,76,32,43,17,33,1,4,14,49,76,5,3,69,101,43,69,13,32,9,14,13,56,101
2015-04-27 00:00:00.000,BMW Open by FWU AG Germany ATP World Tour 250,CLAY,2,Roberto Bautista Agut,Victor Estrella Burgos,Roberto Bautista Agut,4-6; 6-0; 6-0,Q,91,4,2,47,67,34,47,14,20,4,5,11,48,67,0,1,55,80,29,55,10,25,6,12,11,39,80
2015-04-27 00:00:00.000,BMW Open by FWU AG Germany ATP World Tour 250,CLAY,2,Philipp Kohlschreiber,David Goffin,Philipp Kohlschreiber,2-6; 6-3; 6-4,Q,105,6,1,48,77,35,48,16,29,1,4,14,51,77,5,1,33,69,24,33,22,36,4,7,13,46,69
2015-04-27 00:00:00.000,BMW Open by FWU AG Germany ATP World Tour 250,CLAY,2,Gerald Melzer,Dominic Thiem,Gerald Melzer,7-6(5); 3-6; 6-3,Q,137,5,2,66,103,45,66,19,37,6,9,15,64,103,5,2,48,99,34,48,26,51,4,7,15,60,99
2015-04-27 00:00:00.000,BMW Open by FWU AG Germany ATP World Tour 250,CLAY,2,Andy Murray,Roberto Bautista Agut,Andy Murray,6-4; 6-4,S,94,9,1,43,59,31,43,11,16,5,6,10,42,59,3,2,51,74,32,51,9,23,5,8,10,41,74
2015-04-27 00:00:00.000,BMW Open by FWU AG Germany ATP World Tour 250,CLAY,2,Philipp Kohlschreiber,Gerald Melzer,Philipp Kohlschreiber,2-6; 6-1; 6-4,S,97,6,3,46,67,35,46,10,21,2,4,12,45,67,5,0,51,80,30,51,15,29,9,13,13,45,80
2015-04-27 00:00:00.000,BMW Open by FWU AG Germany ATP World Tour 250,CLAY,2,Andy Murray,Philipp Kohlschreiber,Andy Murray,7-6(4); 5-7; 7-6(4),F,184,17,1,81,122,62,81,22,41,3,5,18,84,122,11,0,77,113,60,77,20,36,3,4,18,80,113
2015-05-03 00:00:00.000,Mutua Madrid Open Spain ATP World Tour Masters 1000,CLAY,2,Roger Federer,N/A Bye,Roger Federer,,R64,0,0,0,0,0,0,0,0,0,0,0,0,0,0,0,0,0,0,0,0,0,0,0,0,0,0,0
2015-05-03 00:00:00.000,Mutua Madrid Open Spain ATP World Tour Masters 1000,CLAY,2,Nick Kyrgios,Daniel Gimeno-Traver,Nick Kyrgios,6-2; 6-3,R64,61,10,1,38,51,33,38,5,13,2,2,9,38,51,2,1,38,55,20,38,10,17,1,4,8,30,55
2015-05-03 00:00:00.000,Mutua Madrid Open Spain ATP World Tour Masters 1000,CLAY,2,Thomaz Bellucci,Jeremy Chardy,Thomaz Bellucci,6-4; 7-5,R64,93,7,1,40,58,32,40,14,18,2,2,11,46,58,3,1,53,85,35,53,15,32,8,10,11,50,85
2015-05-03 00:00:00.000,Mutua Madrid Open Spain ATP World Tour Masters 1000,CLAY,2,John Isner,Adrian Mannarino,John Isner,7-6(2); 6-4,R64,80,13,2,47,68,37,47,12,21,0,0,11,49,68,4,4,36,61,28,36,16,25,0,1,11,44,61
2015-05-03 00:00:00.000,Mutua Madrid Open Spain ATP World Tour Masters 1000,CLAY,2,Jo-Wilfried Tsonga,Lukas Rosol,Jo-Wilfried Tsonga,7-5; 6-3,R64,66,11,3,37,56,32,37,13,19,0,0,11,45,56,3,3,33,59,26,33,11,26,0,2,10,37,59
2015-05-03 00:00:00.000,Mutua Madrid Open Spain ATP World Tour Masters 1000,CLAY,2,Jack Sock,Pablo Andujar,Jack Sock,6-4; 7-5,R64,104,7,6,36,70,28,36,17,34,3,5,11,45,70,2,3,59,91,35,59,15,32,5,9,11,50,91
2015-05-03 00:00:00.000,Mutua Madrid Open Spain ATP World Tour Masters 1000,CLAY,2,Richard Gasquet,Ivo Karlovic,Richard Gasquet,6-3; 6-4,R64,58,4,0,44,53,37,44,4,9,0,0,10,41,53,9,3,31,46,22,31,8,15,0,2,9,30,46
2015-05-03 00:00:00.000,Mutua Madrid Open Spain ATP World Tour Masters 1000,CLAY,2,Tomas Berdych,N/A Bye,Tomas Berdych,,R64,0,0,0,0,0,0,0,0,0,0,0,0,0,0,0,0,0,0,0,0,0,0,0,0,0,0,0
2015-05-03 00:00:00.000,Mutua Madrid Open Spain ATP World Tour Masters 1000,CLAY,2,Rafael Nadal,N/A Bye,Rafael Nadal,,R64,0,0,0,0,0,0,0,0,0,0,0,0,0,0,0,0,0,0,0,0,0,0,0,0,0,0,0
2015-05-03 00:00:00.000,Mutua Madrid Open Spain ATP World Tour Masters 1000,CLAY,2,Steve Johnson,Alejandro Gonzalez,Steve Johnson,4-6; 6-3; 7-6(4),R64,140,11,4,61,104,47,61,27,43,5,6,16,74,104,1,2,87,113,57,87,17,26,6,7,15,74,113
2015-05-03 00:00:00.000,Mutua Madrid Open Spain ATP World Tour Masters 1000,CLAY,2,Luca Vanni,Bernard Tomic,Luca Vanni,3-6; 6-4; 7-6(1),R64,108,16,1,59,87,45,59,18,28,5,6,15,63,87,6,0,59,89,42,59,20,30,1,2,16,62,89
2015-05-03 00:00:00.000,Mutua Madrid Open Spain ATP World Tour Masters 1000,CLAY,2,Simone Bolelli,Kevin Anderson,Simone Bolelli,6-4; 6-3,R64,76,2,1,32,42,28,32,8,10,0,0,9,36,42,6,4,44,70,29,44,12,26,3,6,10,41,70
2015-05-03 00:00:00.000,Mutua Madrid Open Spain ATP World Tour Masters 1000,CLAY,2,Grigor Dimitrov,Donald Young,Grigor Dimitrov,6-4; 3-0 RET,R64,57,7,1,28,40,23,28,8,12,1,1,6,31,40,1,3,30,49,20,30,7,19,3,6,7,27,49
2015-05-03 00:00:00.000,Mutua Madrid Open Spain ATP World Tour Masters 1000,CLAY,2,Fabio Fognini,Santiago Giraldo,Fabio Fognini,6-2; 6-3,R64,74,1,1,28,53,20,28,15,25,7,8,8,35,53,1,2,47,69,25,47,9,22,4,9,9,34,69
2015-05-03 00:00:00.000,Mutua Madrid Open Spain ATP World Tour Masters 1000,CLAY,2,Joao Sousa,Jerzy Janowicz,Joao Sousa,6-4; 7-5,R64,87,4,0,40,59,35,40,12,19,3,3,11,47,59,10,4,49,78,35,49,14,29,5,7,11,49,78
2015-05-03 00:00:00.000,Mutua Madrid Open Spain ATP World Tour Masters 1000,CLAY,2,Stan Wawrinka,N/A Bye,Stan Wawrinka,,R64,0,0,0,0,0,0,0,0,0,0,0,0,0,0,0,0,0,0,0,0,0,0,0,0,0,0,0
2015-05-03 00:00:00.000,Mutua Madrid Open Spain ATP World Tour Masters 1000,CLAY,2,David Ferrer,N/A Bye,David Ferrer,,R64,0,0,0,0,0,0,0,0,0,0,0,0,0,0,0,0,0,0,0,0,0,0,0,0,0,0,0
2015-05-03 00:00:00.000,Mutua Madrid Open Spain ATP World Tour Masters 1000,CLAY,2,Albert Ramos-Vinolas,Pablo Cuevas,Albert Ramos-Vinolas,3-6; 6-3; 6-4,R64,135,3,2,52,83,40,52,19,31,3,4,14,59,83,9,4,53,93,38,53,23,40,5,7,14,61,93
2015-05-03 00:00:00.000,Mutua Madrid Open Spain ATP World Tour Masters 1000,CLAY,2,Fernando Verdasco,Guillermo Garcia-Lopez,Fernando Verdasco,4-6; 6-2; 6-3,R64,113,4,4,55,81,45,55,8,26,5,8,14,53,81,2,6,34,72,20,34,18,38,4,9,13,38,72
2015-05-03 00:00:00.000,Mutua Madrid Open Spain ATP World Tour Masters 1000,CLAY,2,Marin Cilic,Jiri Vesely,Marin Cilic,7-5; 6-1,R64,78,5,2,43,65,30,43,12,22,4,5,10,42,65,4,3,37,53,25,37,5,16,3,7,9,30,53
2015-05-03 00:00:00.000,Mutua Madrid Open Spain ATP World Tour Masters 1000,CLAY,2,Roberto Bautista Agut,Marius Copil,Roberto Bautista Agut,7-5; 6-3,R64,90,2,1,48,68,35,48,14,20,0,0,11,49,68,5,3,38,73,25,38,19,35,3,5,10,44,73
2015-05-03 00:00:00.000,Mutua Madrid Open Spain ATP World Tour Masters 1000,CLAY,2,Sam Querrey,Thanasi Kokkinakis,Sam Querrey,6-4; 6-7(6); 6-3,R64,129,11,3,82,107,63,82,11,25,2,3,16,74,107,4,4,60,89,50,60,12,29,4,7,15,62,89
2015-05-03 00:00:00.000,Mutua Madrid Open Spain ATP World Tour Masters 1000,CLAY,2,David Goffin,Ernests Gulbis,David Goffin,3-6; 6-1; 7-5,R64,133,6,3,58,98,42,58,20,40,5,7,14,62,98,6,5,70,102,44,70,14,32,9,13,14,58,102
2015-05-03 00:00:00.000,Mutua Madrid Open Spain ATP World Tour Masters 1000,CLAY,2,Kei Nishikori,N/A Bye,Kei Nishikori,,R64,0,0,0,0,0,0,0,0,0,0,0,0,0,0,0,0,0,0,0,0,0,0,0,0,0,0,0
2015-05-03 00:00:00.000,Mutua Madrid Open Spain ATP World Tour Masters 1000,CLAY,2,Milos Raonic,N/A Bye,Milos Raonic,,R64,0,0,0,0,0,0,0,0,0,0,0,0,0,0,0,0,0,0,0,0,0,0,0,0,0,0,0
2015-05-03 00:00:00.000,Mutua Madrid Open Spain ATP World Tour Masters 1000,CLAY,2,Juan Monaco,Nicolas Almagro,Juan Monaco,6-3; 6-2,R64,69,3,0,45,57,31,45,8,12,2,2,9,39,57,5,1,24,42,18,24,5,18,0,3,8,23,42
2015-05-03 00:00:00.000,Mutua Madrid Open Spain ATP World Tour Masters 1000,CLAY,2,Leonardo Mayer,Gilles Muller,Leonardo Mayer,6-3; 6-3,R64,66,4,3,35,57,30,35,9,22,3,4,9,39,57,0,0,35,49,19,35,6,14,0,4,9,25,49
2015-05-03 00:00:00.000,Mutua Madrid Open Spain ATP World Tour Masters 1000,CLAY,2,Feliciano Lopez,Benjamin Becker,Feliciano Lopez,7-5; 3-6; 6-4,R64,129,13,2,46,78,36,46,20,32,0,2,15,56,78,8,6,71,116,48,71,22,45,10,13,16,70,116
2015-05-03 00:00:00.000,Mutua Madrid Open Spain ATP World Tour Masters 1000,CLAY,2,Gael Monfils,Viktor Troicki,Gael Monfils,6-2; 6-0,R64,60,1,0,37,49,26,37,8,12,3,3,7,34,49,3,1,30,42,16,30,2,12,1,6,7,18,42
2015-05-03 00:00:00.000,Mutua Madrid Open Spain ATP World Tour Masters 1000,CLAY,2,Marcel Granollers,Martin Klizan,Marcel Granollers,5-2 RET,R64,28,3,0,13,20,11,13,5,7,0,0,4,16,20,0,1,11,20,7,11,5,9,0,1,3,12,20
2015-05-03 00:00:00.000,Mutua Madrid Open Spain ATP World Tour Masters 1000,CLAY,2,Philipp Kohlschreiber,Alejandro Falla,Philipp Kohlschreiber,6-1; 6-4,R64,59,6,0,33,45,25,33,8,12,1,2,9,33,45,1,1,36,53,19,36,7,17,0,4,8,26,53
2015-05-03 00:00:00.000,Mutua Madrid Open Spain ATP World Tour Masters 1000,CLAY,2,Andy Murray,N/A Bye,Andy Murray,,R64,0,0,0,0,0,0,0,0,0,0,0,0,0,0,0,0,0,0,0,0,0,0,0,0,0,0,0
2015-05-03 00:00:00.000,Mutua Madrid Open Spain ATP World Tour Masters 1000,CLAY,2,Nick Kyrgios,Roger Federer,Nick Kyrgios,6-7(2); 7-6(5); 7-6(12),R32,157,22,2,85,129,67,85,19,44,2,4,18,86,129,16,1,74,129,58,74,30,55,1,3,18,88,129
2015-05-03 00:00:00.000,Mutua Madrid Open Spain ATP World Tour Masters 1000,CLAY,2,John Isner,Thomaz Bellucci,John Isner,7-6(5); 6-7(11); 6-1,R32,132,23,2,77,108,61,77,20,31,1,1,16,81,108,13,4,68,108,54,68,21,40,3,5,15,75,108
2015-05-03 00:00:00.000,Mutua Madrid Open Spain ATP World Tour Masters 1000,CLAY,2,Jo-Wilfried Tsonga,Jack Sock,Jo-Wilfried Tsonga,6-3; 1-6; 7-6(4),R32,100,5,1,54,78,40,54,11,24,1,4,14,51,78,6,2,60,81,45,60,9,21,0,2,14,54,81
2015-05-03 00:00:00.000,Mutua Madrid Open Spain ATP World Tour Masters 1000,CLAY,2,Tomas Berdych,Richard Gasquet,Tomas Berdych,7-6(3); 7-5,R32,97,10,0,40,70,30,40,24,30,0,1,12,54,70,3,1,45,72,28,45,18,27,3,5,12,46,72
2015-05-03 00:00:00.000,Mutua Madrid Open Spain ATP World Tour Masters 1000,CLAY,2,Rafael Nadal,Steve Johnson,Rafael Nadal,6-4; 6-3,R32,74,0,0,38,46,31,38,5,8,0,0,9,36,46,4,2,38,54,28,38,6,16,2,5,10,34,54
2015-05-03 00:00:00.000,Mutua Madrid Open Spain ATP World Tour Masters 1000,CLAY,2,Simone Bolelli,Luca Vanni,Simone Bolelli,4-6; 6-3; 6-2,R32,101,1,1,48,70,40,48,16,22,3,4,14,56,70,7,3,41,75,31,41,16,34,2,5,13,47,75
2015-05-03 00:00:00.000,Mutua Madrid Open Spain ATP World Tour Masters 1000,CLAY,2,Grigor Dimitrov,Fabio Fognini,Grigor Dimitrov,3-6; 6-2; 7-5,R32,125,2,1,67,91,44,67,12,24,11,14,14,56,91,5,0,47,90,28,47,24,43,5,10,15,52,90
2015-05-03 00:00:00.000,Mutua Madrid Open Spain ATP World Tour Masters 1000,CLAY,2,Stan Wawrinka,Joao Sousa,Stan Wawrinka,7-6(1); 7-5,R32,93,2,1,42,76,37,42,17,34,2,3,12,54,76,2,2,47,79,36,47,11,32,3,5,12,47,79
2015-05-03 00:00:00.000,Mutua Madrid Open Spain ATP World Tour Masters 1000,CLAY,2,David Ferrer,Albert Ramos-Vinolas,David Ferrer,6-4; 6-0,R32,79,1,2,29,46,22,29,9,17,0,1,8,31,46,1,3,43,59,23,43,4,16,8,13,8,27,59
2015-05-03 00:00:00.000,Mutua Madrid Open Spain ATP World Tour Masters 1000,CLAY,2,Fernando Verdasco,Marin Cilic,Fernando Verdasco,6-7(5); 7-6(5); 6-3,R32,147,5,4,72,103,52,72,17,31,2,5,16,69,103,8,4,63,111,46,63,25,48,2,7,17,71,111
2015-05-03 00:00:00.000,Mutua Madrid Open Spain ATP World Tour Masters 1000,CLAY,2,Roberto Bautista Agut,Sam Querrey,Roberto Bautista Agut,7-5; 6-4,R32,73,1,0,39,53,34,39,9,14,2,3,11,43,53,9,1,46,68,27,46,13,22,3,6,11,40,68
2015-05-03 00:00:00.000,Mutua Madrid Open Spain ATP World Tour Masters 1000,CLAY,2,Kei Nishikori,David Goffin,Kei Nishikori,6-2; 4-6; 6-4,R32,114,1,1,54,78,40,54,12,24,2,4,14,52,78,6,2,48,89,34,48,19,41,3,7,14,53,89
2015-05-03 00:00:00.000,Mutua Madrid Open Spain ATP World Tour Masters 1000,CLAY,2,Milos Raonic,Juan Monaco,Milos Raonic,6-3; 6-4,R32,68,9,0,32,50,27,32,13,18,0,0,10,40,50,2,2,42,54,29,42,5,12,2,4,9,34,54
2015-05-03 00:00:00.000,Mutua Madrid Open Spain ATP World Tour Masters 1000,CLAY,2,Leonardo Mayer,Feliciano Lopez,Leonardo Mayer,7-6(3); 7-6(6),R32,118,8,3,54,88,41,54,24,34,2,2,12,65,88,15,2,48,84,38,48,20,36,2,2,12,58,84
2015-05-03 00:00:00.000,Mutua Madrid Open Spain ATP World Tour Masters 1000,CLAY,2,Marcel Granollers,Gael Monfils,Marcel Granollers,7-6(6); 6-7(7); 6-4,R32,200,6,3,85,132,62,85,23,47,9,11,17,85,132,5,7,104,144,70,104,17,40,14,17,17,87,144
2015-05-03 00:00:00.000,Mutua Madrid Open Spain ATP World Tour Masters 1000,CLAY,2,Andy Murray,Philipp Kohlschreiber,Andy Murray,6-4; 3-6; 6-0,R32,108,4,3,44,73,33,44,13,29,4,7,12,46,73,4,2,51,76,30,51,9,25,5,11,13,39,76
2015-05-03 00:00:00.000,Mutua Madrid Open Spain ATP World Tour Masters 1000,CLAY,2,John Isner,Nick Kyrgios,John Isner,6-3; 6-7(7); 6-4,R16,105,20,2,62,84,54,62,16,22,0,0,16,70,84,10,2,64,98,51,64,16,34,2,4,15,67,98
2015-05-03 00:00:00.000,Mutua Madrid Open Spain ATP World Tour Masters 1000,CLAY,2,Tomas Berdych,Jo-Wilfried Tsonga,Tomas Berdych,7-5; 6-2,R16,89,3,1,28,60,23,28,19,32,3,4,10,42,60,3,2,35,54,22,35,9,19,1,5,10,31,54
2015-05-03 00:00:00.000,Mutua Madrid Open Spain ATP World Tour Masters 1000,CLAY,2,Rafael Nadal,Simone Bolelli,Rafael Nadal,6-2; 6-2,R16,73,2,2,34,48,26,34,9,14,2,2,8,35,48,0,2,23,44,12,23,11,21,1,5,8,23,44
2015-05-03 00:00:00.000,Mutua Madrid Open Spain ATP World Tour Masters 1000,CLAY,2,Grigor Dimitrov,Stan Wawrinka,Grigor Dimitrov,7-6(5); 3-6; 6-3,R16,119,4,2,75,102,59,75,9,27,10,12,15,68,102,7,2,50,83,43,50,18,33,3,5,15,61,83
2015-05-03 00:00:00.000,Mutua Madrid Open Spain ATP World Tour Masters 1000,CLAY,2,David Ferrer,Fernando Verdasco,David Ferrer,5-7; 6-3; 6-4,R16,147,5,0,65,110,45,65,24,45,6,8,16,69,110,5,7,72,101,51,72,11,29,5,8,15,62,101
2015-05-03 00:00:00.000,Mutua Madrid Open Spain ATP World Tour Masters 1000,CLAY,2,Kei Nishikori,Roberto Bautista Agut,Kei Nishikori,6-3; 6-3,R16,72,1,2,30,54,26,30,13,24,2,2,9,39,54,4,2,33,51,20,33,10,18,1,4,9,30,51
2015-05-03 00:00:00.000,Mutua Madrid Open Spain ATP World Tour Masters 1000,CLAY,2,Milos Raonic,Leonardo Mayer,Milos Raonic,6-4; 6-3,R16,78,11,1,39,61,32,39,13,22,3,3,10,45,61,3,2,26,46,20,26,12,20,2,4,9,32,46
2015-05-03 00:00:00.000,Mutua Madrid Open Spain ATP World Tour Masters 1000,CLAY,2,Andy Murray,Marcel Granollers,Andy Murray,6-2; 6-0,R16,65,1,3,34,46,27,34,6,12,1,1,7,33,46,1,0,21,36,10,21,3,15,1,6,7,13,36
2015-05-03 00:00:00.000,Mutua Madrid Open Spain ATP World Tour Masters 1000,CLAY,2,Tomas Berdych,John Isner,Tomas Berdych,3-6; 7-6(7); 7-6(1),Q,130,11,1,50,91,43,50,29,41,0,1,16,72,91,29,0,80,104,63,80,13,24,4,4,17,76,104
2015-05-03 00:00:00.000,Mutua Madrid Open Spain ATP World Tour Masters 1000,CLAY,2,Rafael Nadal,Grigor Dimitrov,Rafael Nadal,6-3; 6-4,Q,108,4,1,38,55,24,38,10,17,3,5,9,34,55,4,4,53,83,29,53,12,30,10,15,10,41,83
2015-05-03 00:00:00.000,Mutua Madrid Open Spain ATP World Tour Masters 1000,CLAY,2,Kei Nishikori,David Ferrer,Kei Nishikori,6-4; 6-2,Q,73,3,1,30,51,23,30,9,21,3,5,9,32,51,1,4,32,49,16,32,8,17,1,6,9,24,49
2015-05-03 00:00:00.000,Mutua Madrid Open Spain ATP World Tour Masters 1000,CLAY,2,Andy Murray,Milos Raonic,Andy Murray,6-4; 7-5,Q,101,2,0,51,68,40,51,9,17,5,5,11,49,68,8,4,39,66,32,39,11,27,4,6,11,43,66
2015-05-03 00:00:00.000,Mutua Madrid Open Spain ATP World Tour Masters 1000,CLAY,2,Rafael Nadal,Tomas Berdych,Rafael Nadal,7-6(3); 6-1,S,104,2,0,37,55,32,37,13,18,0,0,10,45,55,8,5,33,73,23,33,21,40,7,9,9,44,73
2015-05-03 00:00:00.000,Mutua Madrid Open Spain ATP World Tour Masters 1000,CLAY,2,Andy Murray,Kei Nishikori,Andy Murray,6-3; 6-4,S,98,4,2,34,58,27,34,13,24,2,3,9,40,58,1,1,46,71,27,46,11,25,4,8,10,38,71
2015-05-03 00:00:00.000,Mutua Madrid Open Spain ATP World Tour Masters 1000,CLAY,2,Andy Murray,Rafael Nadal,Andy Murray,6-3; 6-2,F,89,3,1,31,52,21,31,17,21,3,3,9,38,52,1,1,34,47,23,34,6,13,3,6,8,29,47
2015-05-10 00:00:00.000,Internazionali BNL d'Italia Italy ATP World Tour Masters 1000,CLAY,2,Novak Djokovic,N/A Bye,Novak Djokovic,,R64,0,0,0,0,0,0,0,0,0,0,0,0,0,0,0,0,0,0,0,0,0,0,0,0,0,0,0
2015-05-10 00:00:00.000,Internazionali BNL d'Italia Italy ATP World Tour Masters 1000,CLAY,2,Nicolas Almagro,Luca Vanni,Nicolas Almagro,6-4; 6-3,R64,78,7,0,33,55,29,33,13,22,3,3,10,42,55,5,2,34,65,27,34,12,31,5,7,9,39,65
2015-05-10 00:00:00.000,Internazionali BNL d'Italia Italy ATP World Tour Masters 1000,CLAY,2,Thomaz Bellucci,Diego Schwartzman,Thomaz Bellucci,6-4; 4-3 RET,R64,88,3,4,33,60,22,33,13,27,4,6,8,35,60,0,2,39,57,22,39,9,18,2,6,9,31,57
2015-05-10 00:00:00.000,Internazionali BNL d'Italia Italy ATP World Tour Masters 1000,CLAY,2,Roberto Bautista Agut,Marcel Granollers,Roberto Bautista Agut,6-1; 6-3,R64,76,3,1,35,51,29,35,7,16,4,4,8,36,51,1,0,33,53,18,33,9,20,2,6,8,27,53
2015-05-10 00:00:00.000,Internazionali BNL d'Italia Italy ATP World Tour Masters 1000,CLAY,2,Feliciano Lopez,Nick Kyrgios,Feliciano Lopez,6-4; 7-6(4),R64,82,13,3,46,66,34,46,12,20,0,1,11,46,66,9,6,45,80,32,45,19,35,3,5,11,51,80
2015-05-10 00:00:00.000,Internazionali BNL d'Italia Italy ATP World Tour Masters 1000,CLAY,2,Viktor Troicki,Bernard Tomic,Viktor Troicki,7-6(3); 6-7(4); 7-6(4),R64,166,12,0,68,105,56,68,21,37,1,4,18,77,105,5,5,95,155,61,95,34,60,12,15,18,95,155
2015-05-10 00:00:00.000,Internazionali BNL d'Italia Italy ATP World Tour Masters 1000,CLAY,2,Jiri Vesely,Ernests Gulbis,Jiri Vesely,7-6(4); 2-6; 6-3,R64,148,9,7,59,110,47,59,22,51,5,8,15,69,110,9,6,52,86,39,52,18,34,3,5,14,57,86
2015-05-10 00:00:00.000,Internazionali BNL d'Italia Italy ATP World Tour Masters 1000,CLAY,2,Kei Nishikori,N/A Bye,Kei Nishikori,,R64,0,0,0,0,0,0,0,0,0,0,0,0,0,0,0,0,0,0,0,0,0,0,0,0,0,0,0
2015-05-10 00:00:00.000,Internazionali BNL d'Italia Italy ATP World Tour Masters 1000,CLAY,2,Andy Murray,N/A Bye,Andy Murray,,R64,0,0,0,0,0,0,0,0,0,0,0,0,0,0,0,0,0,0,0,0,0,0,0,0,0,0,0
2015-05-10 00:00:00.000,Internazionali BNL d'Italia Italy ATP World Tour Masters 1000,CLAY,2,Jeremy Chardy,Lukas Rosol,Jeremy Chardy,7-6(0); 6-4,R64,97,10,0,40,60,31,40,17,20,1,1,11,48,60,4,5,51,95,33,51,23,44,11,12,11,56,95
2015-05-10 00:00:00.000,Internazionali BNL d'Italia Italy ATP World Tour Masters 1000,CLAY,2,David Goffin,Andrea Arnaboldi,David Goffin,5-7; 6-2; 6-1,R64,123,6,4,39,65,33,39,13,26,0,2,13,46,65,5,2,62,110,35,62,21,48,16,22,14,56,110
2015-05-10 00:00:00.000,Internazionali BNL d'Italia Italy ATP World Tour Masters 1000,CLAY,2,Jo-Wilfried Tsonga,Sam Querrey,Jo-Wilfried Tsonga,7-6(6); 6-0,R64,85,7,2,38,59,25,38,11,21,0,2,9,36,59,5,2,32,67,23,32,11,35,4,9,9,34,67
2015-05-10 00:00:00.000,Internazionali BNL d'Italia Italy ATP World Tour Masters 1000,CLAY,2,Guillermo Garcia-Lopez,Marin Cilic,Guillermo Garcia-Lopez,6-4; 6-3,R64,105,9,2,43,63,34,43,10,20,5,5,9,44,63,7,7,59,93,40,59,12,34,11,14,10,52,93
2015-05-10 00:00:00.000,Internazionali BNL d'Italia Italy ATP World Tour Masters 1000,CLAY,2,Alexandr Dolgopolov,Martin Klizan,Alexandr Dolgopolov,6-4; 6-1,R64,74,4,0,22,37,18,22,11,15,1,2,8,29,37,1,9,33,74,22,33,13,41,6,11,9,35,74
2015-05-10 00:00:00.000,Internazionali BNL d'Italia Italy ATP World Tour Masters 1000,CLAY,2,Richard Gasquet,Thomas Fabbiano,Richard Gasquet,6-1; 7-6(0),R64,87,4,0,32,57,26,32,18,25,0,1,10,44,57,2,2,37,63,24,37,10,26,4,7,9,34,63
2015-05-10 00:00:00.000,Internazionali BNL d'Italia Italy ATP World Tour Masters 1000,CLAY,2,David Ferrer,N/A Bye,David Ferrer,,R64,0,0,0,0,0,0,0,0,0,0,0,0,0,0,0,0,0,0,0,0,0,0,0,0,0,0,0
2015-05-10 00:00:00.000,Internazionali BNL d'Italia Italy ATP World Tour Masters 1000,CLAY,2,Stan Wawrinka,N/A Bye,Stan Wawrinka,,R64,0,0,0,0,0,0,0,0,0,0,0,0,0,0,0,0,0,0,0,0,0,0,0,0,0,0,0
2015-05-10 00:00:00.000,Internazionali BNL d'Italia Italy ATP World Tour Masters 1000,CLAY,2,Juan Monaco,Dusan Lajovic,Juan Monaco,6-3; 6-7(5); 6-2,R64,140,1,0,79,109,51,79,21,30,6,8,15,72,109,0,0,60,90,40,60,15,30,5,10,14,55,90
2015-05-10 00:00:00.000,Internazionali BNL d'Italia Italy ATP World Tour Masters 1000,CLAY,2,Dominic Thiem,Simone Bolelli,Dominic Thiem,7-6(4); 7-6(5),R64,120,8,3,50,92,38,50,23,42,6,7,12,61,92,2,1,56,79,42,56,13,23,3,4,12,55,79
2015-05-10 00:00:00.000,Internazionali BNL d'Italia Italy ATP World Tour Masters 1000,CLAY,2,Gilles Simon,Jack Sock,Gilles Simon,4-6; 7-6(2); 6-3,R64,141,9,3,51,94,34,51,27,43,2,6,16,61,94,10,5,55,101,37,55,23,46,5,9,15,60,101
2015-05-10 00:00:00.000,Internazionali BNL d'Italia Italy ATP World Tour Masters 1000,CLAY,2,John Isner,Joao Sousa,John Isner,7-5; 6-3,R64,71,13,1,45,61,35,45,10,16,1,1,11,45,61,2,3,23,50,17,23,18,27,0,2,10,35,50
2015-05-10 00:00:00.000,Internazionali BNL d'Italia Italy ATP World Tour Masters 1000,CLAY,2,Leonardo Mayer,Federico Gaio,Leonardo Mayer,6-3; 6-4,R64,72,6,2,33,51,26,33,12,18,2,3,10,38,51,2,4,32,50,23,32,7,18,0,3,9,30,50
2015-05-10 00:00:00.000,Internazionali BNL d'Italia Italy ATP World Tour Masters 1000,CLAY,2,Marsel Ilhan,Adrian Mannarino,Marsel Ilhan,6-4; 6-1,R64,79,3,1,38,58,26,38,14,20,6,6,8,40,58,2,3,33,64,23,33,10,31,3,7,9,33,64
2015-05-10 00:00:00.000,Internazionali BNL d'Italia Italy ATP World Tour Masters 1000,CLAY,2,Rafael Nadal,N/A Bye,Rafael Nadal,,R64,0,0,0,0,0,0,0,0,0,0,0,0,0,0,0,0,0,0,0,0,0,0,0,0,0,0,0
2015-05-10 00:00:00.000,Internazionali BNL d'Italia Italy ATP World Tour Masters 1000,CLAY,2,Tomas Berdych,N/A Bye,Tomas Berdych,,R64,0,0,0,0,0,0,0,0,0,0,0,0,0,0,0,0,0,0,0,0,0,0,0,0,0,0,0
2015-05-10 00:00:00.000,Internazionali BNL d'Italia Italy ATP World Tour Masters 1000,CLAY,2,Matteo Donati,Santiago Giraldo,Matteo Donati,2-6; 6-1; 6-4,R64,117,6,2,50,84,34,50,17,34,4,7,13,51,84,2,0,55,82,35,55,13,27,5,9,12,48,82
2015-05-10 00:00:00.000,Internazionali BNL d'Italia Italy ATP World Tour Masters 1000,CLAY,2,Fabio Fognini,Steve Johnson,Fabio Fognini,7-6(0); 6-3,R64,102,4,2,47,70,39,47,13,23,2,2,11,52,70,4,1,57,82,34,57,14,25,3,4,10,48,82
2015-05-10 00:00:00.000,Internazionali BNL d'Italia Italy ATP World Tour Masters 1000,CLAY,2,Grigor Dimitrov,Jerzy Janowicz,Grigor Dimitrov,6-3; 7-6(4),R64,92,5,4,38,62,32,38,16,24,0,0,11,48,62,5,3,48,77,36,48,12,29,5,6,10,48,77
2015-05-10 00:00:00.000,Internazionali BNL d'Italia Italy ATP World Tour Masters 1000,CLAY,2,Kevin Anderson,Florian Mayer,Kevin Anderson,7-6(3); 4-6; 7-6(4),R64,174,18,4,74,119,53,74,25,45,8,11,17,78,119,6,1,87,123,58,87,20,36,4,6,17,78,123
2015-05-10 00:00:00.000,Internazionali BNL d'Italia Italy ATP World Tour Masters 1000,CLAY,2,Philipp Kohlschreiber,Donald Young,Philipp Kohlschreiber,6-4; 6-1,R64,69,5,0,24,41,22,24,10,17,0,0,8,32,41,1,5,36,69,23,36,14,33,8,12,9,37,69
2015-05-10 00:00:00.000,Internazionali BNL d'Italia Italy ATP World Tour Masters 1000,CLAY,2,Pablo Cuevas,Paolo Lorenzi,Pablo Cuevas,6-3; 6-2,R64,77,5,0,32,43,26,32,10,11,0,0,9,36,43,2,1,32,66,19,32,17,34,5,8,8,36,66
2015-05-10 00:00:00.000,Internazionali BNL d'Italia Italy ATP World Tour Masters 1000,CLAY,2,Roger Federer,N/A Bye,Roger Federer,,R64,0,0,0,0,0,0,0,0,0,0,0,0,0,0,0,0,0,0,0,0,0,0,0,0,0,0,0
2015-05-10 00:00:00.000,Internazionali BNL d'Italia Italy ATP World Tour Masters 1000,CLAY,2,Novak Djokovic,Nicolas Almagro,Novak Djokovic,6-1; 6-7(5); 6-3,R32,122,11,0,65,91,51,65,15,26,1,1,15,66,91,11,2,47,83,33,47,19,36,0,3,13,52,83
2015-05-10 00:00:00.000,Internazionali BNL d'Italia Italy ATP World Tour Masters 1000,CLAY,2,Thomaz Bellucci,Roberto Bautista Agut,Thomaz Bellucci,1-6; 6-1; 6-4,R32,98,6,0,40,71,31,40,17,31,3,5,12,48,71,2,1,39,66,24,39,19,27,2,5,12,43,66
2015-05-10 00:00:00.000,Internazionali BNL d'Italia Italy ATP World Tour Masters 1000,CLAY,2,Viktor Troicki,Feliciano Lopez,Viktor Troicki,6-7(2); 6-4; 6-3,R32,135,16,0,71,103,52,71,19,32,6,7,16,71,103,11,3,57,107,41,57,25,50,3,6,15,66,107
2015-05-10 00:00:00.000,Internazionali BNL d'Italia Italy ATP World Tour Masters 1000,CLAY,2,Kei Nishikori,Jiri Vesely,Kei Nishikori,7-6(3); 7-5,R32,131,8,4,52,83,38,52,15,31,3,5,12,53,83,7,2,57,90,37,57,15,33,5,8,12,52,90
2015-05-10 00:00:00.000,Internazionali BNL d'Italia Italy ATP World Tour Masters 1000,CLAY,2,Andy Murray,Jeremy Chardy,Andy Murray,6-4; 6-3,R32,85,6,0,36,50,28,36,9,14,2,2,9,37,50,1,2,40,54,28,40,6,14,2,5,10,34,54
2015-05-10 00:00:00.000,Internazionali BNL d'Italia Italy ATP World Tour Masters 1000,CLAY,2,David Goffin,Jo-Wilfried Tsonga,David Goffin,6-2; 4-6; 7-5,R32,151,1,2,54,106,34,54,30,52,8,11,15,64,106,6,2,63,104,44,63,17,41,10,15,15,61,104
2015-05-10 00:00:00.000,Internazionali BNL d'Italia Italy ATP World Tour Masters 1000,CLAY,2,Guillermo Garcia-Lopez,Alexandr Dolgopolov,Guillermo Garcia-Lopez,6-4; 6-3,R32,95,4,4,31,63,24,31,13,32,2,4,9,37,63,3,6,52,94,29,52,19,42,10,15,10,48,94
2015-05-10 00:00:00.000,Internazionali BNL d'Italia Italy ATP World Tour Masters 1000,CLAY,2,David Ferrer,Richard Gasquet,David Ferrer,6-4; 7-5,R32,90,1,0,37,63,27,37,17,26,2,3,11,44,63,2,0,40,62,25,40,13,22,5,8,11,38,62
2015-05-10 00:00:00.000,Internazionali BNL d'Italia Italy ATP World Tour Masters 1000,CLAY,2,Stan Wawrinka,Juan Monaco,Stan Wawrinka,4-6; 6-3; 6-2,R32,133,7,1,56,102,40,56,18,46,8,12,14,58,102,1,2,56,81,30,56,11,25,4,10,13,41,81
2015-05-10 00:00:00.000,Internazionali BNL d'Italia Italy ATP World Tour Masters 1000,CLAY,2,Dominic Thiem,Gilles Simon,Dominic Thiem,7-6(5); 2-0 RET,R32,85,3,2,19,43,13,19,13,24,1,3,7,26,43,2,2,27,58,16,27,13,31,3,6,7,29,58
2015-05-10 00:00:00.000,Internazionali BNL d'Italia Italy ATP World Tour Masters 1000,CLAY,2,John Isner,Leonardo Mayer,John Isner,7-6(6); 6-4,R32,94,11,2,41,62,35,41,16,21,0,0,11,51,62,4,2,49,72,40,49,13,23,3,4,11,53,72
2015-05-10 00:00:00.000,Internazionali BNL d'Italia Italy ATP World Tour Masters 1000,CLAY,2,Rafael Nadal,Marsel Ilhan,Rafael Nadal,6-2; 6-0,R32,75,2,1,26,42,24,26,6,16,2,2,7,30,42,4,1,29,55,13,29,11,26,6,11,7,24,55
2015-05-10 00:00:00.000,Internazionali BNL d'Italia Italy ATP World Tour Masters 1000,CLAY,2,Tomas Berdych,Matteo Donati,Tomas Berdych,6-2; 6-4,R32,75,4,1,28,52,24,28,14,24,0,0,9,38,52,8,1,40,61,29,40,6,21,6,9,9,35,61
2015-05-10 00:00:00.000,Internazionali BNL d'Italia Italy ATP World Tour Masters 1000,CLAY,2,Fabio Fognini,Grigor Dimitrov,Fabio Fognini,7-6(9); 4-6; 6-0,R32,138,5,4,64,100,44,64,20,36,7,10,14,64,100,3,1,64,95,46,64,11,31,5,10,14,57,95
2015-05-10 00:00:00.000,Internazionali BNL d'Italia Italy ATP World Tour Masters 1000,CLAY,2,Kevin Anderson,Philipp Kohlschreiber,Kevin Anderson,3-0 RET,R32,16,4,1,8,15,8,8,2,7,0,0,2,10,15,0,0,5,6,2,5,0,1,0,1,1,2,6
2015-05-10 00:00:00.000,Internazionali BNL d'Italia Italy ATP World Tour Masters 1000,CLAY,2,Roger Federer,Pablo Cuevas,Roger Federer,7-6(3); 6-4,R32,81,8,0,36,59,33,36,15,23,0,0,11,48,59,5,0,39,71,26,39,22,32,3,4,11,48,71
2015-05-10 00:00:00.000,Internazionali BNL d'Italia Italy ATP World Tour Masters 1000,CLAY,2,Novak Djokovic,Thomaz Bellucci,Novak Djokovic,5-7; 6-2; 6-3,R16,120,2,0,51,73,42,51,12,22,0,2,15,54,73,6,3,60,94,39,60,17,34,8,12,14,56,94
2015-05-10 00:00:00.000,Internazionali BNL d'Italia Italy ATP World Tour Masters 1000,CLAY,2,Kei Nishikori,Viktor Troicki,Kei Nishikori,6-4; 6-3,R16,89,1,2,38,70,29,38,15,32,2,4,10,44,70,3,1,39,61,21,39,10,22,8,12,9,31,61
2015-05-10 00:00:00.000,Internazionali BNL d'Italia Italy ATP World Tour Masters 1000,CLAY,2,David Goffin,Andy Murray,David Goffin,W/O,R16,0,0,0,0,0,0,0,0,0,0,0,0,0,0,0,0,0,0,0,0,0,0,0,0,0,0,0
2015-05-10 00:00:00.000,Internazionali BNL d'Italia Italy ATP World Tour Masters 1000,CLAY,2,David Ferrer,Guillermo Garcia-Lopez,David Ferrer,6-1; 6-3,R16,86,3,0,32,49,25,32,7,17,2,3,8,32,49,1,2,32,63,19,32,10,31,6,11,8,29,63
2015-05-10 00:00:00.000,Internazionali BNL d'Italia Italy ATP World Tour Masters 1000,CLAY,2,Stan Wawrinka,Dominic Thiem,Stan Wawrinka,7-6(3); 6-4,R16,98,9,3,32,61,30,32,18,29,1,1,11,48,61,5,1,40,75,27,40,20,35,1,2,11,47,75
2015-05-10 00:00:00.000,Internazionali BNL d'Italia Italy ATP World Tour Masters 1000,CLAY,2,Rafael Nadal,John Isner,Rafael Nadal,6-4; 6-4,R16,80,3,3,39,51,35,39,5,12,0,0,10,40,51,7,2,39,56,32,39,5,17,4,6,10,37,56
2015-05-10 00:00:00.000,Internazionali BNL d'Italia Italy ATP World Tour Masters 1000,CLAY,2,Tomas Berdych,Fabio Fognini,Tomas Berdych,6-3; 3-6; 7-6(2),R16,155,10,4,56,110,39,56,31,54,8,10,15,70,110,6,1,48,86,39,48,20,38,2,4,15,59,86
2015-05-10 00:00:00.000,Internazionali BNL d'Italia Italy ATP World Tour Masters 1000,CLAY,2,Roger Federer,Kevin Anderson,Roger Federer,6-3; 7-5,R16,76,5,1,37,59,28,37,12,22,0,2,11,40,59,14,1,41,60,30,41,6,19,4,8,10,36,60
2015-05-10 00:00:00.000,Internazionali BNL d'Italia Italy ATP World Tour Masters 1000,CLAY,2,Novak Djokovic,Kei Nishikori,Novak Djokovic,6-3; 3-6; 6-1,Q,108,3,2,49,72,41,49,11,23,2,3,13,52,72,6,2,46,76,28,46,18,30,3,6,12,46,76
2015-05-10 00:00:00.000,Internazionali BNL d'Italia Italy ATP World Tour Masters 1000,CLAY,2,David Ferrer,David Goffin,David Ferrer,6-2; 4-6; 6-3,Q,129,6,3,46,75,33,46,16,29,2,5,14,49,75,2,3,62,102,41,62,15,40,12,17,13,56,102
2015-05-10 00:00:00.000,Internazionali BNL d'Italia Italy ATP World Tour Masters 1000,CLAY,2,Stan Wawrinka,Rafael Nadal,Stan Wawrinka,7-6(7); 6-2,Q,126,1,2,47,82,30,47,20,35,7,9,10,50,82,1,0,52,74,35,52,8,22,3,7,10,43,74
2015-05-10 00:00:00.000,Internazionali BNL d'Italia Italy ATP World Tour Masters 1000,CLAY,2,Roger Federer,Tomas Berdych,Roger Federer,6-3; 6-3,Q,67,2,0,29,48,25,29,10,19,3,4,9,35,48,3,2,32,46,19,32,7,14,1,5,9,26,46
2015-05-10 00:00:00.000,Internazionali BNL d'Italia Italy ATP World Tour Masters 1000,CLAY,2,Novak Djokovic,David Ferrer,Novak Djokovic,6-4; 6-4,S,95,4,0,49,73,33,49,16,24,3,3,10,49,73,1,1,37,51,29,37,5,14,3,5,10,34,51
2015-05-10 00:00:00.000,Internazionali BNL d'Italia Italy ATP World Tour Masters 1000,CLAY,2,Roger Federer,Stan Wawrinka,Roger Federer,6-4; 6-2,S,55,6,1,35,48,28,35,8,13,1,2,9,36,48,4,2,27,45,19,27,6,18,2,6,9,25,45
2015-05-10 00:00:00.000,Internazionali BNL d'Italia Italy ATP World Tour Masters 1000,CLAY,2,Novak Djokovic,Roger Federer,Novak Djokovic,6-4; 6-3,F,76,5,1,38,53,32,38,10,15,1,1,10,42,53,7,1,39,62,30,39,8,23,3,5,9,38,62
