event_time,event_name,surface,num_of_sets,playerA,playerB,winner,score,round,duration_minutes,a_aces,a_double_faults,a_first_serve_hits,a_first_serve_total,a_first_serve_won,a_first_serve_played,a_second_serve_won,a_second_serve_played,a_break_points_saved,a_break_points_total,a_service_games,a_service_points_won,a_service_points_total,b_aces,b_double_faults,b_first_serve_hits,b_first_serve_total,b_first_serve_won,b_first_serve_played,b_second_serve_won,b_second_serve_played,b_break_points_saved,b_break_points_total,b_service_games,b_service_points_won,b_service_points_total
2013-12-29 00:00:00.000,Brisbane Australia ATP World Tour 250,HARD,2,Roger Federer,N/A Bye,Roger Federer,,R32,0,0,0,0,0,0,0,0,0,0,0,0,0,0,0,0,0,0,0,0,0,0,0,0,0,0,0
2013-12-29 00:00:00.000,Brisbane Australia ATP World Tour 250,HARD,2,Jarkko Nieminen,James Duckworth,Jarkko Nieminen,6-2; 6-3,R32,72,5,3,54,71,36,54,9,17,5,5,9,45,71,9,7,29,51,23,29,6,22,2,5,8,29,51
2013-12-29 00:00:00.000,Brisbane Australia ATP World Tour 250,HARD,2,Marinko Matosevic,Julien Benneteau,Marinko Matosevic,5-7; 6-4; 7-6(4),R32,161,11,3,68,112,43,68,26,44,5,9,17,69,112,14,1,76,117,51,76,18,41,7,11,17,69,117
2013-12-29 00:00:00.000,Brisbane Australia ATP World Tour 250,HARD,2,Sam Querrey,Dmitry Tursunov,Sam Querrey,7-5; 6-4,R32,77,18,1,40,58,36,40,7,18,2,3,11,43,58,4,0,40,63,26,40,12,23,6,9,11,38,63
2013-12-29 00:00:00.000,Brisbane Australia ATP World Tour 250,HARD,2,Pierre-Hugues Herbert,N/A Bye,Pierre-Hugues Herbert,,R32,0,0,0,0,0,0,0,0,0,0,0,0,0,0,0,0,0,0,0,0,0,0,0,0,0,0,0
2013-12-29 00:00:00.000,Brisbane Australia ATP World Tour 250,HARD,2,Sam Groth,Ryan Harrison,Sam Groth,7-6(3); 7-6(2),R32,95,23,2,51,70,46,51,10,19,1,1,12,56,70,5,4,59,86,43,59,15,27,4,4,12,58,86
2013-12-29 00:00:00.000,Brisbane Australia ATP World Tour 250,HARD,2,Nicolas Mahut,Igor Sijsling,Nicolas Mahut,3-6; 6-4; 6-4,R32,107,15,4,59,100,46,59,18,41,4,6,15,64,100,13,2,50,78,43,50,12,28,2,4,14,55,78
2013-12-29 00:00:00.000,Brisbane Australia ATP World Tour 250,HARD,2,Jeremy Chardy,Adrian Mannarino,Jeremy Chardy,7-6(4); 7-5,R32,109,10,2,50,76,34,50,15,26,4,7,12,49,76,4,3,54,88,31,54,17,34,5,9,12,48,88
2013-12-29 00:00:00.000,Brisbane Australia ATP World Tour 250,HARD,2,Feliciano Lopez,Mikhail Kukushkin,Feliciano Lopez,6-4; 6-4,R32,75,13,3,30,55,24,30,14,25,1,3,10,38,55,4,2,28,58,12,28,19,30,2,6,10,31,58
2013-12-29 00:00:00.000,Brisbane Australia ATP World Tour 250,HARD,2,Lleyton Hewitt,Thanasi Kokkinakis,Lleyton Hewitt,6-3; 7-5,R32,101,4,1,32,62,27,32,16,30,3,4,10,43,62,8,5,45,76,29,45,15,31,11,15,11,44,76
2013-12-29 00:00:00.000,Brisbane Australia ATP World Tour 250,HARD,2,Marius Copil,Yuichi Sugita,Marius Copil,7-6(5); 6-7(2); 7-6(7),R32,174,31,2,75,128,66,75,27,53,2,2,18,93,128,4,1,90,126,71,90,22,36,8,8,18,93,126
2013-12-29 00:00:00.000,Brisbane Australia ATP World Tour 250,HARD,2,Gilles Simon,N/A Bye,Gilles Simon,,R32,0,0,0,0,0,0,0,0,0,0,0,0,0,0,0,0,0,0,0,0,0,0,0,0,0,0,0
2013-12-29 00:00:00.000,Brisbane Australia ATP World Tour 250,HARD,2,Grigor Dimitrov,Robin Haase,Grigor Dimitrov,6-2; 6-3,R32,58,6,1,23,43,21,23,15,20,0,0,9,36,43,2,1,39,56,24,39,8,17,5,8,8,32,56
2013-12-29 00:00:00.000,Brisbane Australia ATP World Tour 250,HARD,2,Marin Cilic,Denis Istomin,Marin Cilic,6-7(3); 7-6(5); 6-4,R32,142,14,7,59,111,51,59,27,52,2,2,17,78,111,8,2,56,100,45,56,29,44,2,3,17,74,100
2013-12-29 00:00:00.000,Brisbane Australia ATP World Tour 250,HARD,2,Matthew Ebden,Alex Kuznetsov,Matthew Ebden,6-3; 6-4,R32,73,5,7,40,61,32,40,6,21,1,3,10,38,61,4,1,43,56,24,43,7,13,6,10,9,31,56
2013-12-29 00:00:00.000,Brisbane Australia ATP World Tour 250,HARD,2,Kei Nishikori,N/A Bye,Kei Nishikori,,R32,0,0,0,0,0,0,0,0,0,0,0,0,0,0,0,0,0,0,0,0,0,0,0,0,0,0,0
2013-12-29 00:00:00.000,Brisbane Australia ATP World Tour 250,HARD,2,Roger Federer,Jarkko Nieminen,Roger Federer,6-4; 6-2,R16,68,9,0,34,56,27,34,14,22,4,4,9,41,56,1,4,35,63,21,35,14,28,1,4,9,35,63
2013-12-29 00:00:00.000,Brisbane Australia ATP World Tour 250,HARD,2,Marinko Matosevic,Sam Querrey,Marinko Matosevic,5-7; 7-6(3); 6-4,R16,139,4,3,64,112,46,64,26,48,9,12,17,72,112,19,2,59,101,45,59,23,42,3,6,17,68,101
2013-12-29 00:00:00.000,Brisbane Australia ATP World Tour 250,HARD,2,Sam Groth,Pierre-Hugues Herbert,Sam Groth,4-6; 7-6(3); 7-6(5),R16,146,18,7,62,113,49,62,27,51,5,8,17,76,113,8,6,68,110,51,68,22,42,3,5,17,73,110
2013-12-29 00:00:00.000,Brisbane Australia ATP World Tour 250,HARD,2,Jeremy Chardy,Nicolas Mahut,Jeremy Chardy,7-5; 6-7(4); 6-3,R16,122,10,3,45,85,39,45,26,40,1,3,17,65,85,12,6,53,102,39,53,23,49,4,8,16,62,102
2013-12-29 00:00:00.000,Brisbane Australia ATP World Tour 250,HARD,2,Lleyton Hewitt,Feliciano Lopez,Lleyton Hewitt,7-5; 6-3,R16,99,11,2,43,80,33,43,20,37,9,10,11,53,80,8,8,36,62,29,36,9,26,3,6,10,38,62
2013-12-29 00:00:00.000,Brisbane Australia ATP World Tour 250,HARD,2,Marius Copil,Gilles Simon,Marius Copil,7-5; 6-3,R16,88,10,0,38,66,33,38,16,28,4,4,11,49,66,2,2,32,74,23,32,22,42,4,6,10,45,74
2013-12-29 00:00:00.000,Brisbane Australia ATP World Tour 250,HARD,2,Marin Cilic,Grigor Dimitrov,Marin Cilic,7-5; 7-5,R16,96,16,4,47,77,40,47,16,30,5,5,12,56,77,8,1,42,72,32,42,16,30,4,6,12,48,72
2013-12-29 00:00:00.000,Brisbane Australia ATP World Tour 250,HARD,2,Kei Nishikori,Matthew Ebden,Kei Nishikori,6-2; 6-4,R16,62,1,1,27,48,22,27,15,21,0,0,9,37,48,3,2,26,47,19,26,10,21,3,6,9,29,47
2013-12-29 00:00:00.000,Brisbane Australia ATP World Tour 250,HARD,2,Roger Federer,Marinko Matosevic,Roger Federer,6-1; 6-1,Q,58,9,1,25,41,21,25,9,16,3,3,7,30,41,3,5,30,54,16,30,7,24,4,9,7,23,54
2013-12-29 00:00:00.000,Brisbane Australia ATP World Tour 250,HARD,2,Jeremy Chardy,Sam Groth,Jeremy Chardy,7-5; 6-4,Q,69,7,0,40,52,34,40,11,12,2,2,11,45,52,12,1,41,60,32,41,11,19,3,5,11,43,60
2013-12-29 00:00:00.000,Brisbane Australia ATP World Tour 250,HARD,2,Lleyton Hewitt,Marius Copil,Lleyton Hewitt,6-4; 6-2,Q,72,5,1,25,48,21,25,15,23,2,3,9,36,48,7,3,30,59,22,30,9,29,1,5,9,31,59
2013-12-29 00:00:00.000,Brisbane Australia ATP World Tour 250,HARD,2,Kei Nishikori,Marin Cilic,Kei Nishikori,6-4; 5-7; 6-2,Q,157,6,2,58,105,45,58,26,47,14,15,15,71,105,14,11,52,119,38,52,33,67,12,15,15,71,119
2013-12-29 00:00:00.000,Brisbane Australia ATP World Tour 250,HARD,2,Roger Federer,Jeremy Chardy,Roger Federer,6-3; 6-7(3); 6-3,S,116,20,3,56,95,46,56,23,39,1,1,16,69,95,4,7,43,86,36,43,21,43,1,3,14,57,86
2013-12-29 00:00:00.000,Brisbane Australia ATP World Tour 250,HARD,2,Lleyton Hewitt,Kei Nishikori,Lleyton Hewitt,5-7; 6-4; 6-3,S,150,7,3,45,102,40,45,30,57,6,7,16,70,102,12,6,61,101,44,61,20,40,10,12,15,64,101
2013-12-29 00:00:00.000,Brisbane Australia ATP World Tour 250,HARD,2,Lleyton Hewitt,Roger Federer,Lleyton Hewitt,6-1; 4-6; 6-3,F,127,4,4,50,101,40,50,26,51,9,10,13,66,101,13,0,55,86,38,55,14,31,7,11,13,52,86
2013-12-30 00:00:00.000,Chennai India ATP World Tour 250,HARD,2,Stan Wawrinka,N/A Bye,Stan Wawrinka,,R32,0,0,0,0,0,0,0,0,0,0,0,0,0,0,0,0,0,0,0,0,0,0,0,0,0,0,0
2013-12-30 00:00:00.000,Chennai India ATP World Tour 250,HARD,2,Benjamin Becker,Julian Reister,Benjamin Becker,6-4; 2-1 RET,R32,50,4,2,17,29,13,17,8,12,0,1,6,21,29,1,2,28,46,15,28,9,18,2,5,7,24,46
2013-12-30 00:00:00.000,Chennai India ATP World Tour 250,HARD,2,Aljaz Bedene,Henri Laaksonen,Aljaz Bedene,6-3; 5-7; 7-6(0),R32,149,8,3,66,111,50,66,27,45,6,7,17,77,111,4,8,60,107,48,60,20,47,5,6,16,68,107
2013-12-30 00:00:00.000,Chennai India ATP World Tour 250,HARD,2,Alexander Kudryavtsev,Roberto Bautista Agut,Alexander Kudryavtsev,6-4; 3-6; 6-3,R32,107,0,1,49,84,35,49,21,35,2,4,14,56,84,1,1,53,86,41,53,13,33,4,7,14,54,86
2013-12-30 00:00:00.000,Chennai India ATP World Tour 250,HARD,2,Fabio Fognini,N/A Bye,Fabio Fognini,,R32,0,0,0,0,0,0,0,0,0,0,0,0,0,0,0,0,0,0,0,0,0,0,0,0,0,0,0
2013-12-30 00:00:00.000,Chennai India ATP World Tour 250,HARD,2,Yuki Bhambri,Pablo Carreno Busta,Yuki Bhambri,6-4; 6-3,R32,76,2,2,23,46,18,23,15,23,0,1,9,33,46,3,3,35,61,25,35,10,26,0,4,10,35,61
2013-12-30 00:00:00.000,Chennai India ATP World Tour 250,HARD,2,Yen-Hsun Lu,Tim Smyczek,Yen-Hsun Lu,6-4; 6-2,R32,73,0,3,31,51,22,31,8,20,2,5,9,30,51,0,1,44,61,23,44,4,17,4,10,9,27,61
2013-12-30 00:00:00.000,Chennai India ATP World Tour 250,HARD,2,Vasek Pospisil,Kyle Edmund,Vasek Pospisil,6-3; 7-5,R32,81,4,3,40,63,32,40,15,23,4,4,11,47,63,3,2,47,61,34,47,4,14,4,6,10,38,61
2013-12-30 00:00:00.000,Chennai India ATP World Tour 250,HARD,2,Marcel Granollers,Radu Albot,Marcel Granollers,6-4; 3-6; 6-0,R32,140,1,2,36,69,28,36,17,33,0,2,12,45,69,2,4,56,105,30,56,26,49,14,19,13,56,105
2013-12-30 00:00:00.000,Chennai India ATP World Tour 250,HARD,2,Ramkumar Ramanathan,Somdev Devvarman,Ramkumar Ramanathan,4-6; 6-3; 6-4,R32,142,6,8,59,114,41,59,26,55,5,8,15,67,114,2,1,57,88,37,57,15,31,5,9,14,52,88
2013-12-30 00:00:00.000,Chennai India ATP World Tour 250,HARD,2,Guillermo Garcia-Lopez,Aleksandr Nedovyesov,Guillermo Garcia-Lopez,7-5; 6-0,R32,71,3,2,26,47,20,26,16,21,0,0,9,36,47,1,5,32,59,19,32,12,27,5,9,9,31,59
2013-12-30 00:00:00.000,Chennai India ATP World Tour 250,HARD,2,Benoit Paire,N/A Bye,Benoit Paire,,R32,0,0,0,0,0,0,0,0,0,0,0,0,0,0,0,0,0,0,0,0,0,0,0,0,0,0,0
2013-12-30 00:00:00.000,Chennai India ATP World Tour 250,HARD,2,Edouard Roger-Vasselin,Albert Ramos-Vinolas,Edouard Roger-Vasselin,6-1; 6-3,R32,71,2,2,37,53,23,37,11,16,2,3,8,34,53,1,5,30,55,18,30,6,25,5,10,8,24,55
2013-12-30 00:00:00.000,Chennai India ATP World Tour 250,HARD,2,Jiri Vesely,Jeevan Nedunchezhiyan,Jiri Vesely,7-5; 6-2,R32,83,5,6,32,57,24,32,14,25,2,4,10,38,57,0,3,35,58,16,35,13,23,1,6,10,29,58
2013-12-30 00:00:00.000,Chennai India ATP World Tour 250,HARD,2,Dudi Sela,Lukas Lacko,Dudi Sela,6-4; 6-2,R32,87,2,1,42,67,29,42,14,25,5,6,9,43,67,4,6,46,77,26,46,15,31,6,10,9,41,77
2013-12-30 00:00:00.000,Chennai India ATP World Tour 250,HARD,2,Mikhail Youzhny,N/A Bye,Mikhail Youzhny,,R32,0,0,0,0,0,0,0,0,0,0,0,0,0,0,0,0,0,0,0,0,0,0,0,0,0,0,0
2013-12-30 00:00:00.000,Chennai India ATP World Tour 250,HARD,2,Stan Wawrinka,Benjamin Becker,Stan Wawrinka,6-3; 6-1,R16,55,4,3,29,46,25,29,10,17,4,4,8,35,46,2,3,26,51,14,26,11,25,4,8,8,25,51
2013-12-30 00:00:00.000,Chennai India ATP World Tour 250,HARD,2,Aljaz Bedene,Alexander Kudryavtsev,Aljaz Bedene,1-6; 3-0 RET,R16,43,4,1,16,25,11,16,5,9,0,2,5,16,25,1,0,20,32,14,20,7,12,0,1,5,21,32
2013-12-30 00:00:00.000,Chennai India ATP World Tour 250,HARD,2,Yuki Bhambri,Fabio Fognini,Yuki Bhambri,6-1; 5-5 RET,R16,66,2,2,35,57,25,35,12,22,2,3,9,37,57,1,3,30,45,19,30,7,15,3,6,8,26,45
2013-12-30 00:00:00.000,Chennai India ATP World Tour 250,HARD,2,Vasek Pospisil,Yen-Hsun Lu,Vasek Pospisil,W/O,R16,0,0,0,0,0,0,0,0,0,0,0,0,0,0,0,0,0,0,0,0,0,0,0,0,0,0,0
2013-12-30 00:00:00.000,Chennai India ATP World Tour 250,HARD,2,Marcel Granollers,Ramkumar Ramanathan,Marcel Granollers,6-2; 6-4,R16,71,1,1,29,45,20,29,10,16,1,3,9,30,45,3,6,28,57,18,28,8,29,4,9,9,26,57
2013-12-30 00:00:00.000,Chennai India ATP World Tour 250,HARD,2,Benoit Paire,Guillermo Garcia-Lopez,Benoit Paire,6-1; 6-4,R16,78,5,8,31,75,23,31,22,44,11,12,9,45,75,1,3,29,50,18,29,8,21,2,6,8,26,50
2013-12-30 00:00:00.000,Chennai India ATP World Tour 250,HARD,2,Edouard Roger-Vasselin,Jiri Vesely,Edouard Roger-Vasselin,6-4; 6-4,R16,82,2,2,42,65,29,42,17,23,8,8,10,46,65,6,3,30,57,23,30,15,27,1,3,10,38,57
2013-12-30 00:00:00.000,Chennai India ATP World Tour 250,HARD,2,Dudi Sela,Mikhail Youzhny,Dudi Sela,3-1 RET,R16,24,0,1,8,14,6,8,2,6,2,3,2,8,14,1,1,14,22,6,14,3,8,4,6,2,9,22
2013-12-30 00:00:00.000,Chennai India ATP World Tour 250,HARD,2,Stan Wawrinka,Aljaz Bedene,Stan Wawrinka,6-2; 6-1,Q,66,4,4,32,54,20,32,10,22,5,7,7,30,54,3,4,23,52,9,23,11,29,4,11,8,20,52
2013-12-30 00:00:00.000,Chennai India ATP World Tour 250,HARD,2,Vasek Pospisil,Yuki Bhambri,Vasek Pospisil,6-3; 6-3,Q,71,5,1,33,48,27,33,10,15,0,0,9,37,48,1,3,32,55,20,32,12,23,4,7,9,32,55
2013-12-30 00:00:00.000,Chennai India ATP World Tour 250,HARD,2,Marcel Granollers,Benoit Paire,Marcel Granollers,6-2; 3-6; 7-6(5),Q,133,0,3,75,97,49,75,8,22,6,11,14,57,97,4,3,39,91,30,39,21,52,4,10,15,51,91
2013-12-30 00:00:00.000,Chennai India ATP World Tour 250,HARD,2,Edouard Roger-Vasselin,Dudi Sela,Edouard Roger-Vasselin,7-5; 6-7(6); 6-0,Q,126,3,4,71,114,50,71,20,43,8,10,15,70,114,1,3,51,83,32,51,16,32,2,8,15,48,83
2013-12-30 00:00:00.000,Chennai India ATP World Tour 250,HARD,2,Stan Wawrinka,Vasek Pospisil,Stan Wawrinka,6-4; 5-5 RET,S,111,4,3,51,90,38,51,17,39,9,10,10,55,90,3,5,35,61,25,35,13,26,2,4,10,38,61
2013-12-30 00:00:00.000,Chennai India ATP World Tour 250,HARD,2,Edouard Roger-Vasselin,Marcel Granollers,Edouard Roger-Vasselin,6-2; 4-6; 6-3,S,122,3,0,55,78,38,55,13,23,3,6,14,51,78,4,3,40,85,26,40,21,45,11,16,13,47,85
2013-12-30 00:00:00.000,Chennai India ATP World Tour 250,HARD,2,Stan Wawrinka,Edouard Roger-Vasselin,Stan Wawrinka,7-5; 6-2,F,96,5,2,35,63,25,35,20,28,1,1,10,45,63,1,1,54,79,36,54,9,25,5,8,10,45,79
2013-12-30 00:00:00.000,Doha Qatar ATP World Tour 250,HARD,2,Rafael Nadal,Lukas Rosol,Rafael Nadal,6-2; 7-6(7),R32,104,3,3,52,76,35,52,14,24,4,5,10,49,76,3,2,48,84,27,48,19,36,3,6,10,46,84
2013-12-30 00:00:00.000,Doha Qatar ATP World Tour 250,HARD,2,Tobias Kamke,Malek Jaziri,Tobias Kamke,6-3; 6-4,R32,71,2,2,40,60,28,40,13,20,5,6,10,41,60,0,5,25,46,22,25,6,21,0,3,9,28,46
2013-12-30 00:00:00.000,Doha Qatar ATP World Tour 250,HARD,2,Lukasz Kubot,Daniel Gimeno-Traver,Lukasz Kubot,6-4; 6-3,R32,79,0,2,39,62,27,39,11,23,0,2,10,38,62,2,0,39,59,24,39,9,20,7,11,9,33,59
2013-12-30 00:00:00.000,Doha Qatar ATP World Tour 250,HARD,2,Ernests Gulbis,Daniel Evans,Ernests Gulbis,6-2; 4-6; 6-0,R32,90,9,3,39,66,30,39,12,27,2,5,12,42,66,3,5,46,79,18,46,19,33,6,13,12,37,79
2013-12-30 00:00:00.000,Doha Qatar ATP World Tour 250,HARD,2,Ivo Karlovic,Tomas Berdych,Ivo Karlovic,7-6(7); 7-6(4),R32,107,24,2,54,83,45,54,17,29,2,2,12,62,83,8,2,43,74,37,43,20,31,1,1,12,57,74
2013-12-30 00:00:00.000,Doha Qatar ATP World Tour 250,HARD,2,Dustin Brown,Ivan Dodig,Dustin Brown,6-4; 6-2,R32,56,5,3,30,47,25,30,10,17,1,2,9,35,47,6,3,32,58,19,32,10,26,3,7,9,29,58
2013-12-30 00:00:00.000,Doha Qatar ATP World Tour 250,HARD,2,Peter Gojowczyk,Dominic Thiem,Peter Gojowczyk,7-5; 6-0,R32,65,3,0,31,53,22,31,17,22,1,1,9,39,53,2,6,30,55,18,30,9,25,4,8,9,27,55
2013-12-30 00:00:00.000,Doha Qatar ATP World Tour 250,HARD,2,Philipp Kohlschreiber,Pablo Andujar,Philipp Kohlschreiber,7-6(7); 6-2,R32,96,2,4,37,71,25,37,16,34,4,8,10,41,71,0,5,35,67,19,35,12,32,3,9,10,31,67
2013-12-30 00:00:00.000,Doha Qatar ATP World Tour 250,HARD,2,Fernando Verdasco,Filippo Volandri,Fernando Verdasco,6-3; 6-3,R32,67,3,3,42,57,33,42,6,15,5,6,9,39,57,0,1,38,55,20,38,8,17,3,7,9,28,55
2013-12-30 00:00:00.000,Doha Qatar ATP World Tour 250,HARD,2,Victor Hanescu,Joao Sousa,Victor Hanescu,6-3; 6-2,R32,67,11,1,35,50,27,35,10,15,1,1,9,37,50,1,2,31,48,19,31,6,17,3,6,8,25,48
2013-12-30 00:00:00.000,Doha Qatar ATP World Tour 250,HARD,2,Florian Mayer,Michal Przysiezny,Florian Mayer,6-2; 3-6; 7-6(5),R32,125,6,0,64,99,42,64,17,35,6,10,14,59,99,8,5,57,101,41,57,19,44,7,12,15,60,101
2013-12-30 00:00:00.000,Doha Qatar ATP World Tour 250,HARD,2,Andy Murray,Mousa Shanan Zayed,Andy Murray,6-0; 6-0,R32,37,3,3,20,32,20,20,4,12,0,0,6,24,32,0,2,16,34,4,16,5,18,3,9,6,9,34
2013-12-30 00:00:00.000,Doha Qatar ATP World Tour 250,HARD,2,Richard Gasquet,Karim Hossam,Richard Gasquet,7-5; 6-1,R32,68,0,0,36,51,28,36,7,15,2,5,10,35,51,3,0,27,49,14,27,9,22,1,7,9,23,49
2013-12-30 00:00:00.000,Doha Qatar ATP World Tour 250,HARD,2,Gael Monfils,Santiago Giraldo,Gael Monfils,7-6(1); 6-2,R32,78,9,3,37,55,32,37,12,18,0,0,10,44,55,2,0,42,68,27,42,13,26,7,9,10,40,68
2013-12-30 00:00:00.000,Doha Qatar ATP World Tour 250,HARD,2,Daniel Brands,Nikolay Davydenko,Daniel Brands,6-4; 6-4,R32,80,8,1,54,74,37,54,14,20,5,5,10,51,74,0,5,51,66,34,51,5,15,5,7,10,39,66
2013-12-30 00:00:00.000,Doha Qatar ATP World Tour 250,HARD,2,David Ferrer,Alexandr Dolgopolov,David Ferrer,6-3; 5-7; 6-3,R32,124,2,1,66,92,42,66,13,26,5,9,15,55,92,2,1,63,98,37,63,15,35,5,11,15,52,98
2013-12-30 00:00:00.000,Doha Qatar ATP World Tour 250,HARD,2,Rafael Nadal,Tobias Kamke,Rafael Nadal,6-3; 6-7(3); 6-3,R16,146,5,0,68,92,50,68,15,24,1,2,16,65,92,3,6,54,100,39,54,23,46,9,12,14,62,100
2013-12-30 00:00:00.000,Doha Qatar ATP World Tour 250,HARD,2,Ernests Gulbis,Lukasz Kubot,Ernests Gulbis,6-2; 4-6; 6-3,R16,129,12,3,64,87,44,64,14,23,3,5,14,58,87,1,3,65,105,38,65,21,40,12,16,13,59,105
2013-12-30 00:00:00.000,Doha Qatar ATP World Tour 250,HARD,2,Dustin Brown,Ivo Karlovic,Dustin Brown,3-6; 7-6(13); 6-4,R16,109,4,4,61,91,47,61,18,30,0,2,15,65,91,21,3,80,110,61,80,13,30,4,6,16,74,110
2013-12-30 00:00:00.000,Doha Qatar ATP World Tour 250,HARD,2,Peter Gojowczyk,Philipp Kohlschreiber,Peter Gojowczyk,7-6(4); 7-6(7),R16,101,7,0,47,80,36,47,20,33,1,3,12,56,80,4,0,47,81,32,47,21,34,0,2,12,53,81
2013-12-30 00:00:00.000,Doha Qatar ATP World Tour 250,HARD,2,Victor Hanescu,Fernando Verdasco,Victor Hanescu,4-6; 7-6(0); 6-2,R16,117,3,0,76,96,57,76,11,20,3,4,15,68,96,4,4,60,85,42,60,16,25,1,3,15,58,85
2013-12-30 00:00:00.000,Doha Qatar ATP World Tour 250,HARD,2,Florian Mayer,Andy Murray,Florian Mayer,3-6; 6-4; 6-2,R16,112,4,1,57,87,38,57,19,30,7,10,14,57,87,5,3,45,83,28,45,21,38,5,9,13,49,83
2013-12-30 00:00:00.000,Doha Qatar ATP World Tour 250,HARD,2,Gael Monfils,Richard Gasquet,Gael Monfils,6-2; 7-5,R16,63,9,2,37,53,32,37,8,16,0,1,10,40,53,0,1,51,59,28,51,6,8,3,7,10,34,59
2013-12-30 00:00:00.000,Doha Qatar ATP World Tour 250,HARD,2,Daniel Brands,David Ferrer,Daniel Brands,6-4; 7-5,R16,75,5,0,42,57,33,42,10,15,2,3,11,43,57,2,1,48,66,31,48,9,18,4,7,11,40,66
2013-12-30 00:00:00.000,Doha Qatar ATP World Tour 250,HARD,2,Rafael Nadal,Ernests Gulbis,Rafael Nadal,7-5; 6-4,Q,115,3,0,58,72,37,58,9,14,3,5,11,46,72,9,3,45,72,33,45,10,27,4,8,11,43,72
2013-12-30 00:00:00.000,Doha Qatar ATP World Tour 250,HARD,2,Peter Gojowczyk,Dustin Brown,Peter Gojowczyk,6-3; 3-6; 7-6(5),Q,117,4,2,60,110,41,60,24,50,11,15,15,65,110,9,4,70,110,43,70,19,40,4,8,15,62,110
2013-12-30 00:00:00.000,Doha Qatar ATP World Tour 250,HARD,2,Florian Mayer,Victor Hanescu,Florian Mayer,6-4; 6-7(8); 6-4,Q,135,4,3,58,99,40,58,25,41,4,6,16,65,99,6,2,84,111,55,84,12,27,7,11,16,67,111
2013-12-30 00:00:00.000,Doha Qatar ATP World Tour 250,HARD,2,Gael Monfils,Daniel Brands,Gael Monfils,6-2; 6-1,Q,49,6,2,32,42,27,32,5,10,0,0,8,32,42,2,0,29,42,15,29,4,13,3,7,7,19,42
2013-12-30 00:00:00.000,Doha Qatar ATP World Tour 250,HARD,2,Rafael Nadal,Peter Gojowczyk,Rafael Nadal,4-6; 6-2; 6-3,S,120,5,2,46,72,35,46,11,26,1,4,13,46,72,1,4,46,84,29,46,17,38,10,16,14,46,84
2013-12-30 00:00:00.000,Doha Qatar ATP World Tour 250,HARD,2,Gael Monfils,Florian Mayer,Gael Monfils,6-3; 6-2,S,55,9,4,38,50,29,38,5,12,1,2,9,34,50,1,1,35,52,19,35,7,17,6,10,8,26,52
2013-12-30 00:00:00.000,Doha Qatar ATP World Tour 250,HARD,2,Rafael Nadal,Gael Monfils,Rafael Nadal,6-1; 6-7(5); 6-2,F,120,2,0,63,82,46,63,16,19,4,5,14,62,82,13,4,63,87,42,63,11,24,6,11,13,53,87
2014-01-06 00:00:00.000,Auckland New Zealand ATP World Tour 250,HARD,2,David Ferrer,N/A Bye,David Ferrer,,R32,0,0,0,0,0,0,0,0,0,0,0,0,0,0,0,0,0,0,0,0,0,0,0,0,0,0,0
2014-01-06 00:00:00.000,Auckland New Zealand ATP World Tour 250,HARD,2,Donald Young,Federico Delbonis,Donald Young,7-5; 6-2,R32,86,2,4,41,59,33,41,9,18,2,3,10,42,59,2,2,59,82,33,59,12,23,9,13,10,45,82
2014-01-06 00:00:00.000,Auckland New Zealand ATP World Tour 250,HARD,2,Santiago Giraldo,Albert Montanes,Santiago Giraldo,6-1; 7-6(3),R32,75,10,2,38,63,30,38,11,25,2,3,9,41,63,1,4,38,68,27,38,10,30,6,10,10,37,68
2014-01-06 00:00:00.000,Auckland New Zealand ATP World Tour 250,HARD,2,Guillermo Garcia-Lopez,Robin Haase,Guillermo Garcia-Lopez,4-6; 7-5; 7-6(4),R32,131,4,6,55,107,41,55,27,52,4,7,17,68,107,7,4,72,100,54,72,10,28,0,3,17,64,100
2014-01-06 00:00:00.000,Auckland New Zealand ATP World Tour 250,HARD,2,Kevin Anderson,N/A Bye,Kevin Anderson,,R32,0,0,0,0,0,0,0,0,0,0,0,0,0,0,0,0,0,0,0,0,0,0,0,0,0,0,0
2014-01-06 00:00:00.000,Auckland New Zealand ATP World Tour 250,HARD,2,Steve Johnson,Marcos Baghdatis,Steve Johnson,7-5; 6-7(3); 6-4,R32,122,13,2,59,103,44,59,28,44,1,2,17,72,103,8,7,63,105,47,63,22,42,4,7,17,69,105
2014-01-06 00:00:00.000,Auckland New Zealand ATP World Tour 250,HARD,2,Yen-Hsun Lu,Igor Sijsling,Yen-Hsun Lu,7-5; 7-6(7),R32,85,3,2,49,76,34,49,16,27,1,3,12,50,76,11,2,36,76,30,36,18,40,4,7,12,48,76
2014-01-06 00:00:00.000,Auckland New Zealand ATP World Tour 250,HARD,2,Bradley Klahn,Daniel Brands,Bradley Klahn,7-5; 4-6; 6-3,R32,112,12,2,76,103,56,76,13,27,6,7,16,69,103,8,4,83,110,56,83,12,27,13,15,15,68,110
2014-01-06 00:00:00.000,Auckland New Zealand ATP World Tour 250,HARD,2,Philipp Kohlschreiber,Pablo Carreno Busta,Philipp Kohlschreiber,6-2; 3-6; 7-5,R32,99,9,0,46,74,34,46,16,28,0,2,14,50,74,4,5,56,88,40,56,14,32,3,7,15,54,88
2014-01-06 00:00:00.000,Auckland New Zealand ATP World Tour 250,HARD,2,Horacio Zeballos,Filippo Volandri,Horacio Zeballos,6-0; 7-6(1),R32,81,5,6,41,71,30,41,12,30,3,5,9,42,71,2,2,41,64,23,41,7,23,4,9,9,30,64
2014-01-06 00:00:00.000,Auckland New Zealand ATP World Tour 250,HARD,2,Lukas Lacko,Jose (Rubin) Statham,Lukas Lacko,6-3; 6-1,R32,70,7,2,32,53,24,32,11,21,4,4,8,35,53,3,3,44,66,25,44,7,22,7,11,8,32,66
2014-01-06 00:00:00.000,Auckland New Zealand ATP World Tour 250,HARD,2,John Isner,N/A Bye,John Isner,,R32,0,0,0,0,0,0,0,0,0,0,0,0,0,0,0,0,0,0,0,0,0,0,0,0,0,0,0
2014-01-06 00:00:00.000,Auckland New Zealand ATP World Tour 250,HARD,2,Benoit Paire,Michal Przysiezny,Benoit Paire,6-4; 6-2,R32,49,12,2,23,42,21,23,15,19,0,0,9,36,42,2,2,33,57,24,33,11,24,3,6,9,35,57
2014-01-06 00:00:00.000,Auckland New Zealand ATP World Tour 250,HARD,2,Roberto Bautista Agut,Daniel Gimeno-Traver,Roberto Bautista Agut,6-1; 3-6; 6-4,R32,96,1,1,54,76,41,54,12,22,2,4,13,53,76,1,2,46,87,30,46,20,41,4,8,13,50,87
2014-01-06 00:00:00.000,Auckland New Zealand ATP World Tour 250,HARD,2,Jack Sock,Adrian Mannarino,Jack Sock,6-3; 6-4,R32,62,11,3,35,58,27,35,16,23,2,2,10,43,58,0,1,34,51,24,34,9,17,1,3,9,33,51
2014-01-06 00:00:00.000,Auckland New Zealand ATP World Tour 250,HARD,2,Tommy Haas,N/A Bye,Tommy Haas,,R32,0,0,0,0,0,0,0,0,0,0,0,0,0,0,0,0,0,0,0,0,0,0,0,0,0,0,0
2014-01-06 00:00:00.000,Auckland New Zealand ATP World Tour 250,HARD,2,David Ferrer,Donald Young,David Ferrer,6-7(5); 6-3; 6-1,R16,115,3,4,65,103,45,65,18,38,10,13,14,63,103,1,2,60,89,35,60,12,29,6,13,14,47,89
2014-01-06 00:00:00.000,Auckland New Zealand ATP World Tour 250,HARD,2,Guillermo Garcia-Lopez,Santiago Giraldo,Guillermo Garcia-Lopez,6-7(7); 6-2; 6-3,R16,143,8,4,76,118,50,76,19,42,15,19,15,69,118,5,2,50,94,29,50,20,44,5,12,14,49,94
2014-01-06 00:00:00.000,Auckland New Zealand ATP World Tour 250,HARD,2,Steve Johnson,Kevin Anderson,Steve Johnson,7-5; 6-4,R16,77,6,3,43,68,34,43,14,25,1,1,11,48,68,11,2,34,57,23,34,17,23,4,6,11,40,57
2014-01-06 00:00:00.000,Auckland New Zealand ATP World Tour 250,HARD,2,Yen-Hsun Lu,Bradley Klahn,Yen-Hsun Lu,6-7(3); 6-2; 6-3,R16,110,1,2,69,98,51,69,15,29,6,7,15,66,98,8,1,51,80,38,51,15,29,2,6,14,53,80
2014-01-06 00:00:00.000,Auckland New Zealand ATP World Tour 250,HARD,2,Philipp Kohlschreiber,Horacio Zeballos,Philipp Kohlschreiber,6-4; 6-2,R16,62,13,1,26,41,24,26,12,15,0,0,9,36,41,3,2,37,62,27,37,7,25,7,10,9,34,62
2014-01-06 00:00:00.000,Auckland New Zealand ATP World Tour 250,HARD,2,John Isner,Lukas Lacko,John Isner,7-6(1); 3-6; 6-2,R16,111,21,2,63,85,49,63,11,22,2,3,14,60,85,5,3,53,102,36,53,28,49,6,8,15,64,102
2014-01-06 00:00:00.000,Auckland New Zealand ATP World Tour 250,HARD,2,Roberto Bautista Agut,Benoit Paire,Roberto Bautista Agut,6-3; 6-4,R16,66,1,0,50,63,34,50,10,13,2,3,10,44,63,9,3,29,54,21,29,10,25,1,4,9,31,54
2014-01-06 00:00:00.000,Auckland New Zealand ATP World Tour 250,HARD,2,Jack Sock,Tommy Haas,Jack Sock,6-4; 6-4,R16,73,7,5,30,57,24,30,15,27,1,2,10,39,57,3,1,32,57,23,32,14,25,2,5,10,37,57
2014-01-06 00:00:00.000,Auckland New Zealand ATP World Tour 250,HARD,2,David Ferrer,Guillermo Garcia-Lopez,David Ferrer,6-3; 5-7; 6-4,Q,131,1,3,72,102,48,72,15,30,7,10,16,63,102,2,0,44,81,32,44,19,37,0,4,15,51,81
2014-01-06 00:00:00.000,Auckland New Zealand ATP World Tour 250,HARD,2,Yen-Hsun Lu,Steve Johnson,Yen-Hsun Lu,6-4; 6-4,Q,72,0,0,44,58,33,44,9,14,4,5,10,42,58,8,3,42,71,29,42,13,29,3,6,10,42,71
2014-01-06 00:00:00.000,Auckland New Zealand ATP World Tour 250,HARD,2,John Isner,Philipp Kohlschreiber,John Isner,6-7(4); 7-6(4); 7-6(5),Q,145,18,2,93,112,77,93,14,19,3,3,18,91,112,8,1,87,140,61,87,40,53,7,7,18,101,140
2014-01-06 00:00:00.000,Auckland New Zealand ATP World Tour 250,HARD,2,Roberto Bautista Agut,Jack Sock,Roberto Bautista Agut,6-1; 6-3,Q,63,1,2,41,55,31,41,8,14,6,6,8,39,55,4,2,30,50,21,30,5,20,4,8,8,26,50
2014-01-06 00:00:00.000,Auckland New Zealand ATP World Tour 250,HARD,2,Yen-Hsun Lu,David Ferrer,Yen-Hsun Lu,6-4; 7-6(4),S,88,4,6,46,74,35,46,12,28,3,5,11,47,74,3,0,53,75,35,53,12,22,8,11,11,47,75
2014-01-06 00:00:00.000,Auckland New Zealand ATP World Tour 250,HARD,2,John Isner,Roberto Bautista Agut,John Isner,3-6; 7-6(2); 6-4,S,110,17,2,57,86,46,57,15,29,1,3,15,61,86,5,1,74,102,49,74,19,28,5,7,16,68,102
2014-01-06 00:00:00.000,Auckland New Zealand ATP World Tour 250,HARD,2,John Isner,Yen-Hsun Lu,John Isner,7-6(4); 7-6(7),F,101,23,4,59,80,51,59,11,21,1,1,12,62,80,5,1,62,93,45,62,19,31,10,10,12,64,93
2014-01-06 00:00:00.000,Sydney Australia ATP World Tour 250,HARD,2,Juan Martin Del Potro,N/A Bye,Juan Martin Del Potro,,R32,0,0,0,0,0,0,0,0,0,0,0,0,0,0,0,0,0,0,0,0,0,0,0,0,0,0,0
2014-01-06 00:00:00.000,Sydney Australia ATP World Tour 250,HARD,2,Nicolas Mahut,Ryan Harrison,Nicolas Mahut,7-6(2); 7-5,R32,107,12,0,47,72,38,47,12,25,0,1,12,50,72,6,5,56,92,40,56,13,36,4,6,12,53,92
2014-01-06 00:00:00.000,Sydney Australia ATP World Tour 250,HARD,2,Radek Stepanek,Sam Groth,Radek Stepanek,6-7(6); 7-6(5); 6-2,R32,135,5,2,84,110,64,84,16,26,3,3,16,80,110,18,5,65,107,49,65,22,42,9,11,16,71,107
2014-01-06 00:00:00.000,Sydney Australia ATP World Tour 250,HARD,2,Albert Ramos-Vinolas,Sam Querrey,Albert Ramos-Vinolas,4-6; 6-3; 6-4,R32,122,7,2,67,96,46,67,16,29,5,6,14,62,96,16,1,66,104,48,66,17,38,11,14,15,65,104
2014-01-06 00:00:00.000,Sydney Australia ATP World Tour 250,HARD,2,Dmitry Tursunov,N/A Bye,Dmitry Tursunov,,R32,0,0,0,0,0,0,0,0,0,0,0,0,0,0,0,0,0,0,0,0,0,0,0,0,0,0,0
2014-01-06 00:00:00.000,Sydney Australia ATP World Tour 250,HARD,2,Lukas Rosol,Joao Sousa,Lukas Rosol,7-6(5); 4-6; 7-6(1),R32,128,7,7,60,117,42,60,31,57,6,10,17,73,117,6,2,59,105,39,59,24,46,2,5,17,63,105
2014-01-06 00:00:00.000,Sydney Australia ATP World Tour 250,HARD,2,Denis Istomin,Pablo Andujar,Denis Istomin,6-1; 6-2,R32,58,5,3,29,45,25,29,8,16,0,0,8,33,45,2,4,26,43,16,26,5,17,4,8,7,21,43
2014-01-06 00:00:00.000,Sydney Australia ATP World Tour 250,HARD,2,Marin Cilic,Jan-Lennard Struff,Marin Cilic,3-6; 6-3; 6-3,R32,103,8,3,41,78,35,41,19,37,2,3,13,54,78,7,3,57,85,38,57,15,28,2,5,14,53,85
2014-01-06 00:00:00.000,Sydney Australia ATP World Tour 250,HARD,2,Julien Benneteau,Matthew Ebden,Julien Benneteau,6-2; 6-2,R32,57,4,0,28,41,22,28,10,13,0,0,8,32,41,6,5,27,51,16,27,9,24,4,8,8,25,51
2014-01-06 00:00:00.000,Sydney Australia ATP World Tour 250,HARD,2,Sergiy Stakhovsky,Carlos Berlocq,Sergiy Stakhovsky,6-3; 6-4,R32,71,2,1,30,45,27,30,7,15,1,2,9,34,45,3,1,37,64,23,37,11,27,3,7,10,34,64
2014-01-06 00:00:00.000,Sydney Australia ATP World Tour 250,HARD,2,Marinko Matosevic,Florian Mayer,Marinko Matosevic,6-2; 4-6; 6-3,R32,101,5,4,54,86,42,54,15,32,4,7,14,57,86,4,1,40,71,27,40,12,31,2,7,13,39,71
2014-01-06 00:00:00.000,Sydney Australia ATP World Tour 250,HARD,2,Andreas Seppi,N/A Bye,Andreas Seppi,,R32,0,0,0,0,0,0,0,0,0,0,0,0,0,0,0,0,0,0,0,0,0,0,0,0,0,0,0
2014-01-06 00:00:00.000,Sydney Australia ATP World Tour 250,HARD,2,Bernard Tomic,Marcel Granollers,Bernard Tomic,6-3; 6-0,R32,60,3,0,35,51,25,35,10,16,7,8,8,35,51,0,2,27,40,13,27,3,13,3,8,7,16,40
2014-01-06 00:00:00.000,Sydney Australia ATP World Tour 250,HARD,2,Blaz Kavcic,Jarkko Nieminen,Blaz Kavcic,6-4; 6-3,R32,78,5,2,40,58,28,40,8,18,4,6,9,36,58,1,3,36,62,18,36,14,26,5,10,10,32,62
2014-01-06 00:00:00.000,Sydney Australia ATP World Tour 250,HARD,2,Alexandr Dolgopolov,Edouard Roger-Vasselin,Alexandr Dolgopolov,6-3 RET,R32,29,6,0,15,23,13,15,7,8,0,0,5,20,23,2,0,17,26,10,17,5,9,2,3,4,15,26
2014-01-06 00:00:00.000,Sydney Australia ATP World Tour 250,HARD,2,Jerzy Janowicz,N/A Bye,Jerzy Janowicz,,R32,0,0,0,0,0,0,0,0,0,0,0,0,0,0,0,0,0,0,0,0,0,0,0,0,0,0,0
2014-01-06 00:00:00.000,Sydney Australia ATP World Tour 250,HARD,2,Juan Martin Del Potro,Nicolas Mahut,Juan Martin Del Potro,1-6; 6-3; 6-4,R16,111,15,2,58,88,41,58,15,30,2,4,13,56,88,11,1,42,73,36,42,15,31,3,5,13,51,73
2014-01-06 00:00:00.000,Sydney Australia ATP World Tour 250,HARD,2,Radek Stepanek,Albert Ramos-Vinolas,Radek Stepanek,6-2; 7-6(5),R16,91,10,2,38,58,29,38,13,20,3,5,10,42,58,1,2,45,71,29,45,9,26,3,7,10,38,71
2014-01-06 00:00:00.000,Sydney Australia ATP World Tour 250,HARD,2,Dmitry Tursunov,Lukas Rosol,Dmitry Tursunov,3-6; 6-3; 6-3,R16,91,6,1,59,78,42,59,11,19,7,8,13,53,78,17,4,47,89,39,47,16,42,3,6,14,55,89
2014-01-06 00:00:00.000,Sydney Australia ATP World Tour 250,HARD,2,Denis Istomin,Marin Cilic,Denis Istomin,6-3; 6-4,R16,77,2,0,39,64,34,39,12,25,2,2,10,46,64,8,1,37,54,27,37,6,17,1,3,9,33,54
2014-01-06 00:00:00.000,Sydney Australia ATP World Tour 250,HARD,2,Sergiy Stakhovsky,Julien Benneteau,Sergiy Stakhovsky,6-3; 6-2,R16,67,9,4,34,54,26,34,8,20,2,3,8,34,54,6,2,32,50,17,32,5,18,2,7,9,22,50
2014-01-06 00:00:00.000,Sydney Australia ATP World Tour 250,HARD,2,Marinko Matosevic,Andreas Seppi,Marinko Matosevic,6-3; 6-4,R16,72,7,1,33,54,28,33,14,21,1,1,10,42,54,3,1,34,58,24,34,12,24,6,8,9,36,58
2014-01-06 00:00:00.000,Sydney Australia ATP World Tour 250,HARD,2,Bernard Tomic,Blaz Kavcic,Bernard Tomic,6-3; 4-6; 6-4,R16,122,8,0,56,80,42,56,16,24,0,1,15,58,80,9,2,76,103,51,76,13,27,8,10,14,64,103
2014-01-06 00:00:00.000,Sydney Australia ATP World Tour 250,HARD,2,Alexandr Dolgopolov,Jerzy Janowicz,Alexandr Dolgopolov,6-2; 6-2,R16,57,3,0,26,39,23,26,9,13,0,0,8,32,39,4,5,33,56,22,33,6,23,6,10,8,28,56
2014-01-06 00:00:00.000,Sydney Australia ATP World Tour 250,HARD,2,Juan Martin Del Potro,Radek Stepanek,Juan Martin Del Potro,6-4; 3-6; 6-3,Q,129,14,3,64,97,46,64,14,33,7,10,14,60,97,3,3,39,81,26,39,23,42,3,7,14,49,81
2014-01-06 00:00:00.000,Sydney Australia ATP World Tour 250,HARD,2,Dmitry Tursunov,Denis Istomin,Dmitry Tursunov,7-6(5); 6-2,Q,96,6,3,45,76,35,45,16,31,3,3,10,51,76,9,4,55,78,37,55,9,23,7,9,10,46,78
2014-01-06 00:00:00.000,Sydney Australia ATP World Tour 250,HARD,2,Sergiy Stakhovsky,Marinko Matosevic,Sergiy Stakhovsky,6-4; 6-3,Q,73,7,3,46,65,32,46,9,19,2,3,9,41,65,2,2,36,57,27,36,5,21,3,7,10,32,57
2014-01-06 00:00:00.000,Sydney Australia ATP World Tour 250,HARD,2,Bernard Tomic,Alexandr Dolgopolov,Bernard Tomic,6-4; 6-3,Q,66,7,1,39,57,26,39,12,18,2,4,10,38,57,10,0,34,56,25,34,6,22,6,10,9,31,56
2014-01-06 00:00:00.000,Sydney Australia ATP World Tour 250,HARD,2,Juan Martin Del Potro,Dmitry Tursunov,Juan Martin Del Potro,6-4; 6-2,S,65,9,0,26,43,24,26,13,17,1,1,9,37,43,3,1,35,51,24,35,6,16,2,5,9,30,51
2014-01-06 00:00:00.000,Sydney Australia ATP World Tour 250,HARD,2,Bernard Tomic,Sergiy Stakhovsky,Bernard Tomic,6-7(4); 7-5; 6-3,S,134,8,0,70,108,52,70,21,38,7,8,16,73,108,11,6,51,106,38,51,29,55,6,10,17,67,106
2014-01-06 00:00:00.000,Sydney Australia ATP World Tour 250,HARD,2,Juan Martin Del Potro,Bernard Tomic,Juan Martin Del Potro,6-3; 6-1,F,54,8,0,24,38,20,24,12,14,0,0,8,32,38,2,1,30,42,18,30,3,12,2,6,8,21,42
2014-01-13 00:00:00.000,Australian Open Australia Grand Slams,HARD,3,Rafael Nadal,Bernard Tomic,Rafael Nadal,6-4 RET,R128,41,5,1,16,26,14,16,6,10,0,0,5,20,26,3,1,19,28,15,19,3,9,0,1,5,18,28
2014-01-13 00:00:00.000,Australian Open Australia Grand Slams,HARD,3,Thanasi Kokkinakis,Igor Sijsling,Thanasi Kokkinakis,7-6(4); 0-6; 7-6(3); 6-2,R128,182,6,9,79,147,55,79,36,68,5,9,19,91,147,20,4,73,123,57,73,22,50,2,5,19,79,123
2014-01-13 00:00:00.000,Australian Open Australia Grand Slams,HARD,3,Jack Sock,Tobias Kamke,Jack Sock,7-6(5); 5-7; 6-2; 6-4,R128,242,16,12,74,148,54,74,43,74,10,12,21,97,148,6,8,66,136,51,66,36,70,6,10,21,87,136
2014-01-13 00:00:00.000,Australian Open Australia Grand Slams,HARD,3,Gael Monfils,Ryan Harrison,Gael Monfils,6-4; 6-4; 6-4,R128,111,10,5,51,78,44,51,17,27,0,0,15,61,78,2,1,57,93,42,57,17,36,1,4,15,59,93
2014-01-13 00:00:00.000,Australian Open Australia Grand Slams,HARD,3,Andreas Seppi,Lleyton Hewitt,Andreas Seppi,7-6(4); 6-3; 5-7; 5-7; 7-5,R128,258,17,5,103,176,72,103,40,73,6,13,29,112,176,23,5,90,177,76,90,38,87,11,18,28,114,177
2014-01-13 00:00:00.000,Australian Open Australia Grand Slams,HARD,3,Donald Young,Robin Haase,Donald Young,6-7(4); 7-6(2); 6-2; 1-0 RET,R128,154,0,5,77,106,58,77,16,29,3,4,16,74,106,11,6,81,124,55,81,19,43,5,7,15,74,124
2014-01-13 00:00:00.000,Australian Open Australia Grand Slams,HARD,3,Dusan Lajovic,Lucas Pouille,Dusan Lajovic,6-4; 7-6(9); 4-6; 6-3,R128,183,7,7,80,132,53,80,30,52,4,8,21,83,132,2,10,84,135,56,84,21,51,5,10,20,77,135
2014-01-13 00:00:00.000,Australian Open Australia Grand Slams,HARD,3,Kei Nishikori,Marinko Matosevic,Kei Nishikori,6-3; 5-7; 6-2; 4-6; 6-2,R128,221,6,5,96,143,69,96,26,47,6,9,23,95,143,13,9,103,172,68,103,30,69,8,15,24,98,172
2014-01-13 00:00:00.000,Australian Open Australia Grand Slams,HARD,3,Milos Raonic,Daniel Gimeno-Traver,Milos Raonic,7-6(2); 6-1; 4-6; 6-2,R128,144,21,7,65,101,56,65,17,36,3,6,18,73,101,5,5,69,122,43,69,25,53,13,20,19,68,122
2014-01-13 00:00:00.000,Australian Open Australia Grand Slams,HARD,3,Victor Hanescu,Peter Gojowczyk,Victor Hanescu,7-6(5); 7-6(5); 6-3,R128,136,8,4,78,120,59,78,24,42,5,6,17,83,120,7,6,57,104,44,57,22,47,5,7,16,66,104
2014-01-13 00:00:00.000,Australian Open Australia Grand Slams,HARD,3,Yen-Hsun Lu,Jimmy Wang,Yen-Hsun Lu,6-3; 6-2; 6-1,R128,108,9,5,47,76,33,47,11,29,4,7,12,44,76,1,3,64,101,32,64,12,37,10,19,12,44,101
2014-01-13 00:00:00.000,Australian Open Australia Grand Slams,HARD,3,Grigor Dimitrov,Bradley Klahn,Grigor Dimitrov,6-7(7); 6-4; 6-4; 6-3,R128,154,14,4,62,108,55,62,30,46,0,0,20,85,108,10,9,75,130,54,75,28,55,4,8,21,82,130
2014-01-13 00:00:00.000,Australian Open Australia Grand Slams,HARD,3,Benoit Paire,Frank Dancevic,Benoit Paire,7-6(12); 6-3; 6-4,R128,132,24,6,60,106,54,60,22,46,3,4,16,76,106,12,3,65,108,48,65,19,43,9,12,15,67,108
2014-01-13 00:00:00.000,Australian Open Australia Grand Slams,HARD,3,Nick Kyrgios,Benjamin Becker,Nick Kyrgios,6-3; 6-7(5); 6-2; 7-6(2),R128,152,34,13,69,123,63,69,22,54,4,7,21,85,123,12,5,65,124,44,65,32,59,2,8,20,76,124
2014-01-13 00:00:00.000,Australian Open Australia Grand Slams,HARD,3,Roberto Bautista Agut,Tim Smyczek,Roberto Bautista Agut,6-2; 6-1; 6-1,R128,90,1,1,50,61,37,50,7,11,1,2,11,44,61,8,5,54,89,28,54,10,35,10,18,11,38,89
2014-01-13 00:00:00.000,Australian Open Australia Grand Slams,HARD,3,Juan Martin Del Potro,Rhyne Williams,Juan Martin Del Potro,6-7(1); 6-3; 6-4; 6-4,R128,184,16,3,73,115,61,73,24,42,1,2,21,85,115,29,1,65,114,52,65,25,49,4,8,20,77,114
2014-01-13 00:00:00.000,Australian Open Australia Grand Slams,HARD,3,Andy Murray,Go Soeda,Andy Murray,6-1; 6-1; 6-3,R128,87,11,2,41,59,33,41,11,18,0,0,11,44,59,6,3,45,74,28,45,6,29,6,13,12,34,74
2014-01-13 00:00:00.000,Australian Open Australia Grand Slams,HARD,3,Vincent Millot,Wayne Odesnik,Vincent Millot,7-5; 4-6; 6-7(4); 6-1; 6-3,R128,209,18,9,96,166,64,96,33,70,13,20,25,97,166,11,2,110,165,66,110,23,55,15,26,25,89,165
2014-01-13 00:00:00.000,Australian Open Australia Grand Slams,HARD,3,Michael Berrer,Michael Llodra,Michael Berrer,6-4; 7-5; 6-1,R128,94,9,6,46,73,39,46,19,27,2,2,14,58,73,10,5,69,96,47,69,12,27,7,12,15,59,96
2014-01-13 00:00:00.000,Australian Open Australia Grand Slams,HARD,3,Feliciano Lopez,Somdev Devvarman,Feliciano Lopez,6-4; 6-4; 7-6(2),R128,133,12,2,62,95,50,62,18,33,5,7,16,68,95,6,1,54,104,34,54,28,50,3,7,16,62,104
2014-01-13 00:00:00.000,Australian Open Australia Grand Slams,HARD,3,Stephane Robert,Aljaz Bedene,Stephane Robert,7-6(3); 6-3; 6-0,R128,113,4,2,33,71,25,33,21,38,1,5,13,46,71,16,11,58,107,40,58,9,49,8,17,14,49,107
2014-01-13 00:00:00.000,Australian Open Australia Grand Slams,HARD,3,Michal Przysiezny,Horacio Zeballos,Michal Przysiezny,6-3; 7-6(4); 7-5,R128,126,15,0,61,89,48,61,17,28,2,4,16,65,89,11,4,60,100,43,60,18,40,3,8,17,61,100
2014-01-13 00:00:00.000,Australian Open Australia Grand Slams,HARD,3,Blaz Rola,Federico Delbonis,Blaz Rola,6-4; 6-2; 7-5,R128,128,6,8,69,102,57,69,13,33,8,8,15,70,102,4,1,58,92,38,58,16,34,5,9,15,54,92
2014-01-13 00:00:00.000,Australian Open Australia Grand Slams,HARD,3,Martin Klizan,John Isner,Martin Klizan,6-2; 7-6(6) RET,R128,82,9,2,32,58,27,32,21,26,3,3,11,48,58,10,0,52,67,36,52,6,15,3,5,10,42,67
2014-01-13 00:00:00.000,Australian Open Australia Grand Slams,HARD,3,Jo-Wilfried Tsonga,Filippo Volandri,Jo-Wilfried Tsonga,7-5; 6-3; 6-3,R128,110,15,1,51,82,37,51,23,31,1,2,15,60,82,2,6,60,99,37,60,18,39,8,13,15,55,99
2014-01-13 00:00:00.000,Australian Open Australia Grand Slams,HARD,3,Thomaz Bellucci,Julian Reister,Thomaz Bellucci,4-6; 6-3; 7-6(5) RET,R128,132,8,6,53,99,40,53,23,46,4,8,16,63,99,5,8,57,92,43,57,14,35,3,7,15,57,92
2014-01-13 00:00:00.000,Australian Open Australia Grand Slams,HARD,3,Marin Cilic,Marcel Granollers,Marin Cilic,4-6; 4-6; 6-3; 6-3; 6-2,R128,192,22,4,70,120,58,70,29,50,1,3,23,87,120,13,3,91,149,64,91,27,58,3,8,23,91,149
2014-01-13 00:00:00.000,Australian Open Australia Grand Slams,HARD,3,Gilles Simon,Daniel Brands,Gilles Simon,6-7(4); 6-4; 3-6; 6-3; 16-14,R128,272,32,17,143,257,114,143,57,114,23,25,35,171,257,41,4,128,204,108,128,37,76,6,10,35,145,204
2014-01-13 00:00:00.000,Australian Open Australia Grand Slams,HARD,3,Fernando Verdasco,Ze Zhang,Fernando Verdasco,5-7; 6-3; 6-2; 6-3,R128,146,20,6,70,115,59,70,24,45,4,5,19,83,115,7,6,64,111,44,64,25,47,9,14,19,69,111
2014-01-13 00:00:00.000,Australian Open Australia Grand Slams,HARD,3,Teymuraz Gabashvili,Sergiy Stakhovsky,Teymuraz Gabashvili,6-7(3); 6-4; 6-2; 6-0,R128,171,5,4,66,114,49,66,24,48,3,6,18,73,114,14,8,72,131,50,72,21,59,8,17,18,71,131
2014-01-13 00:00:00.000,Australian Open Australia Grand Slams,HARD,3,Blaz Kavcic,Radek Stepanek,Blaz Kavcic,6-7(3); 4-6; 6-1; 2-0 RET,R128,167,10,6,65,103,43,65,22,38,7,11,16,65,103,5,11,62,122,37,62,29,60,8,14,16,66,122
2014-01-13 00:00:00.000,Australian Open Australia Grand Slams,HARD,3,Roger Federer,James Duckworth,Roger Federer,6-4; 6-4; 6-2,R128,106,11,5,45,78,40,45,19,33,1,1,14,59,78,13,3,48,92,36,48,19,44,13,17,14,55,92
2014-01-13 00:00:00.000,Australian Open Australia Grand Slams,HARD,3,Tomas Berdych,Aleksandr Nedovyesov,Tomas Berdych,6-3; 6-4; 6-3,R128,110,8,0,47,71,39,47,19,24,2,2,14,58,71,8,2,57,93,37,57,17,36,10,14,14,54,93
2014-01-13 00:00:00.000,Australian Open Australia Grand Slams,HARD,3,Kenny De Schepper,Di Wu,Kenny De Schepper,7-5; 7-5; 7-6(2),R128,162,19,13,84,133,63,84,20,49,11,13,18,83,133,3,5,74,126,46,74,29,52,7,11,18,75,126
2014-01-13 00:00:00.000,Australian Open Australia Grand Slams,HARD,3,Damir Dzumhur,Jan Hajek,Damir Dzumhur,6-4; 6-2; 6-1,R128,86,4,3,36,68,31,36,19,32,1,2,12,50,68,2,6,60,82,31,60,6,22,5,12,13,37,82
2014-01-13 00:00:00.000,Australian Open Australia Grand Slams,HARD,3,Ivan Dodig,Ivo Karlovic,Ivan Dodig,7-6(8); 6-3; 7-6(4),R128,114,8,2,83,100,68,83,12,17,2,3,17,80,100,25,1,67,101,55,67,18,34,1,3,16,73,101
2014-01-13 00:00:00.000,Australian Open Australia Grand Slams,HARD,3,Kevin Anderson,Jiri Vesely,Kevin Anderson,2-6; 6-7(4); 6-4; 6-4; 6-4,R128,229,21,9,92,146,76,92,28,54,4,6,25,104,146,16,10,92,162,69,92,43,70,11,14,25,112,162
2014-01-13 00:00:00.000,Australian Open Australia Grand Slams,HARD,3,Dominic Thiem,Joao Sousa,Dominic Thiem,5-7; 6-4; 6-3; 7-6(3),R128,185,20,3,76,137,60,76,31,61,5,8,21,91,137,8,0,94,144,57,94,30,50,7,12,22,87,144
2014-01-13 00:00:00.000,Australian Open Australia Grand Slams,HARD,3,Edouard Roger-Vasselin,Carlos Berlocq,Edouard Roger-Vasselin,6-4; 7-6(5); 6-7(9); 6-2,R128,228,6,6,109,168,67,109,32,59,9,13,21,99,168,9,4,83,145,49,83,32,62,9,16,21,81,145
2014-01-13 00:00:00.000,Australian Open Australia Grand Slams,HARD,3,Guillermo Garcia-Lopez,Tommy Haas,Guillermo Garcia-Lopez,7-5; 5-2 RET,R128,80,7,3,35,60,27,35,11,25,1,2,9,38,60,4,7,31,60,22,31,11,29,0,4,10,33,60
2014-01-13 00:00:00.000,Australian Open Australia Grand Slams,HARD,3,Mikhail Youzhny,Jan-Lennard Struff,Mikhail Youzhny,6-1; 6-4; 6-2,R128,109,5,2,59,86,39,59,17,27,3,5,13,56,86,2,8,37,75,24,37,12,38,2,9,12,36,75
2014-01-13 00:00:00.000,Australian Open Australia Grand Slams,HARD,3,Florian Mayer,Denis Kudla,Florian Mayer,6-4; 6-2; 6-4,R128,105,6,1,49,83,37,49,21,34,2,3,14,58,83,1,2,57,96,35,57,18,39,6,11,14,53,96
2014-01-13 00:00:00.000,Australian Open Australia Grand Slams,HARD,3,Pablo Andujar,Albert Ramos-Vinolas,Pablo Andujar,6-4; 6-2; 6-4,R128,115,2,1,66,90,40,66,15,24,4,7,14,55,90,2,3,51,84,32,51,10,33,5,12,14,42,84
2014-01-13 00:00:00.000,Australian Open Australia Grand Slams,HARD,3,Jerzy Janowicz,Jordan Thompson,Jerzy Janowicz,1-6; 4-6; 6-4; 6-2; 6-1,R128,196,17,11,104,162,74,104,27,58,7,10,21,101,162,13,7,79,131,57,79,22,52,4,9,21,79,131
2014-01-13 00:00:00.000,Australian Open Australia Grand Slams,HARD,3,Jeremy Chardy,Jesse Huta Galung,Jeremy Chardy,6-2; 6-4; 6-4,R128,110,9,3,58,88,46,58,16,30,5,5,14,62,88,9,7,47,86,39,47,15,39,5,9,14,54,86
2014-01-13 00:00:00.000,Australian Open Australia Grand Slams,HARD,3,Alexandr Dolgopolov,Ricardas Berankis,Alexandr Dolgopolov,7-5; 7-5; 6-2,R128,123,8,4,53,91,42,53,23,38,2,3,16,65,91,10,3,57,114,40,57,25,57,11,16,16,65,114
2014-01-13 00:00:00.000,Australian Open Australia Grand Slams,HARD,3,Adrian Mannarino,Steve Johnson,Adrian Mannarino,3-6; 6-3; 6-0; 5-7; 6-4,R128,177,3,3,81,140,52,81,37,59,2,6,23,89,140,21,12,69,131,50,69,28,62,4,11,23,78,131
2014-01-13 00:00:00.000,Australian Open Australia Grand Slams,HARD,3,David Ferrer,Alejandro Gonzalez,David Ferrer,6-3; 6-4; 6-4,R128,125,2,6,44,83,28,44,21,39,2,7,15,49,83,2,4,60,88,34,60,7,28,4,12,14,41,88
2014-01-13 00:00:00.000,Australian Open Australia Grand Slams,HARD,3,Stan Wawrinka,Andrey Golubev,Stan Wawrinka,6-4; 4-1 RET,R128,65,4,1,22,35,20,22,6,13,1,2,7,26,35,0,0,36,56,18,36,10,20,5,9,8,28,56
2014-01-13 00:00:00.000,Australian Open Australia Grand Slams,HARD,3,Alejandro Falla,Mikhail Kukushkin,Alejandro Falla,6-7(2); 6-2; 6-2; 6-3,R128,189,4,2,74,123,50,74,23,49,10,14,18,73,123,2,3,86,156,55,86,23,70,18,28,19,78,156
2014-01-13 00:00:00.000,Australian Open Australia Grand Slams,HARD,3,Matthew Ebden,Nicolas Mahut,Matthew Ebden,6-3; 7-5; 4-6; 0-6; 6-3,R128,184,7,7,89,132,58,89,23,43,9,15,23,81,132,7,4,87,136,63,87,23,49,6,12,23,86,136
2014-01-13 00:00:00.000,Australian Open Australia Grand Slams,HARD,3,Vasek Pospisil,Sam Groth,Vasek Pospisil,6-4; 6-3; 6-4,R128,103,6,4,50,75,45,50,13,25,2,2,14,58,75,16,4,60,93,40,60,17,33,6,10,15,57,93
2014-01-13 00:00:00.000,Australian Open Australia Grand Slams,HARD,3,Tommy Robredo,Lukas Rosol,Tommy Robredo,6-1; 6-7(7); 3-6; 7-6(5); 8-6,R128,212,13,0,82,144,62,82,43,62,4,7,26,105,144,11,12,91,185,71,91,42,94,12,18,28,113,185
2014-01-13 00:00:00.000,Australian Open Australia Grand Slams,HARD,3,Julien Benneteau,Pablo Carreno Busta,Julien Benneteau,6-3; 3-6; 4-6; 6-1; 6-2,R128,183,16,4,87,131,62,87,24,44,1,5,22,86,131,7,7,78,147,47,78,34,69,12,19,21,81,147
2014-01-13 00:00:00.000,Australian Open Australia Grand Slams,HARD,3,Nikolay Davydenko,Lukasz Kubot,Nikolay Davydenko,3-6; 6-3; 3-6; 6-3; 6-4,R128,219,6,4,104,135,76,104,11,31,8,14,23,87,135,8,12,100,168,68,100,25,68,17,24,23,93,168
2014-01-13 00:00:00.000,Australian Open Australia Grand Slams,HARD,3,Richard Gasquet,David Guez,Richard Gasquet,7-5; 6-4; 6-1,R128,113,12,0,58,85,43,58,13,27,4,7,15,56,85,3,0,48,76,26,48,12,28,3,10,14,38,76
2014-01-13 00:00:00.000,Australian Open Australia Grand Slams,HARD,3,Fabio Fognini,Alex Bogomolov Jr.,Fabio Fognini,6-3; 6-2 RET,R128,89,3,4,27,55,19,27,14,28,4,6,8,33,55,0,11,44,84,25,44,14,40,14,20,9,39,84
2014-01-13 00:00:00.000,Australian Open Australia Grand Slams,HARD,3,Jarkko Nieminen,Dudi Sela,Jarkko Nieminen,3-6; 7-6(3); 6-7(3); 6-3; 6-3,R128,218,2,5,103,176,66,103,34,73,8,17,26,100,176,5,3,113,170,72,113,25,57,7,17,25,97,170
2014-01-13 00:00:00.000,Australian Open Australia Grand Slams,HARD,3,Sam Querrey,Santiago Giraldo,Sam Querrey,6-3; 6-2; 3-6; 7-6(3),R128,133,24,4,74,117,60,74,22,43,5,7,19,82,117,9,3,72,113,50,72,23,41,3,7,19,73,113
2014-01-13 00:00:00.000,Australian Open Australia Grand Slams,HARD,3,Ernests Gulbis,Juan Monaco,Ernests Gulbis,1-6; 6-4; 7-6(4); 6-2,R128,189,17,11,76,144,59,76,32,68,9,12,19,91,144,0,4,84,111,63,84,12,27,2,5,18,75,111
2014-01-13 00:00:00.000,Australian Open Australia Grand Slams,HARD,3,Dmitry Tursunov,Michael Russell,Dmitry Tursunov,6-2; 6-2; 6-3,R128,116,8,6,52,99,39,52,24,47,6,7,13,63,99,1,8,42,84,24,42,19,42,3,9,12,43,84
2014-01-13 00:00:00.000,Australian Open Australia Grand Slams,HARD,3,Denis Istomin,Marcos Baghdatis,Denis Istomin,6-4; 7-5; 6-4,R128,156,9,1,80,105,56,80,16,25,8,9,16,72,105,9,4,66,127,53,66,20,61,9,13,16,73,127
2014-01-13 00:00:00.000,Australian Open Australia Grand Slams,HARD,3,Leonardo Mayer,Albert Montanes,Leonardo Mayer,6-1; 6-3; 6-1,R128,70,13,1,33,54,31,33,13,21,0,0,11,44,54,1,4,41,68,23,41,9,27,7,14,12,32,68
2014-01-13 00:00:00.000,Australian Open Australia Grand Slams,HARD,3,Novak Djokovic,Lukas Lacko,Novak Djokovic,6-3; 7-6(2); 6-1,R128,110,9,0,54,79,45,54,17,25,2,3,15,62,79,5,1,56,92,35,56,18,36,4,8,13,53,92
2014-01-13 00:00:00.000,Australian Open Australia Grand Slams,HARD,3,Rafael Nadal,Thanasi Kokkinakis,Rafael Nadal,6-2; 6-4; 6-2,R64,113,7,1,56,74,46,56,10,18,3,3,13,56,74,4,2,52,78,33,52,10,26,5,10,13,43,78
2014-01-13 00:00:00.000,Australian Open Australia Grand Slams,HARD,3,Gael Monfils,Jack Sock,Gael Monfils,7-6(2); 7-5; 6-2,R64,123,13,3,56,91,47,56,23,35,0,1,16,70,91,5,9,69,118,48,69,23,49,7,11,16,71,118
2014-01-13 00:00:00.000,Australian Open Australia Grand Slams,HARD,3,Donald Young,Andreas Seppi,Donald Young,6-4; 2-6; 6-3; 4-6; 7-5,R64,211,6,15,106,177,71,106,30,71,12,18,25,101,177,12,10,84,148,57,84,33,64,9,15,24,90,148
2014-01-13 00:00:00.000,Australian Open Australia Grand Slams,HARD,3,Kei Nishikori,Dusan Lajovic,Kei Nishikori,6-1; 6-1; 7-6(3),R64,109,5,3,52,81,43,52,15,29,4,5,13,58,81,7,3,63,91,35,63,10,28,6,12,13,45,91
2014-01-13 00:00:00.000,Australian Open Australia Grand Slams,HARD,3,Milos Raonic,Victor Hanescu,Milos Raonic,7-6(9); 6-4; 6-4,R64,139,27,3,67,104,57,67,23,37,5,5,16,80,104,6,1,76,113,55,76,22,37,4,6,16,77,113
2014-01-13 00:00:00.000,Australian Open Australia Grand Slams,HARD,3,Grigor Dimitrov,Yen-Hsun Lu,Grigor Dimitrov,6-3; 6-3; 7-6(11),R64,124,15,7,58,96,50,58,17,38,2,4,15,67,96,2,2,82,116,47,82,19,34,16,21,15,66,116
2014-01-13 00:00:00.000,Australian Open Australia Grand Slams,HARD,3,Benoit Paire,Nick Kyrgios,Benoit Paire,6-7(5); 6-7(5); 6-4; 6-2; 6-2,R64,200,32,5,82,161,69,82,46,79,8,10,25,115,161,24,11,124,186,87,124,26,62,17,24,25,113,186
2014-01-13 00:00:00.000,Australian Open Australia Grand Slams,HARD,3,Roberto Bautista Agut,Juan Martin Del Potro,Roberto Bautista Agut,4-6; 6-3; 5-7; 6-4; 7-5,R64,233,12,6,116,166,89,116,22,50,13,17,27,111,166,28,2,107,148,76,107,21,41,3,8,26,97,148
2014-01-13 00:00:00.000,Australian Open Australia Grand Slams,HARD,3,Andy Murray,Vincent Millot,Andy Murray,6-2; 6-2; 7-5,R64,121,5,5,44,75,35,44,17,31,1,4,14,52,75,2,7,54,99,25,54,20,45,9,17,14,45,99
2014-01-13 00:00:00.000,Australian Open Australia Grand Slams,HARD,3,Feliciano Lopez,Michael Berrer,Feliciano Lopez,6-4; 7-6(6); 6-4,R64,133,8,3,60,97,45,60,23,37,2,4,16,68,97,6,3,75,108,49,75,17,33,8,12,16,66,108
2014-01-13 00:00:00.000,Australian Open Australia Grand Slams,HARD,3,Stephane Robert,Michal Przysiezny,Stephane Robert,7-6(3); 6-1; 6-7(3); 6-1,R64,153,12,8,71,124,55,71,31,53,5,7,20,86,124,12,6,72,131,47,72,27,59,11,17,18,74,131
2014-01-13 00:00:00.000,Australian Open Australia Grand Slams,HARD,3,Martin Klizan,Blaz Rola,Martin Klizan,6-4; 6-3; 5-7; 7-6(2),R64,172,16,5,67,116,49,67,34,49,1,4,21,83,116,12,8,92,146,66,92,24,54,9,14,22,90,146
2014-01-13 00:00:00.000,Australian Open Australia Grand Slams,HARD,3,Jo-Wilfried Tsonga,Thomaz Bellucci,Jo-Wilfried Tsonga,7-6(6); 6-4; 6-4,R64,135,13,6,59,92,51,59,18,33,3,4,16,69,92,9,5,48,106,31,48,34,58,6,9,16,65,106
2014-01-13 00:00:00.000,Australian Open Australia Grand Slams,HARD,3,Gilles Simon,Marin Cilic,Gilles Simon,4-6; 7-6(3); 6-7(5); 6-1; 6-2,R64,237,7,8,89,180,65,89,41,91,8,15,25,106,180,15,7,73,147,50,73,32,74,2,12,24,82,147
2014-01-13 00:00:00.000,Australian Open Australia Grand Slams,HARD,3,Teymuraz Gabashvili,Fernando Verdasco,Teymuraz Gabashvili,7-6(1); 3-6; 2-6; 6-4; 6-4,R64,211,2,4,98,143,63,98,25,45,4,10,24,88,143,11,18,93,159,64,93,37,66,12,17,25,101,159
2014-01-13 00:00:00.000,Australian Open Australia Grand Slams,HARD,3,Roger Federer,Blaz Kavcic,Roger Federer,6-2; 6-1; 7-6(4),R64,107,11,0,58,76,45,58,9,18,1,2,13,54,76,6,3,61,99,32,61,18,38,5,11,14,50,99
2014-01-13 00:00:00.000,Australian Open Australia Grand Slams,HARD,3,Tomas Berdych,Kenny De Schepper,Tomas Berdych,6-4; 6-1; 6-3,R64,102,5,4,42,66,37,42,15,24,0,0,13,52,66,8,9,54,84,33,54,10,30,3,8,13,43,84
2014-01-13 00:00:00.000,Australian Open Australia Grand Slams,HARD,3,Damir Dzumhur,Ivan Dodig,Damir Dzumhur,4-6; 4-6; 6-3; 4-1 RET,R64,142,7,6,48,94,36,48,26,46,4,7,16,62,94,14,2,52,92,40,52,19,40,2,5,16,59,92
2014-01-13 00:00:00.000,Australian Open Australia Grand Slams,HARD,3,Kevin Anderson,Dominic Thiem,Kevin Anderson,6-4; 6-3; 6-4,R64,107,15,5,51,80,43,51,18,29,2,2,15,61,80,10,3,44,76,34,44,16,32,2,5,14,50,76
2014-01-13 00:00:00.000,Australian Open Australia Grand Slams,HARD,3,Edouard Roger-Vasselin,Guillermo Garcia-Lopez,Edouard Roger-Vasselin,7-6(1); 6-4; 4-6; 6-1,R64,171,11,2,70,122,49,70,28,52,9,13,19,77,122,9,10,64,125,46,64,26,61,10,17,20,72,125
2014-01-13 00:00:00.000,Australian Open Australia Grand Slams,HARD,3,Florian Mayer,Mikhail Youzhny,Florian Mayer,6-4; 3-6; 6-3; 3-6; 6-3,R64,186,18,2,76,127,58,76,34,51,4,7,23,92,127,14,6,71,135,53,71,38,64,9,13,23,91,135
2014-01-13 00:00:00.000,Australian Open Australia Grand Slams,HARD,3,Jerzy Janowicz,Pablo Andujar,Jerzy Janowicz,4-6; 7-6(3); 7-6(5); 6-3,R64,205,15,5,107,159,76,107,25,52,8,11,22,101,159,11,1,112,141,72,112,19,29,8,11,21,91,141
2014-01-13 00:00:00.000,Australian Open Australia Grand Slams,HARD,3,Jeremy Chardy,Alexandr Dolgopolov,Jeremy Chardy,7-5; 7-6(5); 6-7(3); 7-6(5),R64,211,22,10,95,160,74,95,30,65,8,12,24,104,160,15,2,115,163,80,115,23,48,9,14,24,103,163
2014-01-13 00:00:00.000,Australian Open Australia Grand Slams,HARD,3,David Ferrer,Adrian Mannarino,David Ferrer,7-6(2); 5-7; 6-0; 6-3,R64,182,0,3,81,118,56,81,18,37,5,10,19,74,118,3,1,77,137,44,77,25,60,8,17,20,69,137
2014-01-13 00:00:00.000,Australian Open Australia Grand Slams,HARD,3,Stan Wawrinka,Alejandro Falla,Stan Wawrinka,6-3; 6-3; 6-7(4); 6-4,R64,167,9,4,68,124,57,68,31,56,5,7,20,88,124,1,3,80,135,56,80,25,55,11,17,20,81,135
2014-01-13 00:00:00.000,Australian Open Australia Grand Slams,HARD,3,Vasek Pospisil,Matthew Ebden,Vasek Pospisil,3-6; 7-6(6); 7-6(9); 6-1,R64,169,14,3,77,128,59,77,31,51,8,11,20,90,128,9,3,86,125,64,86,19,39,1,5,20,83,125
2014-01-13 00:00:00.000,Australian Open Australia Grand Slams,HARD,3,Tommy Robredo,Julien Benneteau,Tommy Robredo,6-3; 6-7(4); 6-1; 7-6(6),R64,212,17,2,81,142,61,81,38,61,10,11,21,99,142,14,6,97,155,68,97,27,58,9,13,19,95,155
2014-01-13 00:00:00.000,Australian Open Australia Grand Slams,HARD,3,Richard Gasquet,Nikolay Davydenko,Richard Gasquet,7-6(3); 6-4; 6-4,R64,140,9,5,57,100,40,57,22,43,1,5,16,62,100,7,1,79,105,47,79,11,26,4,10,16,58,105
2014-01-13 00:00:00.000,Australian Open Australia Grand Slams,HARD,3,Fabio Fognini,Jarkko Nieminen,Fabio Fognini,7-5; 6-4; 3-6; 6-2,R64,167,9,12,88,146,66,88,26,58,14,16,19,92,146,3,5,86,132,57,86,23,46,10,15,20,80,132
2014-01-13 00:00:00.000,Australian Open Australia Grand Slams,HARD,3,Sam Querrey,Ernests Gulbis,Sam Querrey,6-2; 6-3; 6-4,R64,97,19,4,51,71,45,51,11,20,2,3,14,56,71,7,4,35,76,23,35,21,41,4,9,13,44,76
2014-01-13 00:00:00.000,Australian Open Australia Grand Slams,HARD,3,Denis Istomin,Dmitry Tursunov,Denis Istomin,7-6(3); 4-6; 6-1; 6-4,R64,164,14,1,66,118,48,66,35,52,7,10,20,83,118,5,5,62,115,45,62,26,53,3,8,19,71,115
2014-01-13 00:00:00.000,Australian Open Australia Grand Slams,HARD,3,Novak Djokovic,Leonardo Mayer,Novak Djokovic,6-0; 6-4; 6-4,R64,107,12,2,44,67,36,44,17,23,0,0,13,53,67,3,7,44,85,28,44,17,41,1,6,13,45,85
2014-01-13 00:00:00.000,Australian Open Australia Grand Slams,HARD,3,Rafael Nadal,Gael Monfils,Rafael Nadal,6-1; 6-2; 6-3,R32,124,2,0,52,79,38,52,20,27,6,6,12,58,79,10,5,67,98,38,67,11,31,6,12,12,49,98
2014-01-13 00:00:00.000,Australian Open Australia Grand Slams,HARD,3,Kei Nishikori,Donald Young,Kei Nishikori,7-5; 6-1; 6-0,R32,107,3,1,41,76,29,41,21,35,3,4,12,50,76,1,5,47,73,23,47,7,26,4,12,13,30,73
2014-01-13 00:00:00.000,Australian Open Australia Grand Slams,HARD,3,Grigor Dimitrov,Milos Raonic,Grigor Dimitrov,6-3; 3-6; 6-4; 7-6(10),R32,156,15,5,67,110,56,67,32,43,2,3,20,88,110,21,5,74,125,55,74,30,51,2,4,20,85,125
2014-01-13 00:00:00.000,Australian Open Australia Grand Slams,HARD,3,Roberto Bautista Agut,Benoit Paire,Roberto Bautista Agut,6-2; 6-1; 6-4,R32,90,4,1,65,78,46,65,7,13,5,7,13,53,78,14,3,48,83,30,48,10,35,13,20,12,40,83
2014-01-13 00:00:00.000,Australian Open Australia Grand Slams,HARD,3,Andy Murray,Feliciano Lopez,Andy Murray,7-6(2); 6-4; 6-2,R32,135,6,2,58,91,50,58,16,33,0,1,15,66,91,8,7,57,99,40,57,19,42,7,11,15,59,99
2014-01-13 00:00:00.000,Australian Open Australia Grand Slams,HARD,3,Stephane Robert,Martin Klizan,Stephane Robert,6-0; 7-6(2); 6-4,R32,105,7,5,63,87,54,63,11,24,3,3,14,65,87,6,4,49,93,32,49,21,44,6,10,14,53,93
2014-01-13 00:00:00.000,Australian Open Australia Grand Slams,HARD,3,Jo-Wilfried Tsonga,Gilles Simon,Jo-Wilfried Tsonga,7-6(5); 6-4; 6-2,R32,113,17,0,60,92,48,60,21,32,3,3,15,69,92,7,3,43,81,34,43,22,38,3,6,15,56,81
2014-01-13 00:00:00.000,Australian Open Australia Grand Slams,HARD,3,Roger Federer,Teymuraz Gabashvili,Roger Federer,6-2; 6-2; 6-3,R32,101,6,1,45,73,39,45,16,28,5,5,13,55,73,3,5,63,91,38,63,10,28,9,14,12,48,91
2014-01-13 00:00:00.000,Australian Open Australia Grand Slams,HARD,3,Tomas Berdych,Damir Dzumhur,Tomas Berdych,6-4; 6-2; 6-2,R32,105,13,1,41,72,37,41,19,31,2,2,13,56,72,5,6,35,79,25,35,17,44,4,9,13,42,79
2014-01-13 00:00:00.000,Australian Open Australia Grand Slams,HARD,3,Kevin Anderson,Edouard Roger-Vasselin,Kevin Anderson,3-6; 4-6; 6-3; 7-6(5); 7-5,R32,234,27,6,101,151,77,101,26,50,4,7,26,103,151,8,4,129,175,93,129,21,46,9,12,26,114,175
2014-01-13 00:00:00.000,Australian Open Australia Grand Slams,HARD,3,Florian Mayer,Jerzy Janowicz,Florian Mayer,7-5; 6-2; 6-2,R32,98,17,0,45,68,41,45,16,23,1,1,14,57,68,3,7,48,93,34,48,18,45,6,11,14,52,93
2014-01-13 00:00:00.000,Australian Open Australia Grand Slams,HARD,3,David Ferrer,Jeremy Chardy,David Ferrer,6-2; 7-6(5); 6-2,R32,132,2,1,63,87,44,63,17,24,2,3,14,61,87,9,8,64,111,44,64,17,47,6,11,14,61,111
2014-01-13 00:00:00.000,Australian Open Australia Grand Slams,HARD,3,Stan Wawrinka,Vasek Pospisil,Stan Wawrinka,W/O,R32,0,0,0,0,0,0,0,0,0,0,0,0,0,0,0,0,0,0,0,0,0,0,0,0,0,0,0
2014-01-13 00:00:00.000,Australian Open Australia Grand Slams,HARD,3,Tommy Robredo,Richard Gasquet,Tommy Robredo,2-6; 7-5; 6-4; 7-6(6),R32,199,16,3,90,139,70,90,21,49,6,9,21,91,139,3,5,86,138,62,86,27,52,4,7,21,89,138
2014-01-13 00:00:00.000,Australian Open Australia Grand Slams,HARD,3,Fabio Fognini,Sam Querrey,Fabio Fognini,7-5; 6-4; 6-4,R32,115,9,3,54,91,40,54,27,37,3,4,16,67,91,10,1,65,103,43,65,19,38,6,10,16,62,103
2014-01-13 00:00:00.000,Australian Open Australia Grand Slams,HARD,3,Novak Djokovic,Denis Istomin,Novak Djokovic,6-3; 6-3; 7-5,R32,119,6,1,48,78,37,48,21,30,0,1,15,58,78,5,1,57,86,41,57,10,29,3,8,15,51,86
2014-01-13 00:00:00.000,Australian Open Australia Grand Slams,HARD,3,Rafael Nadal,Kei Nishikori,Rafael Nadal,7-6(3); 7-5; 7-6(3),R16,197,12,1,88,124,67,88,14,36,6,10,18,81,124,3,1,76,115,51,76,16,39,3,8,18,67,115
2014-01-13 00:00:00.000,Australian Open Australia Grand Slams,HARD,3,Grigor Dimitrov,Roberto Bautista Agut,Grigor Dimitrov,6-3; 3-6; 6-2; 6-4,R16,144,11,3,67,112,57,67,21,45,4,5,18,78,112,5,1,65,102,44,65,22,37,1,5,18,66,102
2014-01-13 00:00:00.000,Australian Open Australia Grand Slams,HARD,3,Andy Murray,Stephane Robert,Andy Murray,6-1; 6-2; 6-7(6); 6-2,R16,162,7,3,77,126,58,77,26,49,5,6,18,84,126,3,8,59,114,40,59,21,55,7,14,17,61,114
2014-01-13 00:00:00.000,Australian Open Australia Grand Slams,HARD,3,Roger Federer,Jo-Wilfried Tsonga,Roger Federer,6-3; 7-5; 6-4,R16,112,7,1,48,84,42,48,25,36,1,1,16,67,84,8,1,46,88,32,46,23,42,4,7,15,55,88
2014-01-13 00:00:00.000,Australian Open Australia Grand Slams,HARD,3,Tomas Berdych,Kevin Anderson,Tomas Berdych,6-2; 6-2; 6-3,R16,118,7,3,37,71,33,37,21,34,0,0,13,54,71,17,1,62,87,39,62,10,25,12,17,12,49,87
2014-01-13 00:00:00.000,Australian Open Australia Grand Slams,HARD,3,David Ferrer,Florian Mayer,David Ferrer,6-7(5); 7-5; 6-2; 6-1,R16,175,3,1,76,118,56,76,23,42,8,11,19,79,118,4,3,94,153,52,94,27,59,10,19,20,79,153
2014-01-13 00:00:00.000,Australian Open Australia Grand Slams,HARD,3,Stan Wawrinka,Tommy Robredo,Stan Wawrinka,6-3; 7-6(3); 7-6(5),R16,143,14,3,62,107,54,62,24,45,3,4,17,78,107,1,0,76,107,53,76,14,31,3,5,16,67,107
2014-01-13 00:00:00.000,Australian Open Australia Grand Slams,HARD,3,Novak Djokovic,Fabio Fognini,Novak Djokovic,6-3; 6-0; 6-2,R16,93,8,2,43,60,38,43,12,17,0,0,12,50,60,3,7,54,91,32,54,13,37,16,22,11,45,91
2014-01-13 00:00:00.000,Australian Open Australia Grand Slams,HARD,3,Rafael Nadal,Grigor Dimitrov,Rafael Nadal,3-6; 7-6(3); 7-6(7); 6-2,Q,217,3,7,91,124,66,91,22,33,3,6,20,88,124,18,5,90,155,64,90,32,65,7,11,21,96,155
2014-01-13 00:00:00.000,Australian Open Australia Grand Slams,HARD,3,Roger Federer,Andy Murray,Roger Federer,6-3; 6-4; 6-7(6); 6-3,Q,200,10,0,78,122,60,78,29,44,1,2,21,89,122,9,1,89,146,60,89,28,57,13,17,19,88,146
2014-01-13 00:00:00.000,Australian Open Australia Grand Slams,HARD,3,Tomas Berdych,David Ferrer,Tomas Berdych,6-1; 6-4; 2-6; 6-4,Q,184,10,4,67,129,52,67,27,62,9,12,18,79,129,2,1,72,118,46,72,23,46,8,13,17,69,118
2014-01-13 00:00:00.000,Australian Open Australia Grand Slams,HARD,3,Stan Wawrinka,Novak Djokovic,Stan Wawrinka,2-6; 6-4; 6-2; 3-6; 9-7,Q,240,17,5,98,170,71,98,36,72,3,7,25,107,170,7,1,105,144,75,105,23,39,5,10,26,98,144
2014-01-13 00:00:00.000,Australian Open Australia Grand Slams,HARD,3,Rafael Nadal,Roger Federer,Rafael Nadal,7-6(4); 6-3; 6-3,S,144,3,1,56,86,41,56,22,30,1,2,15,63,86,8,1,69,105,45,69,18,36,10,14,15,63,105
2014-01-13 00:00:00.000,Australian Open Australia Grand Slams,HARD,3,Stan Wawrinka,Tomas Berdych,Stan Wawrinka,6-3; 6-7(1); 7-6(3); 7-6(4),S,211,18,4,88,145,72,88,32,57,1,1,23,104,145,21,7,87,140,71,87,30,53,3,4,22,101,140
2014-01-13 00:00:00.000,Australian Open Australia Grand Slams,HARD,3,Stan Wawrinka,Rafael Nadal,Stan Wawrinka,6-3; 6-2; 3-6; 6-3,F,141,19,2,53,96,46,53,22,43,4,6,18,68,96,1,3,84,108,50,84,10,24,10,15,17,60,108
2014-02-03 00:00:00.000,Montpellier France ATP World Tour 250,HARD,2,Richard Gasquet,N/A Bye,Richard Gasquet,,R32,0,0,0,0,0,0,0,0,0,0,0,0,0,0,0,0,0,0,0,0,0,0,0,0,0,0,0
2014-02-03 00:00:00.000,Montpellier France ATP World Tour 250,HARD,2,Paul-Henri Mathieu,Nicolas Mahut,Paul-Henri Mathieu,6-1; 3-0 RET,R32,44,4,1,15,34,12,15,12,19,1,1,5,24,34,2,4,16,28,6,16,3,12,2,6,5,9,28
2014-02-03 00:00:00.000,Montpellier France ATP World Tour 250,HARD,2,Albano Olivetti,Kenny De Schepper,Albano Olivetti,4-6; 7-6(2); 6-4,R32,112,14,3,60,93,50,60,20,33,2,3,16,70,93,6,2,53,80,42,53,20,27,0,1,16,62,80
2014-02-03 00:00:00.000,Montpellier France ATP World Tour 250,HARD,2,Nikolay Davydenko,Julien Benneteau,Nikolay Davydenko,7-6(6); 7-5,R32,102,8,2,54,86,42,54,19,32,3,3,12,61,86,6,1,49,76,39,49,16,27,2,3,12,55,76
2014-02-03 00:00:00.000,Montpellier France ATP World Tour 250,HARD,2,Jerzy Janowicz,N/A Bye,Jerzy Janowicz,,R32,0,0,0,0,0,0,0,0,0,0,0,0,0,0,0,0,0,0,0,0,0,0,0,0,0,0,0
2014-02-03 00:00:00.000,Montpellier France ATP World Tour 250,HARD,2,Adrian Mannarino,Vincent Millot,Adrian Mannarino,6-4; 6-4,R32,76,6,1,35,67,31,35,15,32,3,3,10,46,67,1,3,33,52,28,33,7,19,2,4,10,35,52
2014-02-03 00:00:00.000,Montpellier France ATP World Tour 250,HARD,2,Dustin Brown,Teymuraz Gabashvili,Dustin Brown,4-6; 6-1; 7-6(1),R32,110,9,3,71,103,50,71,14,32,3,6,15,64,103,3,1,67,87,44,67,9,20,2,6,14,53,87
2014-02-03 00:00:00.000,Montpellier France ATP World Tour 250,HARD,2,Edouard Roger-Vasselin,Michal Przysiezny,Edouard Roger-Vasselin,7-6(3); 6-3,R32,98,3,4,40,65,34,40,17,25,1,1,11,51,65,10,2,53,88,37,53,18,35,13,14,10,55,88
2014-02-03 00:00:00.000,Montpellier France ATP World Tour 250,HARD,2,Gael Monfils,Lukasz Kubot,Gael Monfils,6-4; 4-6; 6-3,R32,118,11,1,67,92,56,67,9,25,6,7,15,65,92,9,5,51,88,38,51,20,37,6,8,14,58,88
2014-02-03 00:00:00.000,Montpellier France ATP World Tour 250,HARD,2,Joao Sousa,Tobias Kamke,Joao Sousa,3-6; 6-1; 6-4,R32,104,6,0,48,73,34,48,14,25,4,6,13,48,73,1,1,50,84,29,50,22,34,5,9,13,51,84
2014-02-03 00:00:00.000,Montpellier France ATP World Tour 250,HARD,2,Denis Istomin,Marsel Ilhan,Denis Istomin,6-4; 7-5,R32,74,9,1,40,59,31,40,14,19,0,0,11,45,59,2,1,37,62,28,37,16,25,1,3,11,44,62
2014-02-03 00:00:00.000,Montpellier France ATP World Tour 250,HARD,2,Dmitry Tursunov,N/A Bye,Dmitry Tursunov,,R32,0,0,0,0,0,0,0,0,0,0,0,0,0,0,0,0,0,0,0,0,0,0,0,0,0,0,0
2014-02-03 00:00:00.000,Montpellier France ATP World Tour 250,HARD,2,Jarkko Nieminen,Aleksandr Nedovyesov,Jarkko Nieminen,4-6; 6-2; 4-4 RET,R32,88,3,1,49,67,39,49,11,18,1,3,13,50,67,8,2,47,74,33,47,13,27,1,4,13,46,74
2014-02-03 00:00:00.000,Montpellier France ATP World Tour 250,HARD,2,Pierre-Hugues Herbert,Andres Artunedo Martinavarro,Pierre-Hugues Herbert,6-4; 6-3,R32,64,5,1,23,53,21,23,18,30,1,2,10,39,53,3,1,36,47,24,36,6,11,3,6,9,30,47
2014-02-03 00:00:00.000,Montpellier France ATP World Tour 250,HARD,2,Marc Gicquel,Michael Llodra,Marc Gicquel,6-4; 7-6(4),R32,87,6,0,58,74,42,58,8,16,7,8,11,50,74,6,1,50,77,37,50,11,27,3,5,11,48,77
2014-02-03 00:00:00.000,Montpellier France ATP World Tour 250,HARD,2,Gilles Simon,N/A Bye,Gilles Simon,,R32,0,0,0,0,0,0,0,0,0,0,0,0,0,0,0,0,0,0,0,0,0,0,0,0,0,0,0
2014-02-03 00:00:00.000,Montpellier France ATP World Tour 250,HARD,2,Richard Gasquet,Paul-Henri Mathieu,Richard Gasquet,6-1; 6-3,R16,95,3,2,42,69,29,42,16,27,7,7,8,45,69,4,5,36,73,24,36,14,37,5,9,8,38,73
2014-02-03 00:00:00.000,Montpellier France ATP World Tour 250,HARD,2,Albano Olivetti,Nikolay Davydenko,Albano Olivetti,7-6(5); 6-7(5); 7-5,R16,152,28,4,57,107,52,57,30,50,3,5,18,82,107,8,2,97,137,67,97,24,40,7,10,18,91,137
2014-02-03 00:00:00.000,Montpellier France ATP World Tour 250,HARD,2,Jerzy Janowicz,Adrian Mannarino,Jerzy Janowicz,7-6(2); 6-3,R16,72,17,2,39,62,34,39,16,23,0,0,11,50,62,6,2,44,57,32,44,8,13,3,4,10,40,57
2014-02-03 00:00:00.000,Montpellier France ATP World Tour 250,HARD,2,Edouard Roger-Vasselin,Dustin Brown,Edouard Roger-Vasselin,6-3; 6-4,R16,67,4,3,54,65,41,54,4,11,4,4,10,45,65,7,2,40,63,26,40,13,23,1,3,9,39,63
2014-02-03 00:00:00.000,Montpellier France ATP World Tour 250,HARD,2,Gael Monfils,Joao Sousa,Gael Monfils,6-3; 6-2,R16,65,9,2,35,52,27,35,10,17,0,0,9,37,52,2,2,39,62,24,39,10,23,5,8,8,34,62
2014-02-03 00:00:00.000,Montpellier France ATP World Tour 250,HARD,2,Denis Istomin,Dmitry Tursunov,Denis Istomin,7-5; 6-4,R16,94,6,0,44,61,28,44,10,17,4,7,11,38,61,8,0,42,73,20,42,18,31,5,10,11,38,73
2014-02-03 00:00:00.000,Montpellier France ATP World Tour 250,HARD,2,Jarkko Nieminen,Pierre-Hugues Herbert,Jarkko Nieminen,7-6(5); 7-6(5),R16,97,3,0,51,71,43,51,11,20,1,2,12,54,71,23,5,50,94,42,50,19,44,6,7,12,61,94
2014-02-03 00:00:00.000,Montpellier France ATP World Tour 250,HARD,2,Marc Gicquel,Gilles Simon,Marc Gicquel,7-6(4); 6-3,R16,89,6,2,35,62,27,35,14,27,2,5,11,41,62,3,3,45,81,28,45,16,36,3,7,10,44,81
2014-02-03 00:00:00.000,Montpellier France ATP World Tour 250,HARD,2,Richard Gasquet,Albano Olivetti,Richard Gasquet,6-4; 6-2,Q,70,3,0,28,43,24,28,12,15,0,0,9,36,43,13,7,36,71,28,36,11,35,7,10,9,39,71
2014-02-03 00:00:00.000,Montpellier France ATP World Tour 250,HARD,2,Jerzy Janowicz,Edouard Roger-Vasselin,Jerzy Janowicz,6-2; 6-4,Q,70,18,1,36,55,28,36,13,19,3,3,9,41,55,3,2,41,58,26,41,8,17,4,7,9,34,58
2014-02-03 00:00:00.000,Montpellier France ATP World Tour 250,HARD,2,Gael Monfils,Denis Istomin,Gael Monfils,6-4; 6-4,Q,69,7,4,38,55,28,38,10,17,4,6,10,38,55,3,0,45,61,27,45,9,16,2,6,10,36,61
2014-02-03 00:00:00.000,Montpellier France ATP World Tour 250,HARD,2,Jarkko Nieminen,Marc Gicquel,Jarkko Nieminen,6-3; 3-6; 7-6(5),Q,105,1,4,74,101,52,74,12,27,5,7,15,64,101,11,1,47,79,39,47,19,32,1,3,15,58,79
2014-02-03 00:00:00.000,Montpellier France ATP World Tour 250,HARD,2,Richard Gasquet,Jerzy Janowicz,Richard Gasquet,7-6(6); 7-6(4),S,102,8,0,50,70,40,50,14,20,0,1,12,54,70,16,4,52,84,39,52,18,32,3,4,12,57,84
2014-02-03 00:00:00.000,Montpellier France ATP World Tour 250,HARD,2,Gael Monfils,Jarkko Nieminen,Gael Monfils,6-2; 3-6; 6-1,S,79,15,3,51,67,41,51,7,16,0,1,12,48,67,0,0,53,76,31,53,13,23,7,11,12,44,76
2014-02-03 00:00:00.000,Montpellier France ATP World Tour 250,HARD,2,Gael Monfils,Richard Gasquet,Gael Monfils,6-4; 6-4,F,85,9,4,28,50,26,28,14,22,0,0,10,40,50,0,0,55,73,34,55,11,18,3,5,10,45,73
2014-02-03 00:00:00.000,Vina del Mar Chile ATP World Tour 250,CLAY,2,Fabio Fognini,N/A Bye,Fabio Fognini,,R32,0,0,0,0,0,0,0,0,0,0,0,0,0,0,0,0,0,0,0,0,0,0,0,0,0,0,0
2014-02-03 00:00:00.000,Vina del Mar Chile ATP World Tour 250,CLAY,2,Aljaz Bedene,Stephane Robert,Aljaz Bedene,2-6; 6-3; 6-3,R32,117,13,4,43,81,34,43,17,38,4,7,13,51,81,3,4,51,95,31,51,22,44,6,10,13,53,95
2014-02-03 00:00:00.000,Vina del Mar Chile ATP World Tour 250,CLAY,2,Pablo Carreno Busta,Filippo Volandri,Pablo Carreno Busta,6-0; 3-6; 6-1,R32,99,1,4,44,70,30,44,12,26,4,7,11,42,70,0,1,69,93,33,69,10,24,12,19,11,43,93
2014-02-03 00:00:00.000,Vina del Mar Chile ATP World Tour 250,CLAY,2,Jeremy Chardy,Christian Garin,Jeremy Chardy,7-5; 6-0,R32,74,5,0,34,60,25,34,14,26,4,5,9,39,60,2,1,39,60,22,39,7,21,4,9,9,29,60
2014-02-03 00:00:00.000,Vina del Mar Chile ATP World Tour 250,CLAY,2,Nicolas Almagro,N/A Bye,Nicolas Almagro,,R32,0,0,0,0,0,0,0,0,0,0,0,0,0,0,0,0,0,0,0,0,0,0,0,0,0,0,0
2014-02-03 00:00:00.000,Vina del Mar Chile ATP World Tour 250,CLAY,2,Martin Alund,Albert Ramos-Vinolas,Martin Alund,6-3; 6-4,R32,91,3,0,39,61,31,39,14,22,5,5,10,45,61,2,3,39,61,26,39,13,22,4,6,9,39,61
2014-02-03 00:00:00.000,Vina del Mar Chile ATP World Tour 250,CLAY,2,Taro Daniel,Thomaz Bellucci,Taro Daniel,6-3; 6-3,R32,91,1,3,44,68,29,44,13,24,2,3,9,42,68,5,2,29,55,19,29,11,26,5,9,9,30,55
2014-02-03 00:00:00.000,Vina del Mar Chile ATP World Tour 250,CLAY,2,Federico Delbonis,Pablo Cuevas,Federico Delbonis,6-3; 6-4,R32,84,4,2,32,53,28,32,13,21,1,1,10,41,53,4,1,41,69,26,41,15,28,3,5,9,41,69
2014-02-03 00:00:00.000,Vina del Mar Chile ATP World Tour 250,CLAY,2,Guillermo Garcia-Lopez,Julian Reister,Guillermo Garcia-Lopez,3-6; 6-4; 6-4,R32,160,2,6,53,99,38,53,18,46,12,17,14,56,99,0,5,85,126,50,85,16,41,18,24,15,66,126
2014-02-03 00:00:00.000,Vina del Mar Chile ATP World Tour 250,CLAY,2,Paolo Lorenzi,Alejandro Gonzalez,Paolo Lorenzi,6-2; 6-1,R32,73,1,0,37,49,24,37,8,12,3,3,7,32,49,3,1,28,58,14,28,13,30,3,8,8,27,58
2014-02-03 00:00:00.000,Vina del Mar Chile ATP World Tour 250,CLAY,2,Santiago Giraldo,Ruben Ramirez Hidalgo,Santiago Giraldo,6-4; 6-2,R32,76,5,2,34,52,25,34,11,18,5,6,9,36,52,1,1,23,51,12,23,15,28,2,6,9,27,51
2014-02-03 00:00:00.000,Vina del Mar Chile ATP World Tour 250,CLAY,2,Marcel Granollers,N/A Bye,Marcel Granollers,,R32,0,0,0,0,0,0,0,0,0,0,0,0,0,0,0,0,0,0,0,0,0,0,0,0,0,0,0
2014-02-03 00:00:00.000,Vina del Mar Chile ATP World Tour 250,CLAY,2,Daniel Gimeno-Traver,Alexandr Dolgopolov,Daniel Gimeno-Traver,7-6(4); 3-6; 7-5,R32,126,8,3,63,106,51,63,21,43,3,6,17,72,106,7,1,49,95,36,49,32,46,4,6,16,68,95
2014-02-03 00:00:00.000,Vina del Mar Chile ATP World Tour 250,CLAY,2,Horacio Zeballos,Gonzalo Lama,Horacio Zeballos,6-3; 6-3,R32,61,6,0,26,42,20,26,16,16,0,0,9,36,42,3,2,34,54,20,34,12,20,4,7,9,32,54
2014-02-03 00:00:00.000,Vina del Mar Chile ATP World Tour 250,CLAY,2,Leonardo Mayer,Andreas Haider-Maurer,Leonardo Mayer,7-5; 7-5,R32,109,12,2,49,73,39,49,14,24,6,7,12,53,73,7,8,57,98,40,57,16,41,17,20,12,56,98
2014-02-03 00:00:00.000,Vina del Mar Chile ATP World Tour 250,CLAY,2,Tommy Robredo,N/A Bye,Tommy Robredo,,R32,0,0,0,0,0,0,0,0,0,0,0,0,0,0,0,0,0,0,0,0,0,0,0,0,0,0,0
2014-02-03 00:00:00.000,Vina del Mar Chile ATP World Tour 250,CLAY,2,Fabio Fognini,Aljaz Bedene,Fabio Fognini,6-4; 7-6(0),R16,101,4,0,36,59,31,36,16,23,1,2,11,47,59,3,1,50,83,33,50,16,33,4,6,11,49,83
2014-02-03 00:00:00.000,Vina del Mar Chile ATP World Tour 250,CLAY,2,Jeremy Chardy,Pablo Carreno Busta,Jeremy Chardy,6-3; 7-6(5),R16,88,10,3,39,59,34,39,12,20,2,2,10,46,59,2,1,69,84,45,69,7,15,6,8,11,52,84
2014-02-03 00:00:00.000,Vina del Mar Chile ATP World Tour 250,CLAY,2,Nicolas Almagro,Martin Alund,Nicolas Almagro,4-6; 6-3; 6-4,R16,99,11,1,44,71,40,44,18,27,0,1,15,58,71,2,5,50,86,35,50,21,36,1,3,14,56,86
2014-02-03 00:00:00.000,Vina del Mar Chile ATP World Tour 250,CLAY,2,Taro Daniel,Federico Delbonis,Taro Daniel,1-6; 7-6(5); 7-6(7),R16,172,2,1,84,113,49,84,15,29,7,12,15,64,113,11,5,84,121,59,84,15,37,8,11,16,74,121
2014-02-03 00:00:00.000,Vina del Mar Chile ATP World Tour 250,CLAY,2,Guillermo Garcia-Lopez,Paolo Lorenzi,Guillermo Garcia-Lopez,3-6; 7-5; 6-4,R16,156,5,1,62,104,39,62,20,42,6,11,15,59,104,4,0,55,95,36,55,19,40,3,9,16,55,95
2014-02-03 00:00:00.000,Vina del Mar Chile ATP World Tour 250,CLAY,2,Santiago Giraldo,Marcel Granollers,Santiago Giraldo,7-6(7); 7-6(2),R16,133,11,3,45,84,39,45,18,39,2,4,12,57,84,3,1,55,89,39,55,17,34,1,3,12,56,89
2014-02-03 00:00:00.000,Vina del Mar Chile ATP World Tour 250,CLAY,2,Daniel Gimeno-Traver,Horacio Zeballos,Daniel Gimeno-Traver,6-2; 6-4,R16,80,9,0,40,59,32,40,11,19,5,5,9,43,59,1,1,42,61,24,42,11,19,6,9,9,35,61
2014-02-03 00:00:00.000,Vina del Mar Chile ATP World Tour 250,CLAY,2,Leonardo Mayer,Tommy Robredo,Leonardo Mayer,3-6; 7-6(8); 6-4,R16,140,5,4,56,85,44,56,21,29,1,2,15,65,85,7,3,65,106,49,65,23,41,2,3,16,72,106
2014-02-03 00:00:00.000,Vina del Mar Chile ATP World Tour 250,CLAY,2,Fabio Fognini,Jeremy Chardy,Fabio Fognini,6-4; 3-6; 6-2,Q,115,2,2,54,81,35,54,17,27,3,5,13,52,81,7,5,55,96,38,55,18,41,8,12,14,56,96
2014-02-03 00:00:00.000,Vina del Mar Chile ATP World Tour 250,CLAY,2,Nicolas Almagro,Taro Daniel,Nicolas Almagro,6-2; 7-5,Q,81,12,2,22,47,21,22,17,25,2,3,10,38,47,1,1,40,70,26,40,12,30,2,6,10,38,70
2014-02-03 00:00:00.000,Vina del Mar Chile ATP World Tour 250,CLAY,2,Santiago Giraldo,Guillermo Garcia-Lopez,Santiago Giraldo,3-6; 6-4; 6-2,Q,122,5,1,62,99,47,62,15,37,8,10,14,62,99,4,6,53,86,36,53,15,33,6,9,13,51,86
2014-02-03 00:00:00.000,Vina del Mar Chile ATP World Tour 250,CLAY,2,Leonardo Mayer,Daniel Gimeno-Traver,Leonardo Mayer,3-6; 7-5; 6-3,Q,110,4,7,48,80,38,48,17,32,2,5,15,55,80,6,2,46,82,37,46,15,36,2,6,15,52,82
2014-02-03 00:00:00.000,Vina del Mar Chile ATP World Tour 250,CLAY,2,Fabio Fognini,Nicolas Almagro,Fabio Fognini,6-4; 1-6; 7-6(5),S,131,8,4,51,94,36,51,19,43,6,11,14,55,94,11,1,54,93,39,54,22,39,6,10,15,61,93
2014-02-03 00:00:00.000,Vina del Mar Chile ATP World Tour 250,CLAY,2,Leonardo Mayer,Santiago Giraldo,Leonardo Mayer,7-6(2); 6-3,S,91,6,2,34,58,26,34,18,24,0,1,10,44,58,2,2,37,69,26,37,16,32,0,3,11,42,69
2014-02-03 00:00:00.000,Vina del Mar Chile ATP World Tour 250,CLAY,2,Fabio Fognini,Leonardo Mayer,Fabio Fognini,6-2; 6-4,F,83,5,1,34,45,30,34,8,11,0,0,9,38,45,0,2,58,88,36,58,12,30,10,13,9,48,88
2014-02-03 00:00:00.000,Zagreb Croatia ATP World Tour 250,HARD,2,Tommy Haas,N/A Bye,Tommy Haas,,R32,0,0,0,0,0,0,0,0,0,0,0,0,0,0,0,0,0,0,0,0,0,0,0,0,0,0,0
2014-02-03 00:00:00.000,Zagreb Croatia ATP World Tour 250,HARD,2,Benjamin Becker,Jesse Huta Galung,Benjamin Becker,6-7(4); 6-3; 7-6(6),R32,142,12,0,59,109,46,59,27,50,3,5,17,73,109,19,8,75,121,51,75,24,46,5,8,16,75,121
2014-02-03 00:00:00.000,Zagreb Croatia ATP World Tour 250,HARD,2,Andrey Kuznetsov,Sergiy Stakhovsky,Andrey Kuznetsov,6-4; 7-6(8),R32,89,2,3,43,73,32,43,20,30,0,1,11,52,73,5,3,51,77,40,51,8,26,1,3,11,48,77
2014-02-03 00:00:00.000,Zagreb Croatia ATP World Tour 250,HARD,2,Igor Sijsling,Blaz Kavcic,Igor Sijsling,6-7(4); 6-3; 6-4,R32,121,13,0,57,99,40,57,25,42,3,5,16,65,99,7,4,54,90,38,54,16,36,5,9,15,54,90
2014-02-03 00:00:00.000,Zagreb Croatia ATP World Tour 250,HARD,2,Philipp Kohlschreiber,N/A Bye,Philipp Kohlschreiber,,R32,0,0,0,0,0,0,0,0,0,0,0,0,0,0,0,0,0,0,0,0,0,0,0,0,0,0,0
2014-02-03 00:00:00.000,Zagreb Croatia ATP World Tour 250,HARD,2,Andrey Golubev,Victor Hanescu,Andrey Golubev,7-6(6); 4-6; 7-6(5),R32,142,3,4,77,115,57,77,23,38,8,10,17,80,115,6,0,83,99,65,83,9,16,1,2,17,74,99
2014-02-03 00:00:00.000,Zagreb Croatia ATP World Tour 250,HARD,2,Michael Berrer,Borna Coric,Michael Berrer,6-4; 3-6; 6-4,R32,144,8,2,56,93,41,56,19,37,4,7,15,60,93,5,3,52,96,36,52,22,44,3,6,14,58,96
2014-02-03 00:00:00.000,Zagreb Croatia ATP World Tour 250,HARD,2,Daniel Evans,Jan Hajek,Daniel Evans,6-3; 6-1,R32,51,8,0,22,38,21,22,11,16,0,0,8,32,38,2,1,36,50,23,36,4,14,2,6,8,27,50
2014-02-03 00:00:00.000,Zagreb Croatia ATP World Tour 250,HARD,2,Marin Cilic,Mate Delic,Marin Cilic,6-4; 6-4,R32,71,14,0,34,50,31,34,10,16,2,2,10,41,50,3,1,46,66,32,46,9,20,3,5,10,41,66
2014-02-03 00:00:00.000,Zagreb Croatia ATP World Tour 250,HARD,2,Dusan Lajovic,Pedja Krstin,Dusan Lajovic,6-2; 6-3,R32,58,8,1,32,51,24,32,11,19,2,2,8,35,51,3,2,28,45,17,28,8,17,1,5,9,25,45
2014-02-03 00:00:00.000,Zagreb Croatia ATP World Tour 250,HARD,2,Ivo Karlovic,Daniel Brands,Ivo Karlovic,6-7(4); 7-5; 7-6(3),R32,117,44,2,69,93,63,69,18,24,0,0,18,81,93,15,0,86,119,66,86,22,33,5,6,18,88,119
2014-02-03 00:00:00.000,Zagreb Croatia ATP World Tour 250,HARD,2,Ivan Dodig,N/A Bye,Ivan Dodig,,R32,0,0,0,0,0,0,0,0,0,0,0,0,0,0,0,0,0,0,0,0,0,0,0,0,0,0,0
2014-02-03 00:00:00.000,Zagreb Croatia ATP World Tour 250,HARD,2,Dudi Sela,Lukas Rosol,Dudi Sela,6-3; 7-6(2),R32,92,2,4,59,92,37,59,17,33,6,8,11,54,92,2,3,35,70,21,35,17,35,3,6,10,38,70
2014-02-03 00:00:00.000,Zagreb Croatia ATP World Tour 250,HARD,2,Lukas Lacko,Jan-Lennard Struff,Lukas Lacko,6-4; 6-4,R32,62,10,1,32,50,27,32,10,18,0,1,10,37,50,5,5,34,62,22,34,16,28,1,4,10,38,62
2014-02-03 00:00:00.000,Zagreb Croatia ATP World Tour 250,HARD,2,Bjorn Phau,Ante Pavic,Bjorn Phau,6-3; 6-4,R32,66,5,2,30,52,24,30,14,22,1,2,9,38,52,3,6,31,59,21,31,11,28,3,7,10,32,59
2014-02-03 00:00:00.000,Zagreb Croatia ATP World Tour 250,HARD,2,Mikhail Youzhny,N/A Bye,Mikhail Youzhny,,R32,0,0,0,0,0,0,0,0,0,0,0,0,0,0,0,0,0,0,0,0,0,0,0,0,0,0,0
2014-02-03 00:00:00.000,Zagreb Croatia ATP World Tour 250,HARD,2,Tommy Haas,Benjamin Becker,Tommy Haas,4-6; 6-3; 6-3,R16,107,11,2,58,85,46,58,12,27,1,3,14,58,85,10,2,52,82,36,52,15,30,4,8,14,51,82
2014-02-03 00:00:00.000,Zagreb Croatia ATP World Tour 250,HARD,2,Andrey Kuznetsov,Igor Sijsling,Andrey Kuznetsov,1-6; 6-3; 7-6(5),R16,104,8,2,70,109,53,70,16,39,11,13,14,69,109,8,3,50,89,42,50,17,39,2,3,14,59,89
2014-02-03 00:00:00.000,Zagreb Croatia ATP World Tour 250,HARD,2,Philipp Kohlschreiber,Andrey Golubev,Philipp Kohlschreiber,6-4; 6-2,R16,68,6,0,21,42,20,21,16,21,0,0,9,36,42,3,2,47,68,29,47,9,21,5,8,9,38,68
2014-02-03 00:00:00.000,Zagreb Croatia ATP World Tour 250,HARD,2,Daniel Evans,Michael Berrer,Daniel Evans,1-6; 6-1; 7-6(4),R16,97,10,2,42,73,33,42,18,31,0,2,13,51,73,10,1,58,76,42,58,11,18,3,5,13,53,76
2014-02-03 00:00:00.000,Zagreb Croatia ATP World Tour 250,HARD,2,Marin Cilic,Dusan Lajovic,Marin Cilic,6-4; 7-5,R16,98,12,1,42,65,33,42,12,23,3,4,11,45,65,1,6,47,80,31,47,14,33,7,10,11,45,80
2014-02-03 00:00:00.000,Zagreb Croatia ATP World Tour 250,HARD,2,Ivan Dodig,Ivo Karlovic,Ivan Dodig,7-6(5); 6-3,R16,80,6,4,56,73,44,56,10,17,7,7,11,54,73,12,0,41,57,33,41,9,16,0,1,10,42,57
2014-02-03 00:00:00.000,Zagreb Croatia ATP World Tour 250,HARD,2,Dudi Sela,Lukas Lacko,Dudi Sela,6-3; 6-2,R16,51,3,1,33,52,27,33,8,19,1,2,9,35,52,0,3,26,39,18,26,2,13,0,4,8,20,39
2014-02-03 00:00:00.000,Zagreb Croatia ATP World Tour 250,HARD,2,Bjorn Phau,Mikhail Youzhny,Bjorn Phau,4-6; 7-5; 6-1,R16,132,4,5,47,92,34,47,23,45,5,8,14,57,92,7,2,66,106,40,66,19,40,9,15,15,59,106
2014-02-03 00:00:00.000,Zagreb Croatia ATP World Tour 250,HARD,2,Tommy Haas,Andrey Kuznetsov,Tommy Haas,7-6(6); 6-4,Q,85,9,1,60,78,47,60,9,18,2,2,11,56,78,10,3,45,65,35,45,11,20,0,1,11,46,65
2014-02-03 00:00:00.000,Zagreb Croatia ATP World Tour 250,HARD,2,Daniel Evans,Philipp Kohlschreiber,Daniel Evans,6-4; 2-6; 6-4,Q,120,5,1,60,109,42,60,24,49,6,8,14,66,109,10,2,59,95,44,59,17,36,4,6,14,61,95
2014-02-03 00:00:00.000,Zagreb Croatia ATP World Tour 250,HARD,2,Marin Cilic,Ivan Dodig,Marin Cilic,7-5; 6-4,Q,92,6,1,48,70,36,48,9,22,5,7,11,45,70,2,2,36,61,27,36,10,25,1,5,11,37,61
2014-02-03 00:00:00.000,Zagreb Croatia ATP World Tour 250,HARD,2,Bjorn Phau,Dudi Sela,Bjorn Phau,6-4; 6-3,Q,69,1,1,24,49,18,24,15,25,3,5,9,33,49,0,2,30,58,18,30,12,28,1,6,10,30,58
2014-02-03 00:00:00.000,Zagreb Croatia ATP World Tour 250,HARD,2,Tommy Haas,Daniel Evans,Tommy Haas,5-7; 6-4; 6-3,S,119,7,0,57,89,46,57,17,32,4,6,16,63,89,7,2,56,95,40,56,19,39,5,8,15,59,95
2014-02-03 00:00:00.000,Zagreb Croatia ATP World Tour 250,HARD,2,Marin Cilic,Bjorn Phau,Marin Cilic,6-3; 6-4,S,84,6,3,31,63,25,31,15,32,3,5,10,40,63,2,5,37,64,22,37,11,27,6,10,9,33,64
2014-02-03 00:00:00.000,Zagreb Croatia ATP World Tour 250,HARD,2,Marin Cilic,Tommy Haas,Marin Cilic,6-3; 6-4,F,80,10,4,31,60,25,31,15,29,2,3,10,40,60,2,0,37,56,21,37,12,19,5,8,9,33,56
2014-02-10 00:00:00.000,Buenos Aires Argentina ATP World Tour 250,CLAY,2,David Ferrer,Maximo Gonzalez,David Ferrer,7-6(7); 6-4,R32,124,1,1,48,76,35,48,12,28,2,5,11,47,76,2,0,59,86,34,59,14,27,5,9,11,48,86
2014-02-10 00:00:00.000,Buenos Aires Argentina ATP World Tour 250,CLAY,2,Santiago Giraldo,Albert Montanes,Santiago Giraldo,7-6(4); 6-2,R32,110,4,0,39,82,32,39,21,43,8,8,10,53,82,1,3,45,75,32,45,12,30,4,6,10,44,75
2014-02-10 00:00:00.000,Buenos Aires Argentina ATP World Tour 250,CLAY,2,Filippo Volandri,Christian Garin,Filippo Volandri,5-7; 6-0; 6-3,R32,114,2,1,76,97,47,76,9,21,6,10,14,56,97,2,4,56,88,32,56,10,32,7,14,13,42,88
2014-02-10 00:00:00.000,Buenos Aires Argentina ATP World Tour 250,CLAY,2,Albert Ramos-Vinolas,Juan Monaco,Albert Ramos-Vinolas,6-7(3); 6-4; 6-2,R32,140,4,0,65,92,41,65,19,27,2,4,15,60,92,1,1,76,96,49,76,9,20,2,7,15,58,96
2014-02-10 00:00:00.000,Buenos Aires Argentina ATP World Tour 250,CLAY,2,Nicolas Almagro,Horacio Zeballos,Nicolas Almagro,6-2; 7-5,R32,89,9,3,36,62,29,36,15,26,4,4,10,44,62,4,1,42,73,26,42,16,31,5,8,10,42,73
2014-02-10 00:00:00.000,Buenos Aires Argentina ATP World Tour 250,CLAY,2,Daniel Gimeno-Traver,Ruben Ramirez Hidalgo,Daniel Gimeno-Traver,7-5; 6-2,R32,99,8,2,31,59,24,31,15,28,1,2,10,39,59,0,5,35,68,22,35,15,33,4,8,10,37,68
2014-02-10 00:00:00.000,Buenos Aires Argentina ATP World Tour 250,CLAY,2,Alexandr Dolgopolov,Pablo Cuevas,Alexandr Dolgopolov,6-3; 4-6; 7-6(5),R32,122,10,1,58,103,43,58,26,45,5,7,16,69,103,2,11,52,93,43,52,18,41,1,3,15,61,93
2014-02-10 00:00:00.000,Buenos Aires Argentina ATP World Tour 250,CLAY,2,Jeremy Chardy,Alejandro Gonzalez,Jeremy Chardy,6-4; 7-5,R32,102,5,2,35,67,24,35,18,32,4,6,11,42,67,3,1,51,82,30,51,15,31,10,14,11,45,82
2014-02-10 00:00:00.000,Buenos Aires Argentina ATP World Tour 250,CLAY,2,Robin Haase,Martin Alund,Robin Haase,6-4; 6-7(6); 6-3,R32,145,4,2,52,96,42,52,25,44,2,3,16,67,96,5,3,70,111,47,70,22,41,9,12,15,69,111
2014-02-10 00:00:00.000,Buenos Aires Argentina ATP World Tour 250,CLAY,2,Carlos Berlocq,Joao Sousa,Carlos Berlocq,6-4; 6-2,R32,86,1,0,38,53,24,38,12,15,1,2,9,36,53,1,3,28,55,19,28,10,27,3,7,9,29,55
2014-02-10 00:00:00.000,Buenos Aires Argentina ATP World Tour 250,CLAY,2,Guido Pella,Guillermo Garcia-Lopez,Guido Pella,7-6(6); 6-4,R32,105,2,1,49,71,40,49,11,22,4,5,11,51,71,2,3,53,88,39,53,15,35,5,7,11,54,88
2014-02-10 00:00:00.000,Buenos Aires Argentina ATP World Tour 250,CLAY,2,Tommy Robredo,Pablo Carreno Busta,Tommy Robredo,6-4; 6-4,R32,86,1,2,40,63,30,40,10,23,6,8,10,40,63,0,1,42,56,25,42,6,14,3,7,10,31,56
2014-02-10 00:00:00.000,Buenos Aires Argentina ATP World Tour 250,CLAY,2,Marcel Granollers,Aljaz Bedene,Marcel Granollers,7-5; 3-6; 6-2,R32,169,2,2,49,74,29,49,15,25,0,4,14,44,74,3,2,59,115,40,59,22,56,8,14,15,62,115
2014-02-10 00:00:00.000,Buenos Aires Argentina ATP World Tour 250,CLAY,2,Pablo Andujar,Federico Delbonis,Pablo Andujar,3-6; 7-5; 6-1,R32,135,2,3,64,92,44,64,17,28,11,13,14,61,92,5,4,64,99,42,64,15,35,5,9,14,57,99
2014-02-10 00:00:00.000,Buenos Aires Argentina ATP World Tour 250,CLAY,2,Leonardo Mayer,Facundo Arguello,Leonardo Mayer,6-3; 6-4,R32,88,0,2,34,57,23,34,14,23,0,2,9,37,57,0,0,40,62,19,40,11,22,2,7,10,30,62
2014-02-10 00:00:00.000,Buenos Aires Argentina ATP World Tour 250,CLAY,2,Fabio Fognini,Julian Reister,Fabio Fognini,7-5; 6-2,R32,86,1,3,48,75,30,48,11,27,13,17,10,41,75,0,2,39,58,20,39,5,19,6,13,10,25,58
2014-02-10 00:00:00.000,Buenos Aires Argentina ATP World Tour 250,CLAY,2,David Ferrer,Santiago Giraldo,David Ferrer,6-4; 7-6(1),R16,112,1,1,58,79,33,58,11,21,6,10,11,44,79,4,2,49,92,30,49,16,43,11,16,11,46,92
2014-02-10 00:00:00.000,Buenos Aires Argentina ATP World Tour 250,CLAY,2,Albert Ramos-Vinolas,Filippo Volandri,Albert Ramos-Vinolas,6-2; 6-1,R16,59,3,0,32,42,24,32,6,10,2,3,8,30,42,0,2,37,51,17,37,6,14,1,6,7,23,51
2014-02-10 00:00:00.000,Buenos Aires Argentina ATP World Tour 250,CLAY,2,Nicolas Almagro,Daniel Gimeno-Traver,Nicolas Almagro,1-6; 7-5; 6-4,R16,118,4,2,70,99,43,70,17,29,7,11,15,60,99,5,0,43,75,29,43,21,32,2,5,14,50,75
2014-02-10 00:00:00.000,Buenos Aires Argentina ATP World Tour 250,CLAY,2,Jeremy Chardy,Alexandr Dolgopolov,Jeremy Chardy,6-3; 3-6; 7-6(3),R16,106,6,3,61,92,49,61,16,31,4,5,15,65,92,8,2,58,87,44,58,17,29,3,4,15,61,87
2014-02-10 00:00:00.000,Buenos Aires Argentina ATP World Tour 250,CLAY,2,Robin Haase,Carlos Berlocq,Robin Haase,6-2; 6-7(4); 6-2,R16,128,4,2,56,85,45,56,18,29,4,4,14,63,85,4,2,72,93,51,72,9,21,7,11,14,60,93
2014-02-10 00:00:00.000,Buenos Aires Argentina ATP World Tour 250,CLAY,2,Tommy Robredo,Guido Pella,Tommy Robredo,4-6; 6-1; 6-4,R16,94,12,3,42,73,37,42,19,31,1,2,14,56,73,2,3,46,81,33,46,18,35,5,8,13,51,81
2014-02-10 00:00:00.000,Buenos Aires Argentina ATP World Tour 250,CLAY,2,Pablo Andujar,Marcel Granollers,Pablo Andujar,6-3; 6-0,R16,74,1,4,25,41,20,25,7,16,2,3,7,27,41,2,3,29,55,17,29,7,26,9,15,8,24,55
2014-02-10 00:00:00.000,Buenos Aires Argentina ATP World Tour 250,CLAY,2,Fabio Fognini,Leonardo Mayer,Fabio Fognini,6-7(4); 6-3; 6-2,R16,139,2,5,85,127,60,85,17,42,12,13,15,77,127,1,3,60,83,40,60,12,23,4,8,14,52,83
2014-02-10 00:00:00.000,Buenos Aires Argentina ATP World Tour 250,CLAY,2,David Ferrer,Albert Ramos-Vinolas,David Ferrer,6-1; 6-2,Q,70,0,3,32,53,23,32,12,21,2,3,8,35,53,0,1,35,49,17,35,5,14,2,7,7,22,49
2014-02-10 00:00:00.000,Buenos Aires Argentina ATP World Tour 250,CLAY,2,Nicolas Almagro,Jeremy Chardy,Nicolas Almagro,7-6(7); 6-3,Q,104,4,1,54,84,37,54,17,30,5,8,11,54,84,3,1,47,66,28,47,11,19,0,4,10,39,66
2014-02-10 00:00:00.000,Buenos Aires Argentina ATP World Tour 250,CLAY,2,Tommy Robredo,Robin Haase,Tommy Robredo,6-1; 2-0 RET,Q,41,1,0,13,18,12,13,4,5,0,0,4,16,18,1,1,28,40,12,28,5,12,6,10,5,17,40
2014-02-10 00:00:00.000,Buenos Aires Argentina ATP World Tour 250,CLAY,2,Fabio Fognini,Pablo Andujar,Fabio Fognini,6-4; 6-3,Q,94,2,2,34,61,27,34,15,27,3,4,10,42,61,0,2,40,63,25,40,10,23,7,10,9,35,63
2014-02-10 00:00:00.000,Buenos Aires Argentina ATP World Tour 250,CLAY,2,David Ferrer,Nicolas Almagro,David Ferrer,6-4; 6-2,S,87,0,2,53,76,36,53,12,23,6,7,9,48,76,0,0,27,51,18,27,10,24,1,5,9,28,51
2014-02-10 00:00:00.000,Buenos Aires Argentina ATP World Tour 250,CLAY,2,Fabio Fognini,Tommy Robredo,Fabio Fognini,3-6; 7-5; 6-3,S,119,2,3,56,87,38,56,14,31,2,6,15,52,87,3,4,61,88,39,61,13,27,8,13,15,52,88
2014-02-10 00:00:00.000,Buenos Aires Argentina ATP World Tour 250,CLAY,2,David Ferrer,Fabio Fognini,David Ferrer,6-4; 6-3,F,74,0,2,39,54,26,39,11,15,0,1,10,37,54,2,3,34,52,24,34,5,18,2,5,9,29,52
2014-02-10 00:00:00.000,Memphis TN; U.S.A. ATP World Tour 250,HARD,2,Kei Nishikori,N/A Bye,Kei Nishikori,,R32,0,0,0,0,0,0,0,0,0,0,0,0,0,0,0,0,0,0,0,0,0,0,0,0,0,0,0
2014-02-10 00:00:00.000,Memphis TN; U.S.A. ATP World Tour 250,HARD,2,Benjamin Becker,Lukas Lacko,Benjamin Becker,6-3; 6-2,R32,69,5,1,35,62,30,35,12,27,3,3,9,42,62,6,1,30,54,21,30,10,24,4,7,8,31,54
2014-02-10 00:00:00.000,Memphis TN; U.S.A. ATP World Tour 250,HARD,2,Ryan Harrison,Bjorn Phau,Ryan Harrison,6-3; 6-4,R32,68,2,2,36,56,31,36,12,20,3,3,10,43,56,3,3,34,59,21,34,15,25,3,5,9,36,59
2014-02-10 00:00:00.000,Memphis TN; U.S.A. ATP World Tour 250,HARD,2,Alex Bogomolov Jr.,Sam Querrey,Alex Bogomolov Jr.,2-6; 6-4; 7-6(7),R32,122,2,5,79,103,49,79,13,24,6,10,15,62,103,18,2,54,98,44,54,17,44,3,6,15,61,98
2014-02-10 00:00:00.000,Memphis TN; U.S.A. ATP World Tour 250,HARD,2,Lleyton Hewitt,N/A Bye,Lleyton Hewitt,,R32,0,0,0,0,0,0,0,0,0,0,0,0,0,0,0,0,0,0,0,0,0,0,0,0,0,0,0
2014-02-10 00:00:00.000,Memphis TN; U.S.A. ATP World Tour 250,HARD,2,Marcos Baghdatis,Rajeev Ram,Marcos Baghdatis,6-3; 6-4,R32,75,10,5,30,60,22,30,19,30,4,5,10,41,60,1,1,36,53,23,36,6,17,4,7,9,29,53
2014-02-10 00:00:00.000,Memphis TN; U.S.A. ATP World Tour 250,HARD,2,Tim Smyczek,Nick Kyrgios,Tim Smyczek,6-7(5); 6-4; 6-3,R32,115,4,6,62,103,42,62,21,41,1,4,16,63,103,1,5,63,101,37,63,20,38,5,10,15,57,101
2014-02-10 00:00:00.000,Memphis TN; U.S.A. ATP World Tour 250,HARD,2,Michael Russell,Michal Przysiezny,Michael Russell,3-6; 6-3; 6-1,R32,115,1,6,50,88,31,50,20,38,6,10,13,51,88,6,9,48,96,31,48,17,48,6,12,12,48,96
2014-02-10 00:00:00.000,Memphis TN; U.S.A. ATP World Tour 250,HARD,2,Mikhail Kukushkin,Teymuraz Gabashvili,Mikhail Kukushkin,7-6(9); 7-5,R32,112,6,1,50,82,36,50,18,32,2,4,12,54,82,6,3,50,88,34,50,17,38,5,8,12,51,88
2014-02-10 00:00:00.000,Memphis TN; U.S.A. ATP World Tour 250,HARD,2,Alex Kuznetsov,David Goffin,Alex Kuznetsov,6-4; 6-3,R32,71,14,2,32,46,28,32,6,14,2,3,9,34,46,5,4,33,65,26,33,9,32,4,8,10,35,65
2014-02-10 00:00:00.000,Memphis TN; U.S.A. ATP World Tour 250,HARD,2,Denis Kudla,Donald Young,Denis Kudla,6-1; 6-1,R32,60,0,0,29,43,21,29,10,14,2,2,7,31,43,0,4,31,53,14,31,8,22,4,9,7,22,53
2014-02-10 00:00:00.000,Memphis TN; U.S.A. ATP World Tour 250,HARD,2,Yen-Hsun Lu,N/A Bye,Yen-Hsun Lu,,R32,0,0,0,0,0,0,0,0,0,0,0,0,0,0,0,0,0,0,0,0,0,0,0,0,0,0,0
2014-02-10 00:00:00.000,Memphis TN; U.S.A. ATP World Tour 250,HARD,2,Jiri Vesely,Marinko Matosevic,Jiri Vesely,6-3; 6-2,R32,71,5,3,34,58,26,34,12,24,0,1,9,38,58,1,2,27,49,19,27,8,22,3,7,8,27,49
2014-02-10 00:00:00.000,Memphis TN; U.S.A. ATP World Tour 250,HARD,2,Jack Sock,Adrian Mannarino,Jack Sock,7-5; 1-6; 7-6(5),R32,122,10,5,51,88,39,51,15,37,3,8,15,54,88,7,5,53,93,39,53,21,40,2,6,16,60,93
2014-02-10 00:00:00.000,Memphis TN; U.S.A. ATP World Tour 250,HARD,2,Ivo Karlovic,Matthew Ebden,Ivo Karlovic,7-5; 6-4,R32,82,14,3,48,63,39,48,8,15,0,0,11,47,63,2,7,35,66,30,35,13,31,3,5,11,43,66
2014-02-10 00:00:00.000,Memphis TN; U.S.A. ATP World Tour 250,HARD,2,Feliciano Lopez,N/A Bye,Feliciano Lopez,,R32,0,0,0,0,0,0,0,0,0,0,0,0,0,0,0,0,0,0,0,0,0,0,0,0,0,0,0
2014-02-10 00:00:00.000,Memphis TN; U.S.A. ATP World Tour 250,HARD,2,Kei Nishikori,Benjamin Becker,Kei Nishikori,6-4; 6-4,R16,85,4,2,42,64,28,42,10,22,5,8,10,38,64,2,1,31,64,20,31,12,33,3,8,10,32,64
2014-02-10 00:00:00.000,Memphis TN; U.S.A. ATP World Tour 250,HARD,2,Alex Bogomolov Jr.,Ryan Harrison,Alex Bogomolov Jr.,6-3; 2-6; 6-2,R16,111,2,5,71,102,42,71,19,31,9,12,13,61,102,7,3,44,70,30,44,12,26,3,7,12,42,70
2014-02-10 00:00:00.000,Memphis TN; U.S.A. ATP World Tour 250,HARD,2,Lleyton Hewitt,Marcos Baghdatis,Lleyton Hewitt,1-6; 6-2; 6-0,R16,91,1,3,35,66,26,35,14,31,1,3,10,40,66,4,4,22,62,14,22,17,40,1,6,11,31,62
2014-02-10 00:00:00.000,Memphis TN; U.S.A. ATP World Tour 250,HARD,2,Michael Russell,Tim Smyczek,Michael Russell,6-2; 7-6(5),R16,88,1,2,45,72,34,45,12,27,4,6,10,46,72,2,2,44,62,28,44,7,18,4,8,10,35,62
2014-02-10 00:00:00.000,Memphis TN; U.S.A. ATP World Tour 250,HARD,2,Alex Kuznetsov,Mikhail Kukushkin,Alex Kuznetsov,2-6; 6-3; 7-6(1),R16,122,15,4,63,97,50,63,16,34,4,7,15,66,97,6,4,48,93,31,48,27,45,6,8,14,58,93
2014-02-10 00:00:00.000,Memphis TN; U.S.A. ATP World Tour 250,HARD,2,Yen-Hsun Lu,Denis Kudla,Yen-Hsun Lu,3-6; 6-3; 6-3,R16,117,4,5,60,97,40,60,16,37,10,14,14,56,97,2,1,60,93,35,60,15,33,14,19,13,50,93
2014-02-10 00:00:00.000,Memphis TN; U.S.A. ATP World Tour 250,HARD,2,Jack Sock,Jiri Vesely,Jack Sock,6-2; 6-1,R16,69,5,6,23,56,18,23,18,33,7,8,8,36,56,2,6,28,52,15,28,8,24,6,11,7,23,52
2014-02-10 00:00:00.000,Memphis TN; U.S.A. ATP World Tour 250,HARD,2,Ivo Karlovic,Feliciano Lopez,Ivo Karlovic,7-6(2); 6-4,R16,70,19,1,37,55,35,37,14,18,0,0,11,49,55,4,2,40,62,31,40,14,22,3,4,11,45,62
2014-02-10 00:00:00.000,Memphis TN; U.S.A. ATP World Tour 250,HARD,2,Kei Nishikori,Alex Bogomolov Jr.,Kei Nishikori,3-6; 6-3; 6-2,Q,138,5,3,57,94,40,57,15,37,5,9,13,55,94,1,2,53,93,27,53,21,40,9,15,13,48,93
2014-02-10 00:00:00.000,Memphis TN; U.S.A. ATP World Tour 250,HARD,2,Michael Russell,Lleyton Hewitt,Michael Russell,6-3; 7-6(6),Q,108,2,6,40,74,26,40,15,34,2,6,11,41,74,2,6,37,73,25,37,14,36,4,9,10,39,73
2014-02-10 00:00:00.000,Memphis TN; U.S.A. ATP World Tour 250,HARD,2,Yen-Hsun Lu,Alex Kuznetsov,Yen-Hsun Lu,6-1; 6-4,Q,74,6,3,32,49,24,32,9,17,2,3,8,33,49,6,3,33,60,22,33,8,27,6,11,9,30,60
2014-02-10 00:00:00.000,Memphis TN; U.S.A. ATP World Tour 250,HARD,2,Ivo Karlovic,Jack Sock,Ivo Karlovic,7-6(4); 6-7(3); 6-3,Q,145,16,7,66,104,56,66,23,38,5,5,16,79,104,5,9,85,125,68,85,17,40,9,11,17,85,125
2014-02-10 00:00:00.000,Memphis TN; U.S.A. ATP World Tour 250,HARD,2,Kei Nishikori,Michael Russell,Kei Nishikori,6-3; 6-2,S,64,6,3,28,47,22,28,12,19,1,2,9,34,47,1,1,30,46,16,30,6,16,0,4,8,22,46
2014-02-10 00:00:00.000,Memphis TN; U.S.A. ATP World Tour 250,HARD,2,Ivo Karlovic,Yen-Hsun Lu,Ivo Karlovic,6-1 RET,S,29,7,1,10,17,10,10,6,7,0,0,4,16,17,0,2,23,34,11,23,5,11,6,8,3,16,34
2014-02-10 00:00:00.000,Memphis TN; U.S.A. ATP World Tour 250,HARD,2,Kei Nishikori,Ivo Karlovic,Kei Nishikori,6-4; 7-6(0),F,90,8,2,44,68,38,44,15,24,2,2,11,53,68,20,3,57,75,44,57,6,18,8,9,11,50,75
2014-02-10 00:00:00.000,Rotterdam The Netherlands ATP World Tour 500,HARD,2,Juan Martin Del Potro,Gael Monfils,Juan Martin Del Potro,7-6(6); 6-3,R32,101,2,4,53,78,39,53,13,25,3,5,11,52,78,7,2,36,61,28,36,11,25,1,4,10,39,61
2014-02-10 00:00:00.000,Rotterdam The Netherlands ATP World Tour 500,HARD,2,Paul-Henri Mathieu,Ivan Dodig,Paul-Henri Mathieu,4-6; 7-6(2); 6-4,R32,135,4,0,58,104,43,58,28,46,5,6,16,71,104,21,4,51,87,49,51,15,36,2,3,16,64,87
2014-02-10 00:00:00.000,Rotterdam The Netherlands ATP World Tour 500,HARD,2,Ernests Gulbis,Denis Istomin,Ernests Gulbis,6-4; 7-6(4),R32,91,7,1,36,61,29,36,16,25,2,4,11,45,61,3,2,53,71,33,53,9,18,2,5,11,42,71
2014-02-10 00:00:00.000,Rotterdam The Netherlands ATP World Tour 500,HARD,2,Grigor Dimitrov,Dmitry Tursunov,Grigor Dimitrov,6-2; 1-6; 6-4,R32,120,7,2,36,72,25,36,18,36,3,7,12,43,72,3,3,46,85,30,46,19,39,9,14,13,49,85
2014-02-10 00:00:00.000,Rotterdam The Netherlands ATP World Tour 500,HARD,2,Tomas Berdych,Andreas Seppi,Tomas Berdych,6-3; 6-3,R32,66,9,0,31,43,27,31,9,12,0,0,9,36,43,2,1,39,61,24,39,10,22,7,10,9,34,61
2014-02-10 00:00:00.000,Rotterdam The Netherlands ATP World Tour 500,HARD,2,Nicolas Mahut,Daniel Brands,Nicolas Mahut,7-5; 6-3,R32,71,13,4,38,60,35,38,11,22,2,2,11,46,60,6,0,46,60,29,46,10,14,2,4,10,39,60
2014-02-10 00:00:00.000,Rotterdam The Netherlands ATP World Tour 500,HARD,2,Jerzy Janowicz,Julien Benneteau,Jerzy Janowicz,3-6; 6-4; 6-4,R32,116,5,2,49,87,38,49,22,38,1,3,15,60,87,8,1,62,83,44,62,11,21,3,5,14,55,83
2014-02-10 00:00:00.000,Rotterdam The Netherlands ATP World Tour 500,HARD,2,Tommy Haas,Fernando Verdasco,Tommy Haas,6-7(4); 7-6(1); 7-5,R32,150,2,3,75,106,53,75,20,31,3,7,18,73,106,10,6,76,119,53,76,21,43,5,10,18,74,119
2014-02-10 00:00:00.000,Rotterdam The Netherlands ATP World Tour 500,HARD,2,Igor Sijsling,Mikhail Youzhny,Igor Sijsling,6-2; 6-2,R32,74,9,1,36,49,29,36,6,13,1,1,8,35,49,0,3,46,73,26,46,11,27,8,12,8,37,73
2014-02-10 00:00:00.000,Rotterdam The Netherlands ATP World Tour 500,HARD,2,Michael Berrer,Jesse Huta Galung,Michael Berrer,6-4; 2-6; 6-3,R32,118,4,0,71,97,49,71,11,26,5,8,14,60,97,11,4,41,74,31,41,17,33,4,7,13,48,74
2014-02-10 00:00:00.000,Rotterdam The Netherlands ATP World Tour 500,HARD,2,Philipp Kohlschreiber,Sergiy Stakhovsky,Philipp Kohlschreiber,6-2; 7-5,R32,65,4,0,24,50,21,24,19,26,0,0,10,40,50,5,0,45,59,27,45,8,14,3,6,10,35,59
2014-02-10 00:00:00.000,Rotterdam The Netherlands ATP World Tour 500,HARD,2,Richard Gasquet,Thiemo de Bakker,Richard Gasquet,6-7(5); 7-6(2); 6-3,R32,144,13,1,78,106,62,78,18,28,5,6,17,80,106,16,2,56,103,45,56,24,47,3,5,16,69,103
2014-02-10 00:00:00.000,Rotterdam The Netherlands ATP World Tour 500,HARD,2,Jo-Wilfried Tsonga,Florian Mayer,Jo-Wilfried Tsonga,4-6; 6-3; 6-1,R32,87,10,1,50,71,40,50,11,21,0,1,13,51,71,5,1,47,77,28,47,16,30,2,6,13,44,77
2014-02-10 00:00:00.000,Rotterdam The Netherlands ATP World Tour 500,HARD,2,Marin Cilic,Lukas Rosol,Marin Cilic,6-2; 6-2,R32,61,8,1,34,49,26,34,9,15,1,1,8,35,49,3,1,34,54,20,34,6,20,2,6,8,26,54
2014-02-10 00:00:00.000,Rotterdam The Netherlands ATP World Tour 500,HARD,2,Dominic Thiem,Jarkko Nieminen,Dominic Thiem,6-4; 4-6; 6-4,R32,121,15,2,46,85,40,46,22,39,7,8,15,62,85,2,4,85,116,56,85,16,31,14,16,15,72,116
2014-02-10 00:00:00.000,Rotterdam The Netherlands ATP World Tour 500,HARD,2,Andy Murray,Edouard Roger-Vasselin,Andy Murray,6-3; 6-3,R32,89,3,1,34,56,25,34,15,22,4,4,9,40,56,1,1,40,65,29,40,7,25,7,10,9,36,65
2014-02-10 00:00:00.000,Rotterdam The Netherlands ATP World Tour 500,HARD,2,Juan Martin Del Potro,Paul-Henri Mathieu,Juan Martin Del Potro,6-2; 7-6(2),R16,86,10,1,33,54,29,33,15,21,2,2,10,44,54,5,2,28,60,17,28,21,32,3,5,10,38,60
2014-02-10 00:00:00.000,Rotterdam The Netherlands ATP World Tour 500,HARD,2,Ernests Gulbis,Grigor Dimitrov,Ernests Gulbis,6-4; 7-6(3),R16,88,12,3,54,71,46,54,7,17,5,5,11,53,71,5,1,39,71,28,39,21,32,4,5,11,49,71
2014-02-10 00:00:00.000,Rotterdam The Netherlands ATP World Tour 500,HARD,2,Tomas Berdych,Nicolas Mahut,Tomas Berdych,6-4; 6-3,R16,72,10,0,32,51,28,32,14,19,4,4,10,42,51,6,2,32,51,22,32,9,19,1,3,9,31,51
2014-02-10 00:00:00.000,Rotterdam The Netherlands ATP World Tour 500,HARD,2,Jerzy Janowicz,Tommy Haas,Jerzy Janowicz,6-4; 6-4,R16,81,18,2,35,53,28,35,13,18,0,0,10,41,53,5,3,55,79,35,55,12,24,5,7,10,47,79
2014-02-10 00:00:00.000,Rotterdam The Netherlands ATP World Tour 500,HARD,2,Igor Sijsling,Michael Berrer,Igor Sijsling,6-1; 6-2,R16,56,4,3,24,41,20,24,10,17,1,1,7,30,41,1,1,26,52,13,26,10,26,3,8,8,23,52
2014-02-10 00:00:00.000,Rotterdam The Netherlands ATP World Tour 500,HARD,2,Philipp Kohlschreiber,Richard Gasquet,Philipp Kohlschreiber,7-5; 7-5,R16,96,6,1,38,66,27,38,16,28,4,6,12,43,66,5,2,55,85,34,55,14,30,10,14,12,48,85
2014-02-10 00:00:00.000,Rotterdam The Netherlands ATP World Tour 500,HARD,2,Marin Cilic,Jo-Wilfried Tsonga,Marin Cilic,6-4; 6-4,R16,71,5,2,34,53,30,34,12,19,3,3,10,42,53,3,0,41,60,29,41,11,19,3,5,10,40,60
2014-02-10 00:00:00.000,Rotterdam The Netherlands ATP World Tour 500,HARD,2,Andy Murray,Dominic Thiem,Andy Murray,6-4; 3-6; 6-3,R16,142,3,5,66,99,47,66,14,33,5,7,14,61,99,2,7,63,113,46,63,22,50,8,11,14,68,113
2014-02-10 00:00:00.000,Rotterdam The Netherlands ATP World Tour 500,HARD,2,Ernests Gulbis,Juan Martin Del Potro,Ernests Gulbis,6-3; 6-4,Q,82,12,1,35,54,29,35,13,19,1,1,10,42,54,5,1,44,60,30,44,6,16,7,9,9,36,60
2014-02-10 00:00:00.000,Rotterdam The Netherlands ATP World Tour 500,HARD,2,Tomas Berdych,Jerzy Janowicz,Tomas Berdych,6-7(9); 6-2; 6-4,Q,148,13,1,60,99,46,60,22,39,3,4,15,68,99,13,10,60,103,44,60,17,43,8,12,15,61,103
2014-02-10 00:00:00.000,Rotterdam The Netherlands ATP World Tour 500,HARD,2,Igor Sijsling,Philipp Kohlschreiber,Igor Sijsling,6-2; 2-6; 6-1,Q,75,5,0,37,63,29,37,14,26,0,2,12,43,63,3,0,35,56,22,35,12,21,2,6,11,34,56
2014-02-10 00:00:00.000,Rotterdam The Netherlands ATP World Tour 500,HARD,2,Marin Cilic,Andy Murray,Marin Cilic,6-3; 6-4,Q,72,8,1,36,58,32,36,10,22,4,4,10,42,58,4,3,27,47,23,27,10,20,3,5,9,33,47
2014-02-10 00:00:00.000,Rotterdam The Netherlands ATP World Tour 500,HARD,2,Tomas Berdych,Ernests Gulbis,Tomas Berdych,6-3; 6-2,S,66,7,3,37,53,32,37,6,16,1,1,9,38,53,4,1,24,41,16,24,8,17,0,3,8,24,41
2014-02-10 00:00:00.000,Rotterdam The Netherlands ATP World Tour 500,HARD,2,Marin Cilic,Igor Sijsling,Marin Cilic,5-7; 6-3; 6-2,S,112,15,6,44,78,38,44,17,34,3,5,15,55,78,7,1,47,93,36,47,19,46,9,13,14,55,93
2014-02-10 00:00:00.000,Rotterdam The Netherlands ATP World Tour 500,HARD,2,Tomas Berdych,Marin Cilic,Tomas Berdych,6-4; 6-2,F,76,9,0,29,52,24,29,16,23,3,3,9,40,52,8,4,28,52,21,28,10,24,1,4,9,31,52
2014-02-17 00:00:00.000,Delray Beach FL; U.S.A. ATP World Tour 250,HARD,2,Tommy Haas,Wayne Odesnik,Tommy Haas,6-2; 6-1,R32,55,5,1,20,35,19,20,9,15,0,0,7,28,35,3,3,34,51,17,34,7,17,1,6,8,24,51
2014-02-17 00:00:00.000,Delray Beach FL; U.S.A. ATP World Tour 250,HARD,2,Steve Johnson,Mikhail Kukushkin,Steve Johnson,6-4; 6-3,R32,73,9,1,38,56,29,38,12,18,5,5,9,41,56,1,2,33,70,24,33,17,37,6,9,10,41,70
2014-02-17 00:00:00.000,Delray Beach FL; U.S.A. ATP World Tour 250,HARD,2,Adrian Mannarino,Jack Sock,Adrian Mannarino,6-4; 6-2,R32,73,1,6,47,68,33,47,9,21,7,8,9,42,68,7,4,33,57,22,33,8,24,5,9,9,30,57
2014-02-17 00:00:00.000,Delray Beach FL; U.S.A. ATP World Tour 250,HARD,2,Feliciano Lopez,Sam Querrey,Feliciano Lopez,4-6; 6-2; 6-3,R32,94,4,5,32,67,28,32,20,35,4,6,13,48,67,7,4,52,98,32,52,22,46,9,14,14,54,98
2014-02-17 00:00:00.000,Delray Beach FL; U.S.A. ATP World Tour 250,HARD,2,Kevin Anderson,Tim Smyczek,Kevin Anderson,4-6; 6-1; 6-3,R32,107,11,5,44,72,36,44,15,28,1,2,13,51,72,2,5,55,92,36,55,18,37,8,12,13,54,92
2014-02-17 00:00:00.000,Delray Beach FL; U.S.A. ATP World Tour 250,HARD,2,Ivo Karlovic,Sam Groth,Ivo Karlovic,7-6(4); 6-3,R32,72,19,2,40,60,36,40,16,20,2,2,11,52,60,6,2,42,64,32,42,14,22,3,4,10,46,64
2014-02-17 00:00:00.000,Delray Beach FL; U.S.A. ATP World Tour 250,HARD,2,Marinko Matosevic,David Goffin,Marinko Matosevic,6-2; 6-4,R32,77,7,1,29,65,24,29,20,36,5,5,9,44,65,2,4,26,60,14,26,21,34,5,8,9,35,60
2014-02-17 00:00:00.000,Delray Beach FL; U.S.A. ATP World Tour 250,HARD,2,Lleyton Hewitt,Bradley Klahn,Lleyton Hewitt,6-3; 6-1,R32,65,0,3,27,46,21,27,8,19,0,1,8,29,46,3,5,21,52,11,21,13,31,2,7,8,24,52
2014-02-17 00:00:00.000,Delray Beach FL; U.S.A. ATP World Tour 250,HARD,2,Marin Cilic,Benjamin Becker,Marin Cilic,6-1; 6-3,R32,56,9,3,25,42,22,25,9,17,1,2,8,31,42,3,3,35,55,21,35,4,20,4,9,8,25,55
2014-02-17 00:00:00.000,Delray Beach FL; U.S.A. ATP World Tour 250,HARD,2,Ryan Harrison,Yen-Hsun Lu,Ryan Harrison,4-6; 1-0 RET,R32,39,3,1,17,33,11,17,12,16,1,2,6,23,33,0,1,20,29,15,20,6,9,0,0,5,21,29
2014-02-17 00:00:00.000,Delray Beach FL; U.S.A. ATP World Tour 250,HARD,2,Teymuraz Gabashvili,Matthew Ebden,Teymuraz Gabashvili,2-6; 6-3; 6-2,R32,106,2,8,45,78,27,45,12,33,4,10,12,39,78,6,15,32,74,20,32,13,42,7,15,13,33,74
2014-02-17 00:00:00.000,Delray Beach FL; U.S.A. ATP World Tour 250,HARD,2,Kei Nishikori,Gastao Elias,Kei Nishikori,6-1; 5-7; 6-2,R32,116,3,7,52,89,33,52,22,37,2,5,14,55,89,3,3,47,92,25,47,21,45,7,13,13,46,92
2014-02-17 00:00:00.000,Delray Beach FL; U.S.A. ATP World Tour 250,HARD,2,Rhyne Williams,Alejandro Falla,Rhyne Williams,6-3; 4-0 RET,R32,55,2,0,23,39,16,23,8,16,2,3,6,24,39,2,7,17,43,10,17,7,26,4,9,7,17,43
2014-02-17 00:00:00.000,Delray Beach FL; U.S.A. ATP World Tour 250,HARD,2,Marcos Baghdatis,Jiri Vesely,Marcos Baghdatis,3-6; 6-2; 6-1,R32,98,4,4,33,66,28,33,20,33,0,1,12,48,66,2,10,46,82,29,46,16,36,2,6,12,45,82
2014-02-17 00:00:00.000,Delray Beach FL; U.S.A. ATP World Tour 250,HARD,2,Dudi Sela,Alex Bogomolov Jr.,Dudi Sela,6-0; 6-2,R32,54,0,2,15,33,13,15,15,18,0,0,7,28,33,0,1,33,47,13,33,7,14,2,7,7,20,47
2014-02-17 00:00:00.000,Delray Beach FL; U.S.A. ATP World Tour 250,HARD,2,John Isner,Michael Russell,John Isner,4-6; 7-6(3); 6-4,R32,114,20,2,61,93,50,61,18,32,2,3,16,68,93,2,3,72,97,56,72,12,25,2,3,16,68,97
2014-02-17 00:00:00.000,Delray Beach FL; U.S.A. ATP World Tour 250,HARD,2,Steve Johnson,Tommy Haas,Steve Johnson,6-4; 2-6; 7-6(2),R16,127,13,2,65,106,47,65,17,41,9,12,15,64,106,9,5,54,98,35,54,26,44,3,5,15,61,98
2014-02-17 00:00:00.000,Delray Beach FL; U.S.A. ATP World Tour 250,HARD,2,Feliciano Lopez,Adrian Mannarino,Feliciano Lopez,4-6; 6-4; 6-2,R16,103,10,2,43,75,34,43,19,32,0,1,14,53,75,3,5,44,85,28,44,24,41,4,7,14,52,85
2014-02-17 00:00:00.000,Delray Beach FL; U.S.A. ATP World Tour 250,HARD,2,Kevin Anderson,Ivo Karlovic,Kevin Anderson,1-0 RET,R16,4,1,1,3,5,3,3,1,2,0,0,1,4,5,0,2,1,3,0,1,0,2,0,0,0,0,3
2014-02-17 00:00:00.000,Delray Beach FL; U.S.A. ATP World Tour 250,HARD,2,Marinko Matosevic,Lleyton Hewitt,Marinko Matosevic,7-6(2) RET,R16,67,4,0,23,43,16,23,8,20,3,5,6,24,43,2,7,24,45,13,24,9,21,1,3,6,22,45
2014-02-17 00:00:00.000,Delray Beach FL; U.S.A. ATP World Tour 250,HARD,2,Marin Cilic,Ryan Harrison,Marin Cilic,6-3; 6-4,R16,74,9,2,30,57,26,30,18,27,1,1,10,44,57,5,2,33,56,24,33,12,23,4,6,9,36,56
2014-02-17 00:00:00.000,Delray Beach FL; U.S.A. ATP World Tour 250,HARD,2,Teymuraz Gabashvili,Kei Nishikori,Teymuraz Gabashvili,4-2 RET,R16,19,2,0,9,16,7,9,6,7,2,2,3,13,16,1,2,12,18,8,12,2,6,2,3,3,10,18
2014-02-17 00:00:00.000,Delray Beach FL; U.S.A. ATP World Tour 250,HARD,2,Rhyne Williams,Marcos Baghdatis,Rhyne Williams,6-7(7); 6-4; 6-2,R16,146,6,4,64,95,52,64,11,31,1,3,15,63,95,4,10,35,99,20,35,38,64,5,10,15,58,99
2014-02-17 00:00:00.000,Delray Beach FL; U.S.A. ATP World Tour 250,HARD,2,John Isner,Dudi Sela,John Isner,3-6; 6-1; 7-6(5),R16,116,12,3,61,93,42,61,17,32,4,7,14,59,93,2,5,62,97,38,62,19,35,9,13,14,57,97
2014-02-17 00:00:00.000,Delray Beach FL; U.S.A. ATP World Tour 250,HARD,2,Steve Johnson,Feliciano Lopez,Steve Johnson,6-3; 6-2,Q,74,4,2,36,58,26,36,14,22,3,3,9,40,58,7,3,35,59,24,35,8,24,7,10,8,32,59
2014-02-17 00:00:00.000,Delray Beach FL; U.S.A. ATP World Tour 250,HARD,2,Kevin Anderson,Marinko Matosevic,Kevin Anderson,6-7(3); 6-3; 6-3,Q,144,10,2,53,86,41,53,21,33,4,5,15,62,86,9,6,57,116,42,57,27,59,9,13,15,69,116
2014-02-17 00:00:00.000,Delray Beach FL; U.S.A. ATP World Tour 250,HARD,2,Marin Cilic,Teymuraz Gabashvili,Marin Cilic,6-2; 6-3,Q,80,12,2,31,61,25,31,10,30,4,6,9,35,61,1,0,21,50,8,21,13,29,1,6,8,21,50
2014-02-17 00:00:00.000,Delray Beach FL; U.S.A. ATP World Tour 250,HARD,2,John Isner,Rhyne Williams,John Isner,4-6; 6-3; 6-2,Q,102,18,5,45,71,40,45,15,26,1,2,14,55,71,5,1,58,85,38,58,14,27,4,7,13,52,85
2014-02-17 00:00:00.000,Delray Beach FL; U.S.A. ATP World Tour 250,HARD,2,Kevin Anderson,Steve Johnson,Kevin Anderson,6-2; 6-4,S,76,13,1,35,56,30,35,10,21,0,0,9,40,56,6,3,33,55,23,33,10,22,5,8,9,33,55
2014-02-17 00:00:00.000,Delray Beach FL; U.S.A. ATP World Tour 250,HARD,2,Marin Cilic,John Isner,Marin Cilic,7-6(5); 6-3,S,86,12,2,39,68,33,39,18,29,0,0,11,51,68,9,3,52,72,34,52,10,20,6,7,10,44,72
2014-02-17 00:00:00.000,Delray Beach FL; U.S.A. ATP World Tour 250,HARD,2,Marin Cilic,Kevin Anderson,Marin Cilic,7-6(6); 6-7(7); 6-4,F,189,16,8,66,123,50,66,30,57,10,13,17,80,123,18,12,88,145,66,88,23,57,10,14,17,89,145
2014-02-17 00:00:00.000,Marseille France ATP World Tour 250,HARD,2,Richard Gasquet,N/A Bye,Richard Gasquet,,R32,0,0,0,0,0,0,0,0,0,0,0,0,0,0,0,0,0,0,0,0,0,0,0,0,0,0,0
2014-02-17 00:00:00.000,Marseille France ATP World Tour 250,HARD,2,Blaz Kavcic,Thanasi Kokkinakis,Blaz Kavcic,6-4; 6-2,R32,77,6,1,36,57,28,36,13,21,3,3,9,41,57,7,5,34,57,24,34,10,23,2,5,9,34,57
2014-02-17 00:00:00.000,Marseille France ATP World Tour 250,HARD,2,Tobias Kamke,Kyle Edmund,Tobias Kamke,7-5; 6-1,R32,92,7,0,36,71,26,36,20,35,6,6,9,46,71,2,3,35,65,24,35,12,30,1,5,10,36,65
2014-02-17 00:00:00.000,Marseille France ATP World Tour 250,HARD,2,Ivan Dodig,Albano Olivetti,Ivan Dodig,7-5; 6-2,R32,96,11,4,53,83,39,53,15,30,11,11,10,54,83,13,5,38,69,25,38,15,31,4,7,10,40,69
2014-02-17 00:00:00.000,Marseille France ATP World Tour 250,HARD,2,Ernests Gulbis,N/A Bye,Ernests Gulbis,,R32,0,0,0,0,0,0,0,0,0,0,0,0,0,0,0,0,0,0,0,0,0,0,0,0,0,0,0
2014-02-17 00:00:00.000,Marseille France ATP World Tour 250,HARD,2,Roberto Bautista Agut,Dustin Brown,Roberto Bautista Agut,7-5; 4-6; 6-3,R32,120,3,2,68,99,53,68,14,31,6,8,16,67,99,8,3,58,103,41,58,24,45,9,12,15,65,103
2014-02-17 00:00:00.000,Marseille France ATP World Tour 250,HARD,2,Ricardas Berankis,Jan Hajek,Ricardas Berankis,6-5 RET,R32,44,3,0,16,30,14,16,4,14,1,3,5,18,30,0,0,27,34,12,27,6,7,2,5,6,18,34
2014-02-17 00:00:00.000,Marseille France ATP World Tour 250,HARD,2,Nicolas Mahut,Kenny De Schepper,Nicolas Mahut,7-6(2); 6-3,R32,87,4,6,39,70,32,39,18,31,0,0,11,50,70,11,6,39,61,30,39,11,22,1,2,10,41,61
2014-02-17 00:00:00.000,Marseille France ATP World Tour 250,HARD,2,Julien Benneteau,Jesse Huta Galung,Julien Benneteau,6-1; 6-4,R32,60,11,4,30,54,24,30,16,24,4,4,9,40,54,3,2,28,44,19,28,5,16,1,4,8,24,44
2014-02-17 00:00:00.000,Marseille France ATP World Tour 250,HARD,2,Jan-Lennard Struff,David Guez,Jan-Lennard Struff,3-6; 6-1; 6-1,R32,96,8,4,30,60,26,30,12,30,2,4,11,38,60,4,1,53,88,32,53,11,35,7,13,12,43,88
2014-02-17 00:00:00.000,Marseille France ATP World Tour 250,HARD,2,Michael Llodra,Lukas Lacko,Michael Llodra,6-3; 7-6(2),R32,78,9,1,36,63,29,36,17,27,1,2,11,46,63,11,3,36,74,24,36,20,38,3,5,10,44,74
2014-02-17 00:00:00.000,Marseille France ATP World Tour 250,HARD,2,Andreas Seppi,N/A Bye,Andreas Seppi,,R32,0,0,0,0,0,0,0,0,0,0,0,0,0,0,0,0,0,0,0,0,0,0,0,0,0,0,0
2014-02-17 00:00:00.000,Marseille France ATP World Tour 250,HARD,2,Edouard Roger-Vasselin,Ante Pavic,Edouard Roger-Vasselin,3-6; 7-6(5); 7-5,R32,133,13,2,75,105,58,75,13,30,7,9,16,71,105,23,3,64,109,55,64,21,45,2,4,17,76,109
2014-02-17 00:00:00.000,Marseille France ATP World Tour 250,HARD,2,Sergiy Stakhovsky,Daniel Evans,Sergiy Stakhovsky,3-6; 7-6(4); 6-4,R32,117,15,3,64,98,47,64,16,34,10,12,15,63,98,5,4,75,114,53,75,18,39,14,16,16,71,114
2014-02-17 00:00:00.000,Marseille France ATP World Tour 250,HARD,2,Nikolay Davydenko,Igor Sijsling,Nikolay Davydenko,6-4; 6-4,R32,82,12,1,40,64,29,40,14,24,2,3,10,43,64,5,4,37,70,28,37,13,33,9,12,10,41,70
2014-02-17 00:00:00.000,Marseille France ATP World Tour 250,HARD,2,Jo-Wilfried Tsonga,N/A Bye,Jo-Wilfried Tsonga,,R32,0,0,0,0,0,0,0,0,0,0,0,0,0,0,0,0,0,0,0,0,0,0,0,0,0,0,0
2014-02-17 00:00:00.000,Marseille France ATP World Tour 250,HARD,2,Richard Gasquet,Blaz Kavcic,Richard Gasquet,6-3; 6-3,R16,70,2,0,32,47,25,32,11,15,0,0,9,36,47,2,2,38,60,27,38,8,22,8,11,9,35,60
2014-02-17 00:00:00.000,Marseille France ATP World Tour 250,HARD,2,Ivan Dodig,Tobias Kamke,Ivan Dodig,6-7(4); 6-0; 6-3,R16,114,16,3,44,73,37,44,20,29,1,1,13,57,73,0,2,69,99,35,69,22,30,3,8,14,57,99
2014-02-17 00:00:00.000,Marseille France ATP World Tour 250,HARD,2,Ernests Gulbis,Roberto Bautista Agut,Ernests Gulbis,6-3; 5-7; 6-4,R16,135,23,3,74,105,58,74,13,31,5,6,16,71,105,3,1,67,94,50,67,12,27,7,9,15,62,94
2014-02-17 00:00:00.000,Marseille France ATP World Tour 250,HARD,2,Nicolas Mahut,Ricardas Berankis,Nicolas Mahut,7-6(5); 6-3,R16,88,12,2,43,61,39,43,9,18,1,1,10,48,61,0,2,46,75,33,46,16,29,2,4,11,49,75
2014-02-17 00:00:00.000,Marseille France ATP World Tour 250,HARD,2,Jan-Lennard Struff,Julien Benneteau,Jan-Lennard Struff,4-6; 7-6(3); 6-3,R16,116,12,1,48,87,42,48,24,39,1,2,15,66,87,17,1,60,94,49,60,15,34,6,8,16,64,94
2014-02-17 00:00:00.000,Marseille France ATP World Tour 250,HARD,2,Michael Llodra,Andreas Seppi,Michael Llodra,7-6(3); 6-4,R16,95,14,4,51,71,43,51,8,20,5,6,11,51,71,10,2,51,85,38,51,15,34,4,6,11,53,85
2014-02-17 00:00:00.000,Marseille France ATP World Tour 250,HARD,2,Edouard Roger-Vasselin,Sergiy Stakhovsky,Edouard Roger-Vasselin,7-6(2); 6-4,R16,96,3,3,50,74,39,50,12,24,2,3,11,51,74,9,2,42,75,30,42,17,33,2,4,11,47,75
2014-02-17 00:00:00.000,Marseille France ATP World Tour 250,HARD,2,Jo-Wilfried Tsonga,Nikolay Davydenko,Jo-Wilfried Tsonga,7-6(4); 7-6(8),R16,107,19,2,63,85,49,63,12,22,3,4,12,61,85,9,3,50,80,38,50,18,30,2,3,12,56,80
2014-02-17 00:00:00.000,Marseille France ATP World Tour 250,HARD,2,Richard Gasquet,Ivan Dodig,Richard Gasquet,7-5; 6-3,Q,84,3,2,46,69,33,46,13,23,5,6,11,46,69,7,2,36,58,26,36,8,22,4,7,10,34,58
2014-02-17 00:00:00.000,Marseille France ATP World Tour 250,HARD,2,Ernests Gulbis,Nicolas Mahut,Ernests Gulbis,6-3; 7-6(1),Q,81,9,0,41,56,38,41,10,15,0,0,11,48,56,6,2,46,70,30,46,14,24,5,6,10,44,70
2014-02-17 00:00:00.000,Marseille France ATP World Tour 250,HARD,2,Jan-Lennard Struff,Michael Llodra,Jan-Lennard Struff,6-4; 6-3,Q,60,9,1,32,48,28,32,8,16,0,0,9,36,48,8,2,52,70,31,52,8,18,1,4,10,39,70
2014-02-17 00:00:00.000,Marseille France ATP World Tour 250,HARD,2,Jo-Wilfried Tsonga,Edouard Roger-Vasselin,Jo-Wilfried Tsonga,6-7(3); 6-2; 6-2,Q,112,13,2,54,86,41,54,21,32,2,2,14,62,86,4,1,59,90,36,59,20,31,4,8,14,56,90
2014-02-17 00:00:00.000,Marseille France ATP World Tour 250,HARD,2,Ernests Gulbis,Richard Gasquet,Ernests Gulbis,6-3; 6-2,S,65,15,1,32,48,30,32,7,16,0,0,9,37,48,3,1,41,53,24,41,6,12,1,4,8,30,53
2014-02-17 00:00:00.000,Marseille France ATP World Tour 250,HARD,2,Jo-Wilfried Tsonga,Jan-Lennard Struff,Jo-Wilfried Tsonga,7-6(4); 7-5,S,99,10,3,43,68,40,43,12,25,5,6,12,52,68,2,0,46,80,30,46,21,34,5,7,12,51,80
2014-02-17 00:00:00.000,Marseille France ATP World Tour 250,HARD,2,Ernests Gulbis,Jo-Wilfried Tsonga,Ernests Gulbis,7-6(5); 6-4,F,94,14,3,41,66,35,41,16,25,2,2,11,51,66,8,0,50,74,40,50,11,24,10,11,11,51,74
2014-02-17 00:00:00.000,Rio de Janeiro Brazil ATP World Tour 500,CLAY,2,Rafael Nadal,Daniel Gimeno-Traver,Rafael Nadal,6-3; 7-5,R32,101,1,1,35,61,27,35,17,26,2,3,11,44,61,5,5,36,64,25,36,12,28,3,6,10,37,64
2014-02-17 00:00:00.000,Rio de Janeiro Brazil ATP World Tour 500,CLAY,2,Albert Montanes,Robin Haase,Albert Montanes,6-1; 7-6(4),R32,84,1,0,43,63,30,43,16,20,4,5,10,46,63,0,3,39,70,25,39,13,31,4,7,9,38,70
2014-02-17 00:00:00.000,Rio de Janeiro Brazil ATP World Tour 500,CLAY,2,Albert Ramos-Vinolas,Leonardo Mayer,Albert Ramos-Vinolas,6-2; 6-0,R32,62,0,0,25,42,21,25,9,17,0,0,7,30,42,2,3,21,42,9,21,9,21,2,7,7,18,42
2014-02-17 00:00:00.000,Rio de Janeiro Brazil ATP World Tour 500,CLAY,2,Joao Sousa,Marcel Granollers,Joao Sousa,2-6; 6-3; 7-5,R32,148,0,4,59,119,40,59,31,60,12,15,15,71,119,7,4,49,75,35,49,15,26,4,7,14,50,75
2014-02-17 00:00:00.000,Rio de Janeiro Brazil ATP World Tour 500,CLAY,2,Tommy Robredo,Pablo Carreno Busta,Tommy Robredo,7-6(5); 6-3,R32,97,6,1,34,66,30,34,19,32,0,0,11,49,66,2,2,35,63,28,35,13,28,3,4,10,41,63
2014-02-17 00:00:00.000,Rio de Janeiro Brazil ATP World Tour 500,CLAY,2,Dusan Lajovic,Filippo Volandri,Dusan Lajovic,6-7(7); 6-3; 4-0 RET,R32,132,4,3,47,89,29,47,23,42,9,14,12,52,89,0,1,55,97,29,55,16,42,4,13,13,45,97
2014-02-17 00:00:00.000,Rio de Janeiro Brazil ATP World Tour 500,CLAY,2,Martin Klizan,Guillermo Garcia-Lopez,Martin Klizan,6-4; 4-6; 7-6(4),R32,172,6,3,44,104,32,44,31,60,4,8,16,63,104,11,7,57,116,39,57,26,59,7,11,16,65,116
2014-02-17 00:00:00.000,Rio de Janeiro Brazil ATP World Tour 500,CLAY,2,Pablo Andujar,Julian Reister,Pablo Andujar,6-4; 6-3,R32,106,0,2,37,50,23,37,7,13,3,6,9,30,50,2,2,49,76,27,49,8,27,4,10,10,35,76
2014-02-17 00:00:00.000,Rio de Janeiro Brazil ATP World Tour 500,CLAY,2,Alexandr Dolgopolov,Nicolas Almagro,Alexandr Dolgopolov,2-6; 6-3; 6-0,R32,95,9,2,30,70,24,30,21,40,5,7,11,45,70,8,4,39,74,27,39,14,35,3,8,12,41,74
2014-02-17 00:00:00.000,Rio de Janeiro Brazil ATP World Tour 500,CLAY,2,Facundo Bagnis,Joao Souza,Facundo Bagnis,7-5; 2-6; 6-2,R32,147,7,5,56,88,37,56,20,32,3,6,14,57,88,3,2,55,97,32,55,24,42,5,9,14,56,97
2014-02-17 00:00:00.000,Rio de Janeiro Brazil ATP World Tour 500,CLAY,2,Pablo Cuevas,Alejandro Gonzalez,Pablo Cuevas,6-7(0); 6-1; 6-3,R32,141,6,4,50,89,36,50,15,39,8,13,14,51,89,6,4,63,110,41,63,14,47,9,18,14,55,110
2014-02-17 00:00:00.000,Rio de Janeiro Brazil ATP World Tour 500,CLAY,2,Fabio Fognini,Aljaz Bedene,Fabio Fognini,7-6(5); 0-6; 6-1,R32,119,3,6,41,79,26,41,13,38,4,10,12,39,79,7,3,35,83,19,35,22,48,2,8,13,41,83
2014-02-17 00:00:00.000,Rio de Janeiro Brazil ATP World Tour 500,CLAY,2,Juan Monaco,Horacio Zeballos,Juan Monaco,6-3; 6-1,R32,64,1,0,33,43,26,33,7,10,2,2,8,33,43,2,1,23,47,19,23,6,24,2,6,8,25,47
2014-02-17 00:00:00.000,Rio de Janeiro Brazil ATP World Tour 500,CLAY,2,Thomaz Bellucci,Santiago Giraldo,Thomaz Bellucci,3-6; 6-4; 6-3,R32,146,3,4,58,90,35,58,19,32,4,8,14,54,90,8,5,47,103,34,47,24,56,9,14,14,58,103
2014-02-17 00:00:00.000,Rio de Janeiro Brazil ATP World Tour 500,CLAY,2,Federico Delbonis,Guilherme Clezar,Federico Delbonis,6-1; 6-1,R32,56,2,1,20,40,16,20,14,20,0,0,7,30,40,4,3,32,49,18,32,2,17,5,10,7,20,49
2014-02-17 00:00:00.000,Rio de Janeiro Brazil ATP World Tour 500,CLAY,2,David Ferrer,Jeremy Chardy,David Ferrer,6-2; 6-3,R32,68,1,4,33,55,25,33,10,22,4,6,9,35,55,1,5,25,53,16,25,7,28,7,12,8,23,53
2014-02-17 00:00:00.000,Rio de Janeiro Brazil ATP World Tour 500,CLAY,2,Rafael Nadal,Albert Montanes,Rafael Nadal,6-1; 6-2,R16,75,0,2,33,51,21,33,10,18,2,3,7,31,51,0,4,36,57,16,36,7,21,4,10,8,23,57
2014-02-17 00:00:00.000,Rio de Janeiro Brazil ATP World Tour 500,CLAY,2,Joao Sousa,Albert Ramos-Vinolas,Joao Sousa,7-6(6); 2-6; 6-3,R16,127,7,2,70,103,47,70,15,33,4,8,15,62,103,5,2,56,80,40,56,13,24,2,5,14,53,80
2014-02-17 00:00:00.000,Rio de Janeiro Brazil ATP World Tour 500,CLAY,2,Tommy Robredo,Dusan Lajovic,Tommy Robredo,6-2; 6-1,R16,68,2,2,18,39,16,18,14,21,1,1,7,30,39,1,6,20,51,12,20,10,31,4,9,8,22,51
2014-02-17 00:00:00.000,Rio de Janeiro Brazil ATP World Tour 500,CLAY,2,Pablo Andujar,Martin Klizan,Pablo Andujar,W/O,R16,0,0,0,0,0,0,0,0,0,0,0,0,0,0,0,0,0,0,0,0,0,0,0,0,0,0,0
2014-02-17 00:00:00.000,Rio de Janeiro Brazil ATP World Tour 500,CLAY,2,Alexandr Dolgopolov,Facundo Bagnis,Alexandr Dolgopolov,6-7(4); 6-2; 7-6(4),R16,151,8,1,50,101,37,50,30,51,3,6,16,67,101,8,2,70,111,43,70,20,41,7,12,16,63,111
2014-02-17 00:00:00.000,Rio de Janeiro Brazil ATP World Tour 500,CLAY,2,Fabio Fognini,Pablo Cuevas,Fabio Fognini,7-6(1); 4-6; 6-3,R16,120,2,3,63,100,45,63,23,37,1,3,16,68,100,1,2,51,78,38,51,18,27,0,2,15,56,78
2014-02-17 00:00:00.000,Rio de Janeiro Brazil ATP World Tour 500,CLAY,2,Thomaz Bellucci,Juan Monaco,Thomaz Bellucci,4-6; 6-3; 6-3,R16,122,3,0,41,83,34,41,24,42,2,4,14,58,83,0,0,57,79,37,57,10,22,2,6,14,47,79
2014-02-17 00:00:00.000,Rio de Janeiro Brazil ATP World Tour 500,CLAY,2,David Ferrer,Federico Delbonis,David Ferrer,7-6(2); 6-1,R16,87,0,4,30,53,25,30,13,23,1,2,9,38,53,3,2,44,78,24,44,15,34,12,16,10,39,78
2014-02-17 00:00:00.000,Rio de Janeiro Brazil ATP World Tour 500,CLAY,2,Rafael Nadal,Joao Sousa,Rafael Nadal,6-1; 6-0,Q,76,4,3,33,47,24,33,7,14,3,3,7,31,47,1,5,30,57,17,30,7,27,5,10,6,24,57
2014-02-17 00:00:00.000,Rio de Janeiro Brazil ATP World Tour 500,CLAY,2,Pablo Andujar,Tommy Robredo,Pablo Andujar,6-1; 6-1,Q,61,0,0,40,51,26,40,8,11,5,5,7,34,51,2,4,17,41,10,17,7,24,3,8,7,17,41
2014-02-17 00:00:00.000,Rio de Janeiro Brazil ATP World Tour 500,CLAY,2,Alexandr Dolgopolov,Fabio Fognini,Alexandr Dolgopolov,6-1; 6-1,Q,67,12,3,28,54,23,28,12,26,5,6,7,35,54,2,3,37,57,17,37,6,20,1,7,7,23,57
2014-02-17 00:00:00.000,Rio de Janeiro Brazil ATP World Tour 500,CLAY,2,David Ferrer,Thomaz Bellucci,David Ferrer,4-6; 6-3; 6-3,Q,143,1,3,68,101,47,68,16,33,6,8,14,63,101,5,4,56,99,39,56,18,43,8,12,14,57,99
2014-02-17 00:00:00.000,Rio de Janeiro Brazil ATP World Tour 500,CLAY,2,Rafael Nadal,Pablo Andujar,Rafael Nadal,2-6; 6-3; 7-6(10),S,167,4,4,72,121,52,72,22,49,11,14,15,74,121,0,0,71,93,48,71,13,22,2,4,14,61,93
2014-02-17 00:00:00.000,Rio de Janeiro Brazil ATP World Tour 500,CLAY,2,Alexandr Dolgopolov,David Ferrer,Alexandr Dolgopolov,6-4; 6-4,S,84,4,1,30,62,23,30,18,32,3,4,10,41,62,2,1,51,72,28,51,11,21,7,10,10,39,72
2014-02-17 00:00:00.000,Rio de Janeiro Brazil ATP World Tour 500,CLAY,2,Rafael Nadal,Alexandr Dolgopolov,Rafael Nadal,6-3; 7-6(3),F,101,3,0,43,68,34,43,14,25,3,4,11,48,68,10,1,30,67,22,30,17,37,1,3,10,39,67
2014-02-24 00:00:00.000,Acapulco Mexico ATP World Tour 500,HARD,2,David Ferrer,Mikhail Kukushkin,David Ferrer,6-2; 6-3,R32,88,5,1,38,56,29,38,11,18,2,2,9,40,56,1,3,45,82,27,45,16,37,13,16,8,43,82
2014-02-24 00:00:00.000,Acapulco Mexico ATP World Tour 500,HARD,2,Feliciano Lopez,Edouard Roger-Vasselin,Feliciano Lopez,6-4; 6-2,R32,81,15,3,31,64,26,31,18,33,7,8,9,44,64,2,5,36,62,23,36,10,26,5,9,9,33,62
2014-02-24 00:00:00.000,Acapulco Mexico ATP World Tour 500,HARD,2,Sam Querrey,Tigre Hank,Sam Querrey,6-7(5); 6-4; 6-3,R32,116,4,1,51,80,45,51,21,29,2,2,15,66,80,11,2,59,103,42,59,27,44,6,9,16,69,103
2014-02-24 00:00:00.000,Acapulco Mexico ATP World Tour 500,HARD,2,Kevin Anderson,Stephane Robert,Kevin Anderson,6-2; 7-6(7),R32,85,8,2,42,63,36,42,13,21,0,0,10,49,63,7,4,30,64,24,30,20,34,4,6,10,44,64
2014-02-24 00:00:00.000,Acapulco Mexico ATP World Tour 500,HARD,2,Ivo Karlovic,John Isner,Ivo Karlovic,7-6(4); 7-6(5),R32,99,15,2,43,68,36,43,21,25,1,2,12,57,68,8,1,51,74,42,51,13,23,1,2,12,55,74
2014-02-24 00:00:00.000,Acapulco Mexico ATP World Tour 500,HARD,2,Dudi Sela,Alejandro Falla,Dudi Sela,6-1; 6-4,R32,76,2,2,29,49,22,29,10,20,1,3,9,32,49,2,3,27,54,15,27,8,27,3,8,8,23,54
2014-02-24 00:00:00.000,Acapulco Mexico ATP World Tour 500,HARD,2,Jeremy Chardy,Matthew Ebden,Jeremy Chardy,7-5; 6-0,R32,66,7,1,30,52,24,30,15,22,1,1,9,39,52,2,4,22,46,14,22,11,24,1,5,9,25,46
2014-02-24 00:00:00.000,Acapulco Mexico ATP World Tour 500,HARD,2,Alexandr Dolgopolov,Vasek Pospisil,Alexandr Dolgopolov,6-2; 6-2,R32,68,5,0,26,45,20,26,13,19,1,1,8,33,45,5,2,34,56,19,34,8,22,3,7,8,27,56
2014-02-24 00:00:00.000,Acapulco Mexico ATP World Tour 500,HARD,2,Ernests Gulbis,Yen-Hsun Lu,Ernests Gulbis,6-1; 6-1,R32,60,4,5,24,52,22,24,11,28,2,2,7,33,52,0,2,28,43,10,28,7,15,2,7,7,17,43
2014-02-24 00:00:00.000,Acapulco Mexico ATP World Tour 500,HARD,2,David Goffin,Lukasz Kubot,David Goffin,6-4; 2-6; 6-4,R32,117,12,6,58,87,37,58,10,29,5,10,14,47,87,12,5,62,93,40,62,14,31,9,14,14,54,93
2014-02-24 00:00:00.000,Acapulco Mexico ATP World Tour 500,HARD,2,Marcos Baghdatis,Miguel Angel Reyes-Varela,Marcos Baghdatis,6-2; 6-4,R32,72,6,2,24,53,22,24,14,29,1,2,9,36,53,0,1,27,53,17,27,11,26,4,8,9,28,53
2014-02-24 00:00:00.000,Acapulco Mexico ATP World Tour 500,HARD,2,Grigor Dimitrov,Marinko Matosevic,Grigor Dimitrov,7-5; 6-1,R32,79,7,6,38,64,28,38,14,26,3,4,10,42,64,6,4,38,58,24,38,6,20,2,6,9,30,58
2014-02-24 00:00:00.000,Acapulco Mexico ATP World Tour 500,HARD,2,Gilles Simon,Tim Smyczek,Gilles Simon,6-1; 6-2,R32,66,1,0,18,42,16,18,18,24,3,3,8,34,42,2,0,42,62,23,42,8,20,6,10,7,31,62
2014-02-24 00:00:00.000,Acapulco Mexico ATP World Tour 500,HARD,2,Donald Young,Jarkko Nieminen,Donald Young,6-3; 6-3,R32,66,1,2,39,48,26,39,3,9,1,4,9,29,48,1,5,32,61,17,32,10,29,5,11,9,27,61
2014-02-24 00:00:00.000,Acapulco Mexico ATP World Tour 500,HARD,2,Joao Sousa,Adrian Mannarino,Joao Sousa,1-6; 6-2; 6-2,R32,96,2,2,45,73,31,45,12,28,5,8,11,43,73,3,2,41,69,26,41,12,28,3,8,12,38,69
2014-02-24 00:00:00.000,Acapulco Mexico ATP World Tour 500,HARD,2,Andy Murray,Pablo Andujar,Andy Murray,3-6; 6-1; 6-2,R32,121,7,4,50,81,35,50,14,31,7,10,12,49,81,0,3,58,86,31,58,12,28,9,15,12,43,86
2014-02-24 00:00:00.000,Acapulco Mexico ATP World Tour 500,HARD,2,David Ferrer,Feliciano Lopez,David Ferrer,7-6(1); 6-2,R16,83,2,1,46,66,34,46,14,20,2,2,10,48,66,4,3,36,53,27,36,7,17,0,2,10,34,53
2014-02-24 00:00:00.000,Acapulco Mexico ATP World Tour 500,HARD,2,Kevin Anderson,Sam Querrey,Kevin Anderson,7-6(2); 6-4,R16,85,11,3,40,60,37,40,13,20,0,0,11,50,60,3,3,46,73,35,46,12,27,3,4,11,47,73
2014-02-24 00:00:00.000,Acapulco Mexico ATP World Tour 500,HARD,2,Ivo Karlovic,Dudi Sela,Ivo Karlovic,7-6(4); 6-2,R16,80,16,2,38,60,35,38,13,22,3,3,10,48,60,2,4,38,60,25,38,15,22,2,4,10,40,60
2014-02-24 00:00:00.000,Acapulco Mexico ATP World Tour 500,HARD,2,Alexandr Dolgopolov,Jeremy Chardy,Alexandr Dolgopolov,6-3; 6-4,R16,66,11,0,28,48,26,28,14,20,0,0,10,40,48,7,2,26,55,17,26,19,29,6,8,9,36,55
2014-02-24 00:00:00.000,Acapulco Mexico ATP World Tour 500,HARD,2,Ernests Gulbis,David Goffin,Ernests Gulbis,6-1; 3-6; 7-6(5),R16,140,22,3,69,107,52,69,16,38,10,12,14,68,107,2,6,55,109,38,55,28,54,7,10,14,66,109
2014-02-24 00:00:00.000,Acapulco Mexico ATP World Tour 500,HARD,2,Grigor Dimitrov,Marcos Baghdatis,Grigor Dimitrov,6-1; 6-4,R16,60,1,1,32,50,24,32,10,18,0,1,9,34,50,2,5,21,46,14,21,9,25,0,4,8,23,46
2014-02-24 00:00:00.000,Acapulco Mexico ATP World Tour 500,HARD,2,Gilles Simon,Donald Young,Gilles Simon,6-4; 6-3,R16,80,1,1,38,55,24,38,7,17,4,7,9,31,55,2,2,40,58,16,40,9,18,3,9,10,25,58
2014-02-24 00:00:00.000,Acapulco Mexico ATP World Tour 500,HARD,2,Andy Murray,Joao Sousa,Andy Murray,6-3; 6-4,R16,101,6,0,33,64,21,33,22,31,2,3,10,43,64,0,3,35,68,24,35,13,33,6,9,9,37,68
2014-02-24 00:00:00.000,Acapulco Mexico ATP World Tour 500,HARD,2,Kevin Anderson,David Ferrer,Kevin Anderson,2-6; 4-2 RET,Q,76,3,1,28,47,21,28,6,19,3,6,7,27,47,0,1,27,42,17,27,8,15,3,5,7,25,42
2014-02-24 00:00:00.000,Acapulco Mexico ATP World Tour 500,HARD,2,Alexandr Dolgopolov,Ivo Karlovic,Alexandr Dolgopolov,6-4; 7-6(4),Q,100,11,3,42,74,34,42,21,32,3,3,11,55,74,18,4,50,73,42,50,10,23,7,8,11,52,73
2014-02-24 00:00:00.000,Acapulco Mexico ATP World Tour 500,HARD,2,Grigor Dimitrov,Ernests Gulbis,Grigor Dimitrov,4-6; 7-6(2); 7-5,Q,160,4,7,71,114,50,71,18,43,7,12,17,68,114,15,12,64,101,49,64,8,37,2,7,17,57,101
2014-02-24 00:00:00.000,Acapulco Mexico ATP World Tour 500,HARD,2,Andy Murray,Gilles Simon,Andy Murray,1-6; 7-6(4); 6-2,Q,155,5,3,51,96,35,51,20,45,3,9,14,55,96,2,2,44,78,24,44,19,34,0,5,13,43,78
2014-02-24 00:00:00.000,Acapulco Mexico ATP World Tour 500,HARD,2,Kevin Anderson,Alexandr Dolgopolov,Kevin Anderson,6-1; 5-7; 6-4,S,120,19,2,50,77,43,50,17,27,0,1,15,60,77,7,1,60,92,40,60,18,32,10,13,14,58,92
2014-02-24 00:00:00.000,Acapulco Mexico ATP World Tour 500,HARD,2,Grigor Dimitrov,Andy Murray,Grigor Dimitrov,4-6; 7-6(5); 7-6(3),S,175,5,2,74,107,59,74,16,33,3,6,17,75,107,4,1,72,109,57,72,20,37,5,7,17,77,109
2014-02-24 00:00:00.000,Acapulco Mexico ATP World Tour 500,HARD,2,Grigor Dimitrov,Kevin Anderson,Grigor Dimitrov,7-6(1); 3-6; 7-6(5),F,178,7,1,72,105,50,72,23,33,3,5,16,73,105,13,7,82,119,59,82,19,37,2,3,17,78,119
2014-02-24 00:00:00.000,Dubai U.A.E. ATP World Tour 500,HARD,2,Novak Djokovic,Denis Istomin,Novak Djokovic,6-3; 6-3,R32,84,6,2,44,66,32,44,12,22,4,4,9,44,66,3,1,43,71,28,43,11,28,9,12,9,39,71
2014-02-24 00:00:00.000,Dubai U.A.E. ATP World Tour 500,HARD,2,Roberto Bautista Agut,Adrian Ungur,Roberto Bautista Agut,6-1; 6-3,R32,66,3,2,34,51,26,34,8,17,5,6,8,34,51,2,6,30,56,15,30,10,26,7,12,8,25,56
2014-02-24 00:00:00.000,Dubai U.A.E. ATP World Tour 500,HARD,2,James Ward,Teymuraz Gabashvili,James Ward,2-6; 6-4; 7-6(6),R32,141,6,3,68,100,46,68,14,32,3,7,15,60,100,7,4,61,104,43,61,19,43,7,10,15,62,104
2014-02-24 00:00:00.000,Dubai U.A.E. ATP World Tour 500,HARD,2,Mikhail Youzhny,Michal Przysiezny,Mikhail Youzhny,6-3; 6-4,R32,74,2,2,28,51,21,28,16,23,2,3,9,37,51,3,3,34,57,19,34,12,23,3,7,10,31,57
2014-02-24 00:00:00.000,Dubai U.A.E. ATP World Tour 500,HARD,2,Roger Federer,Benjamin Becker,Roger Federer,6-1; 6-4,R32,62,5,2,31,50,26,31,12,19,1,1,9,38,50,1,3,34,62,21,34,13,28,1,4,8,34,62
2014-02-24 00:00:00.000,Dubai U.A.E. ATP World Tour 500,HARD,2,Radek Stepanek,Michael Russell,Radek Stepanek,5-7; 6-3; 6-1,R32,122,4,1,52,86,35,52,18,34,2,5,14,53,86,3,4,45,87,24,45,21,42,4,10,14,45,87
2014-02-24 00:00:00.000,Dubai U.A.E. ATP World Tour 500,HARD,2,Lukas Rosol,Daniel Brands,Lukas Rosol,7-6(4); 6-4,R32,75,9,3,42,70,34,42,15,28,3,4,11,49,70,10,3,47,72,34,47,14,25,3,5,11,48,72
2014-02-24 00:00:00.000,Dubai U.A.E. ATP World Tour 500,HARD,2,Dmitry Tursunov,Lukas Lacko,Dmitry Tursunov,7-5; 6-1,R32,70,7,3,19,59,15,19,28,40,4,4,10,43,59,6,0,30,54,20,30,11,24,2,5,9,31,54
2014-02-24 00:00:00.000,Dubai U.A.E. ATP World Tour 500,HARD,2,Jo-Wilfried Tsonga,Victor Hanescu,Jo-Wilfried Tsonga,6-2; 6-4,R32,72,5,0,27,47,22,27,12,20,0,1,9,34,47,1,1,38,58,23,38,6,20,6,10,9,29,58
2014-02-24 00:00:00.000,Dubai U.A.E. ATP World Tour 500,HARD,2,Nikolay Davydenko,Andrey Golubev,Nikolay Davydenko,7-6(6); 6-4,R32,91,1,2,40,62,28,40,14,22,1,4,11,42,62,3,4,43,72,28,43,11,29,1,5,11,39,72
2014-02-24 00:00:00.000,Dubai U.A.E. ATP World Tour 500,HARD,2,Sergiy Stakhovsky,Ivan Dodig,Sergiy Stakhovsky,7-6(6); 6-7(4); 6-2,R32,137,8,0,67,99,54,67,23,32,5,5,16,77,99,12,5,64,113,47,64,29,49,5,7,16,76,113
2014-02-24 00:00:00.000,Dubai U.A.E. ATP World Tour 500,HARD,2,Tomas Berdych,Marius Copil,Tomas Berdych,6-3; 6-4,R32,79,3,6,30,54,28,30,14,24,1,1,10,42,54,8,5,35,67,25,35,14,32,5,7,9,39,67
2014-02-24 00:00:00.000,Dubai U.A.E. ATP World Tour 500,HARD,2,Philipp Kohlschreiber,Thiemo de Bakker,Philipp Kohlschreiber,6-3; 6-3,R32,65,4,4,29,57,23,29,16,28,4,5,9,39,57,5,1,29,55,22,29,10,26,4,8,9,32,55
2014-02-24 00:00:00.000,Dubai U.A.E. ATP World Tour 500,HARD,2,Andreas Seppi,Florian Mayer,Andreas Seppi,4-6; 6-1; 7-5,R32,118,5,2,43,90,30,43,27,47,6,9,15,57,90,3,2,54,98,30,54,24,44,12,17,14,54,98
2014-02-24 00:00:00.000,Dubai U.A.E. ATP World Tour 500,HARD,2,Malek Jaziri,Igor Sijsling,Malek Jaziri,0-6; 6-4; 7-6(4),R32,112,6,7,52,105,37,52,24,53,8,12,14,61,105,7,2,51,79,38,51,16,28,2,4,14,54,79
2014-02-24 00:00:00.000,Dubai U.A.E. ATP World Tour 500,HARD,2,Somdev Devvarman,Juan Martin Del Potro,Somdev Devvarman,7-6(3) RET,R32,67,5,1,19,43,12,19,16,24,3,4,6,28,43,4,0,24,42,17,24,11,18,4,5,6,28,42
2014-02-24 00:00:00.000,Dubai U.A.E. ATP World Tour 500,HARD,2,Novak Djokovic,Roberto Bautista Agut,Novak Djokovic,6-1; 6-3,R16,58,4,2,34,47,26,34,6,13,1,2,8,32,47,0,1,31,46,13,31,8,15,3,8,8,21,46
2014-02-24 00:00:00.000,Dubai U.A.E. ATP World Tour 500,HARD,2,Mikhail Youzhny,James Ward,Mikhail Youzhny,6-1; 7-6(3),R16,95,4,1,35,64,29,35,15,29,0,1,10,44,64,3,2,36,64,25,36,11,28,4,7,9,36,64
2014-02-24 00:00:00.000,Dubai U.A.E. ATP World Tour 500,HARD,2,Roger Federer,Radek Stepanek,Roger Federer,6-2; 6-7(4); 6-3,R16,129,8,5,54,87,39,54,16,33,4,8,14,55,87,3,3,48,97,30,48,20,49,4,12,15,50,97
2014-02-24 00:00:00.000,Dubai U.A.E. ATP World Tour 500,HARD,2,Lukas Rosol,Dmitry Tursunov,Lukas Rosol,6-4; 7-6(4),R16,89,14,4,45,77,36,45,19,32,5,5,11,55,77,11,3,47,88,33,47,22,41,4,5,11,55,88
2014-02-24 00:00:00.000,Dubai U.A.E. ATP World Tour 500,HARD,2,Jo-Wilfried Tsonga,Nikolay Davydenko,Jo-Wilfried Tsonga,W/O,R16,0,0,0,0,0,0,0,0,0,0,0,0,0,0,0,0,0,0,0,0,0,0,0,0,0,0,0
2014-02-24 00:00:00.000,Dubai U.A.E. ATP World Tour 500,HARD,2,Tomas Berdych,Sergiy Stakhovsky,Tomas Berdych,6-2; 6-1,R16,57,1,0,15,40,12,15,17,25,0,1,8,29,40,2,2,19,40,10,19,8,21,4,9,7,18,40
2014-02-24 00:00:00.000,Dubai U.A.E. ATP World Tour 500,HARD,2,Philipp Kohlschreiber,Andreas Seppi,Philipp Kohlschreiber,6-3; 6-3,R16,80,5,0,41,71,32,41,15,30,4,4,9,47,71,7,1,38,61,24,38,10,23,1,4,9,34,61
2014-02-24 00:00:00.000,Dubai U.A.E. ATP World Tour 500,HARD,2,Malek Jaziri,Somdev Devvarman,Malek Jaziri,6-3; 7-5,R16,95,9,0,36,69,25,36,19,33,8,10,10,44,69,4,3,32,64,19,32,15,32,4,9,11,34,64
2014-02-24 00:00:00.000,Dubai U.A.E. ATP World Tour 500,HARD,2,Novak Djokovic,Mikhail Youzhny,Novak Djokovic,W/O,Q,0,0,0,0,0,0,0,0,0,0,0,0,0,0,0,0,0,0,0,0,0,0,0,0,0,0,0
2014-02-24 00:00:00.000,Dubai U.A.E. ATP World Tour 500,HARD,2,Roger Federer,Lukas Rosol,Roger Federer,6-2; 6-2,Q,58,4,1,30,48,24,30,8,18,1,2,8,32,48,2,2,27,55,13,27,11,28,6,11,8,24,55
2014-02-24 00:00:00.000,Dubai U.A.E. ATP World Tour 500,HARD,2,Tomas Berdych,Jo-Wilfried Tsonga,Tomas Berdych,6-4; 6-3,Q,88,3,3,40,64,30,40,15,24,5,5,10,45,64,5,3,29,61,24,29,14,32,5,7,9,38,61
2014-02-24 00:00:00.000,Dubai U.A.E. ATP World Tour 500,HARD,2,Philipp Kohlschreiber,Malek Jaziri,Philipp Kohlschreiber,6-2; 6-3,Q,72,2,1,28,51,26,28,13,23,0,0,9,39,51,3,5,21,50,12,21,14,29,1,4,8,26,50
2014-02-24 00:00:00.000,Dubai U.A.E. ATP World Tour 500,HARD,2,Roger Federer,Novak Djokovic,Roger Federer,3-6; 6-3; 6-2,S,106,7,0,46,77,35,46,18,31,5,6,13,53,77,5,2,53,86,36,53,19,33,4,7,13,55,86
2014-02-24 00:00:00.000,Dubai U.A.E. ATP World Tour 500,HARD,2,Tomas Berdych,Philipp Kohlschreiber,Tomas Berdych,7-5; 7-5,S,89,5,1,39,64,32,39,14,25,0,1,12,46,64,1,0,36,69,25,36,20,33,4,7,12,45,69
2014-02-24 00:00:00.000,Dubai U.A.E. ATP World Tour 500,HARD,2,Roger Federer,Tomas Berdych,Roger Federer,3-6; 6-4; 6-3,F,119,8,1,43,84,36,43,19,41,7,10,14,55,84,5,1,41,85,27,41,20,44,6,10,14,47,85
2014-02-24 00:00:00.000,Sao Paulo Brazil ATP World Tour 250,CLAY,2,Tommy Haas,N/A Bye,Tommy Haas,,R32,0,0,0,0,0,0,0,0,0,0,0,0,0,0,0,0,0,0,0,0,0,0,0,0,0,0,0
2014-02-24 00:00:00.000,Sao Paulo Brazil ATP World Tour 250,CLAY,2,Potito Starace,Alejandro Gonzalez,Potito Starace,4-6; 6-2; 6-3,R32,110,3,1,64,88,43,64,12,24,5,7,13,55,88,6,2,59,91,39,59,13,32,7,12,14,52,91
2014-02-24 00:00:00.000,Sao Paulo Brazil ATP World Tour 250,CLAY,2,Horacio Zeballos,Pablo Cuevas,Horacio Zeballos,7-6(3); 3-6; 6-3,R32,127,5,0,56,109,43,56,31,53,8,9,15,74,109,18,2,44,80,39,44,24,36,0,1,15,63,80
2014-02-24 00:00:00.000,Sao Paulo Brazil ATP World Tour 250,CLAY,2,Guido Pella,Leonardo Mayer,Guido Pella,7-6(4); 6-7(3); 7-6(4),R32,154,9,1,78,123,65,78,25,45,6,7,18,90,123,11,7,77,120,64,77,22,43,2,3,18,86,120
2014-02-24 00:00:00.000,Sao Paulo Brazil ATP World Tour 250,CLAY,2,Juan Monaco,N/A Bye,Juan Monaco,,R32,0,0,0,0,0,0,0,0,0,0,0,0,0,0,0,0,0,0,0,0,0,0,0,0,0,0,0
2014-02-24 00:00:00.000,Sao Paulo Brazil ATP World Tour 250,CLAY,2,Albert Ramos-Vinolas,Gastao Elias,Albert Ramos-Vinolas,6-3; 3-6; 6-2,R32,131,2,3,56,88,37,56,19,32,4,6,13,56,88,6,2,42,89,33,42,21,47,7,11,13,54,89
2014-02-24 00:00:00.000,Sao Paulo Brazil ATP World Tour 250,CLAY,2,Paolo Lorenzi,Pere Riba,Paolo Lorenzi,7-5; 6-3,R32,99,6,2,41,71,32,41,19,30,3,3,11,51,71,9,2,37,72,28,37,19,35,5,7,10,47,72
2014-02-24 00:00:00.000,Sao Paulo Brazil ATP World Tour 250,CLAY,2,Rogerio Dutra Silva,Guillermo Garcia-Lopez,Rogerio Dutra Silva,1-6; 7-5; 6-3,R32,138,4,2,77,115,48,77,19,38,12,15,14,67,115,4,5,43,91,30,43,25,48,5,8,14,55,91
2014-02-24 00:00:00.000,Sao Paulo Brazil ATP World Tour 250,CLAY,2,Thomaz Bellucci,Santiago Giraldo,Thomaz Bellucci,4-6; 7-5; 6-3,R32,126,6,1,56,91,38,56,23,35,4,7,16,61,91,2,1,55,86,37,55,16,31,6,10,15,53,86
2014-02-24 00:00:00.000,Sao Paulo Brazil ATP World Tour 250,CLAY,2,Andreas Haider-Maurer,Julian Reister,Andreas Haider-Maurer,6-2; 4-6; 6-1,R32,109,8,0,56,93,43,56,17,37,6,7,13,60,93,3,1,43,68,28,43,12,25,4,8,12,40,68
2014-02-24 00:00:00.000,Sao Paulo Brazil ATP World Tour 250,CLAY,2,Martin Klizan,Guilherme Clezar,Martin Klizan,6-4; 6-3,R32,71,12,7,26,57,23,26,19,31,2,2,10,42,57,3,0,32,50,25,32,8,18,0,2,9,33,50
2014-02-24 00:00:00.000,Sao Paulo Brazil ATP World Tour 250,CLAY,2,Marcel Granollers,N/A Bye,Marcel Granollers,,R32,0,0,0,0,0,0,0,0,0,0,0,0,0,0,0,0,0,0,0,0,0,0,0,0,0,0,0
2014-02-24 00:00:00.000,Sao Paulo Brazil ATP World Tour 250,CLAY,2,Joao Souza,Robin Haase,Joao Souza,7-5; 6-4,R32,103,4,0,48,66,40,48,8,18,4,4,11,48,66,3,0,43,74,32,43,14,31,3,5,11,46,74
2014-02-24 00:00:00.000,Sao Paulo Brazil ATP World Tour 250,CLAY,2,Albert Montanes,Aljaz Bedene,Albert Montanes,6-2; 6-2,R32,60,0,0,30,40,25,30,8,10,3,3,8,33,40,1,1,20,43,13,20,11,23,0,4,8,24,43
2014-02-24 00:00:00.000,Sao Paulo Brazil ATP World Tour 250,CLAY,2,Federico Delbonis,Filippo Volandri,Federico Delbonis,6-1; 6-2,R32,47,8,1,30,40,25,30,6,10,2,3,8,31,40,2,1,24,39,11,24,4,15,2,7,7,15,39
2014-02-24 00:00:00.000,Sao Paulo Brazil ATP World Tour 250,CLAY,2,Nicolas Almagro,N/A Bye,Nicolas Almagro,,R32,0,0,0,0,0,0,0,0,0,0,0,0,0,0,0,0,0,0,0,0,0,0,0,0,0,0,0
2014-02-24 00:00:00.000,Sao Paulo Brazil ATP World Tour 250,CLAY,2,Tommy Haas,Potito Starace,Tommy Haas,7-6(2); 6-3,R16,90,5,3,40,68,35,40,13,28,1,1,10,48,68,6,2,52,78,36,52,13,26,6,8,11,49,78
2014-02-24 00:00:00.000,Sao Paulo Brazil ATP World Tour 250,CLAY,2,Horacio Zeballos,Guido Pella,Horacio Zeballos,6-3; 6-4,R16,74,6,0,39,53,33,39,6,14,1,2,10,39,53,6,1,37,58,25,37,9,21,7,10,9,34,58
2014-02-24 00:00:00.000,Sao Paulo Brazil ATP World Tour 250,CLAY,2,Juan Monaco,Albert Ramos-Vinolas,Juan Monaco,7-6(4); 2-6; 7-5,R16,173,5,4,85,129,53,85,23,44,14,18,16,76,129,5,4,65,108,42,65,21,43,4,7,16,63,108
2014-02-24 00:00:00.000,Sao Paulo Brazil ATP World Tour 250,CLAY,2,Paolo Lorenzi,Rogerio Dutra Silva,Paolo Lorenzi,6-4; 6-3,R16,71,1,3,26,51,22,26,14,25,0,2,10,36,51,1,2,29,45,16,29,8,16,0,4,9,24,45
2014-02-24 00:00:00.000,Sao Paulo Brazil ATP World Tour 250,CLAY,2,Thomaz Bellucci,Andreas Haider-Maurer,Thomaz Bellucci,7-6(4); 5-7; 6-3,R16,157,16,1,65,103,50,65,22,38,6,8,17,72,103,6,4,63,122,48,63,29,59,7,9,16,77,122
2014-02-24 00:00:00.000,Sao Paulo Brazil ATP World Tour 250,CLAY,2,Martin Klizan,Marcel Granollers,Martin Klizan,6-4; 6-3,R16,86,4,3,34,67,25,34,18,33,5,7,10,43,67,1,1,25,54,15,25,13,29,0,4,9,28,54
2014-02-24 00:00:00.000,Sao Paulo Brazil ATP World Tour 250,CLAY,2,Albert Montanes,Joao Souza,Albert Montanes,6-4; 2-3 RET,R16,72,2,1,27,41,21,27,9,14,3,3,7,30,41,2,0,33,47,26,33,7,14,3,4,8,33,47
2014-02-24 00:00:00.000,Sao Paulo Brazil ATP World Tour 250,CLAY,2,Federico Delbonis,Nicolas Almagro,Federico Delbonis,3-6; 6-3; 6-2,R16,91,10,0,56,82,44,56,12,26,9,10,13,56,82,10,5,38,69,32,38,13,31,2,5,13,45,69
2014-02-24 00:00:00.000,Sao Paulo Brazil ATP World Tour 250,CLAY,2,Tommy Haas,Horacio Zeballos,Tommy Haas,6-3; 5-7; 6-2,Q,102,10,4,43,81,37,43,25,38,5,6,15,62,81,7,2,51,85,40,51,14,34,3,6,14,54,85
2014-02-24 00:00:00.000,Sao Paulo Brazil ATP World Tour 250,CLAY,2,Paolo Lorenzi,Juan Monaco,Paolo Lorenzi,7-6(6); 6-7(4); 6-4,Q,154,12,4,58,99,46,58,22,41,2,6,17,68,99,0,2,79,114,51,79,16,35,2,7,17,67,114
2014-02-24 00:00:00.000,Sao Paulo Brazil ATP World Tour 250,CLAY,2,Thomaz Bellucci,Martin Klizan,Thomaz Bellucci,6-3; 6-3,Q,75,5,2,30,47,29,30,7,17,0,0,9,36,47,4,3,36,65,26,36,12,29,5,8,9,38,65
2014-02-24 00:00:00.000,Sao Paulo Brazil ATP World Tour 250,CLAY,2,Federico Delbonis,Albert Montanes,Federico Delbonis,6-4; 6-3,Q,66,6,0,28,50,22,28,15,22,0,1,10,37,50,0,1,47,62,26,47,9,15,6,9,9,35,62
2014-02-24 00:00:00.000,Sao Paulo Brazil ATP World Tour 250,CLAY,2,Paolo Lorenzi,Tommy Haas,Paolo Lorenzi,6-3; 3-2 RET,S,62,6,1,20,42,16,20,13,22,0,0,7,29,42,2,2,28,48,20,28,8,20,1,3,7,28,48
2014-02-24 00:00:00.000,Sao Paulo Brazil ATP World Tour 250,CLAY,2,Federico Delbonis,Thomaz Bellucci,Federico Delbonis,6-4; 6-7(5); 6-4,S,130,8,2,57,92,42,57,24,35,0,2,16,66,92,6,6,56,97,41,56,23,41,3,7,16,64,97
2014-02-24 00:00:00.000,Sao Paulo Brazil ATP World Tour 250,CLAY,2,Federico Delbonis,Paolo Lorenzi,Federico Delbonis,4-6; 6-3; 6-4,F,127,12,0,55,87,46,55,19,32,2,3,15,65,87,6,3,49,87,33,49,23,38,1,3,14,56,87
2014-03-06 00:00:00.000,ATP World Tour Masters 1000 Indian Wells CA; U.S.A. ATP World Tour Masters 1000,HARD,2,Rafael Nadal,N/A Bye,Rafael Nadal,,R128,0,0,0,0,0,0,0,0,0,0,0,0,0,0,0,0,0,0,0,0,0,0,0,0,0,0,0
2014-03-06 00:00:00.000,ATP World Tour Masters 1000 Indian Wells CA; U.S.A. ATP World Tour Masters 1000,HARD,2,Radek Stepanek,Denis Istomin,Radek Stepanek,6-1; 3-6; 6-1,R128,116,4,0,44,84,34,44,20,40,5,6,12,54,84,3,5,43,77,30,43,12,34,3,7,11,42,77
2014-03-06 00:00:00.000,ATP World Tour Masters 1000 Indian Wells CA; U.S.A. ATP World Tour Masters 1000,HARD,2,Tim Smyczek,Jack Sock,Tim Smyczek,6-4; 1-6; 6-4,R128,123,3,5,63,98,38,63,18,35,9,13,13,56,98,6,9,48,93,38,48,17,45,6,10,14,55,93
2014-03-06 00:00:00.000,ATP World Tour Masters 1000 Indian Wells CA; U.S.A. ATP World Tour Masters 1000,HARD,2,Alexandr Dolgopolov,N/A Bye,Alexandr Dolgopolov,,R128,0,0,0,0,0,0,0,0,0,0,0,0,0,0,0,0,0,0,0,0,0,0,0,0,0,0,0
2014-03-06 00:00:00.000,ATP World Tour Masters 1000 Indian Wells CA; U.S.A. ATP World Tour Masters 1000,HARD,2,Gael Monfils,N/A Bye,Gael Monfils,,R128,0,0,0,0,0,0,0,0,0,0,0,0,0,0,0,0,0,0,0,0,0,0,0,0,0,0,0
2014-03-06 00:00:00.000,ATP World Tour Masters 1000 Indian Wells CA; U.S.A. ATP World Tour Masters 1000,HARD,2,Sergiy Stakhovsky,Lukasz Kubot,Sergiy Stakhovsky,6-4; 7-5,R128,88,1,1,41,59,30,41,12,18,2,3,11,42,59,4,4,39,65,29,39,12,26,6,9,11,41,65
2014-03-06 00:00:00.000,ATP World Tour Masters 1000 Indian Wells CA; U.S.A. ATP World Tour Masters 1000,HARD,2,Ryan Harrison,Andrey Golubev,Ryan Harrison,6-4; 7-5,R128,92,2,3,42,68,30,42,18,26,3,3,11,48,68,0,2,34,69,20,34,24,35,6,8,11,44,69
2014-03-06 00:00:00.000,ATP World Tour Masters 1000 Indian Wells CA; U.S.A. ATP World Tour Masters 1000,HARD,2,Fabio Fognini,N/A Bye,Fabio Fognini,,R128,0,0,0,0,0,0,0,0,0,0,0,0,0,0,0,0,0,0,0,0,0,0,0,0,0,0,0
2014-03-06 00:00:00.000,ATP World Tour Masters 1000 Indian Wells CA; U.S.A. ATP World Tour Masters 1000,HARD,2,Milos Raonic,N/A Bye,Milos Raonic,,R128,0,0,0,0,0,0,0,0,0,0,0,0,0,0,0,0,0,0,0,0,0,0,0,0,0,0,0
2014-03-06 00:00:00.000,ATP World Tour Masters 1000 Indian Wells CA; U.S.A. ATP World Tour Masters 1000,HARD,2,Edouard Roger-Vasselin,Benjamin Becker,Edouard Roger-Vasselin,6-4; 6-2,R128,73,2,1,36,59,28,36,12,23,6,7,9,40,59,6,2,22,46,17,22,8,24,1,5,9,25,46
2014-03-06 00:00:00.000,ATP World Tour Masters 1000 Indian Wells CA; U.S.A. ATP World Tour Masters 1000,HARD,2,Alejandro Falla,Federico Delbonis,Alejandro Falla,6-3; 6-4,R128,70,4,4,34,63,31,34,13,29,2,2,10,44,63,2,4,33,55,24,33,10,22,2,4,9,34,55
2014-03-06 00:00:00.000,ATP World Tour Masters 1000 Indian Wells CA; U.S.A. ATP World Tour Masters 1000,HARD,2,Jerzy Janowicz,N/A Bye,Jerzy Janowicz,,R128,0,0,0,0,0,0,0,0,0,0,0,0,0,0,0,0,0,0,0,0,0,0,0,0,0,0,0
2014-03-06 00:00:00.000,ATP World Tour Masters 1000 Indian Wells CA; U.S.A. ATP World Tour Masters 1000,HARD,2,Pablo Andujar,N/A Bye,Pablo Andujar,,R128,0,0,0,0,0,0,0,0,0,0,0,0,0,0,0,0,0,0,0,0,0,0,0,0,0,0,0
2014-03-06 00:00:00.000,ATP World Tour Masters 1000 Indian Wells CA; U.S.A. ATP World Tour Masters 1000,HARD,2,Jiri Vesely,Igor Sijsling,Jiri Vesely,3-6; 6-4; 7-6(1),R128,113,15,10,58,88,47,58,12,30,4,8,16,59,88,5,5,50,100,37,50,25,50,8,11,15,62,100
2014-03-06 00:00:00.000,ATP World Tour Masters 1000 Indian Wells CA; U.S.A. ATP World Tour Masters 1000,HARD,2,Lukas Rosol,Dusan Lajovic,Lukas Rosol,6-7(2); 7-5; 6-4,R128,124,7,6,55,102,45,55,24,47,3,4,17,69,102,13,2,69,110,53,69,20,41,5,8,17,73,110
2014-03-06 00:00:00.000,ATP World Tour Masters 1000 Indian Wells CA; U.S.A. ATP World Tour Masters 1000,HARD,2,Andy Murray,N/A Bye,Andy Murray,,R128,0,0,0,0,0,0,0,0,0,0,0,0,0,0,0,0,0,0,0,0,0,0,0,0,0,0,0
2014-03-06 00:00:00.000,ATP World Tour Masters 1000 Indian Wells CA; U.S.A. ATP World Tour Masters 1000,HARD,2,Stan Wawrinka,N/A Bye,Stan Wawrinka,,R128,0,0,0,0,0,0,0,0,0,0,0,0,0,0,0,0,0,0,0,0,0,0,0,0,0,0,0
2014-03-06 00:00:00.000,ATP World Tour Masters 1000 Indian Wells CA; U.S.A. ATP World Tour Masters 1000,HARD,2,Ivo Karlovic,Alex Bogomolov Jr.,Ivo Karlovic,6-4; 6-4,R128,69,8,1,32,53,25,32,10,21,2,4,10,35,53,0,1,36,52,22,36,8,16,1,5,10,30,52
2014-03-06 00:00:00.000,ATP World Tour Masters 1000 Indian Wells CA; U.S.A. ATP World Tour Masters 1000,HARD,2,Sam Querrey,Alex Kuznetsov,Sam Querrey,6-3; 6-3,R128,69,8,1,26,53,22,26,18,27,2,2,9,40,53,4,0,40,59,25,40,10,19,3,6,9,35,59
2014-03-06 00:00:00.000,ATP World Tour Masters 1000 Indian Wells CA; U.S.A. ATP World Tour Masters 1000,HARD,2,Andreas Seppi,N/A Bye,Andreas Seppi,,R128,0,0,0,0,0,0,0,0,0,0,0,0,0,0,0,0,0,0,0,0,0,0,0,0,0,0,0
2014-03-06 00:00:00.000,ATP World Tour Masters 1000 Indian Wells CA; U.S.A. ATP World Tour Masters 1000,HARD,2,Kevin Anderson,N/A Bye,Kevin Anderson,,R128,0,0,0,0,0,0,0,0,0,0,0,0,0,0,0,0,0,0,0,0,0,0,0,0,0,0,0
2014-03-06 00:00:00.000,ATP World Tour Masters 1000 Indian Wells CA; U.S.A. ATP World Tour Masters 1000,HARD,2,Lleyton Hewitt,Matthew Ebden,Lleyton Hewitt,7-6(2); 3-6; 6-3,R128,133,4,10,49,89,31,49,17,40,7,14,15,48,89,4,8,50,98,32,50,19,48,8,15,15,51,98
2014-03-06 00:00:00.000,ATP World Tour Masters 1000 Indian Wells CA; U.S.A. ATP World Tour Masters 1000,HARD,2,Michael Russell,Donald Young,Michael Russell,4-6; 6-1; 6-2,R128,113,1,5,36,67,25,36,17,31,1,4,12,42,67,2,3,50,86,28,50,13,36,10,17,13,41,86
2014-03-06 00:00:00.000,ATP World Tour Masters 1000 Indian Wells CA; U.S.A. ATP World Tour Masters 1000,HARD,2,Evgeny Donskoy,N/A Bye,Evgeny Donskoy,,R128,0,0,0,0,0,0,0,0,0,0,0,0,0,0,0,0,0,0,0,0,0,0,0,0,0,0,0
2014-03-06 00:00:00.000,ATP World Tour Masters 1000 Indian Wells CA; U.S.A. ATP World Tour Masters 1000,HARD,2,Tommy Haas,N/A Bye,Tommy Haas,,R128,0,0,0,0,0,0,0,0,0,0,0,0,0,0,0,0,0,0,0,0,0,0,0,0,0,0,0
2014-03-06 00:00:00.000,ATP World Tour Masters 1000 Indian Wells CA; U.S.A. ATP World Tour Masters 1000,HARD,2,Jeremy Chardy,Rhyne Williams,Jeremy Chardy,7-6(5); 7-5,R128,101,13,5,36,65,33,36,18,29,0,1,12,51,65,13,4,63,86,45,63,10,23,3,5,12,55,86
2014-03-06 00:00:00.000,ATP World Tour Masters 1000 Indian Wells CA; U.S.A. ATP World Tour Masters 1000,HARD,2,Santiago Giraldo,Daniel Gimeno-Traver,Santiago Giraldo,6-3; 4-6; 6-4,R128,126,4,2,48,97,34,48,29,49,5,7,15,63,97,5,3,39,87,27,39,29,48,2,5,14,56,87
2014-03-06 00:00:00.000,ATP World Tour Masters 1000 Indian Wells CA; U.S.A. ATP World Tour Masters 1000,HARD,2,Kei Nishikori,N/A Bye,Kei Nishikori,,R128,0,0,0,0,0,0,0,0,0,0,0,0,0,0,0,0,0,0,0,0,0,0,0,0,0,0,0
2014-03-06 00:00:00.000,ATP World Tour Masters 1000 Indian Wells CA; U.S.A. ATP World Tour Masters 1000,HARD,2,Dmitry Tursunov,N/A Bye,Dmitry Tursunov,,R128,0,0,0,0,0,0,0,0,0,0,0,0,0,0,0,0,0,0,0,0,0,0,0,0,0,0,0
2014-03-06 00:00:00.000,ATP World Tour Masters 1000 Indian Wells CA; U.S.A. ATP World Tour Masters 1000,HARD,2,Juan Monaco,Peter Polansky,Juan Monaco,6-4; 6-7(5); 6-4,R128,144,2,2,65,91,48,65,18,26,1,3,16,66,91,2,3,61,101,40,61,24,40,6,10,16,64,101
2014-03-06 00:00:00.000,ATP World Tour Masters 1000 Indian Wells CA; U.S.A. ATP World Tour Masters 1000,HARD,2,Paul-Henri Mathieu,Robby Ginepri,Paul-Henri Mathieu,6-2; 6-3,R128,83,4,2,37,68,26,37,17,31,5,6,9,43,68,1,3,38,58,23,38,6,20,4,8,8,29,58
2014-03-06 00:00:00.000,ATP World Tour Masters 1000 Indian Wells CA; U.S.A. ATP World Tour Masters 1000,HARD,2,Roger Federer,N/A Bye,Roger Federer,,R128,0,0,0,0,0,0,0,0,0,0,0,0,0,0,0,0,0,0,0,0,0,0,0,0,0,0,0
2014-03-06 00:00:00.000,ATP World Tour Masters 1000 Indian Wells CA; U.S.A. ATP World Tour Masters 1000,HARD,2,Richard Gasquet,N/A Bye,Richard Gasquet,,R128,0,0,0,0,0,0,0,0,0,0,0,0,0,0,0,0,0,0,0,0,0,0,0,0,0,0,0
2014-03-06 00:00:00.000,ATP World Tour Masters 1000 Indian Wells CA; U.S.A. ATP World Tour Masters 1000,HARD,2,Teymuraz Gabashvili,Nicolas Mahut,Teymuraz Gabashvili,6-2; 7-5,R128,89,2,1,47,64,33,47,6,17,3,6,10,39,64,5,3,49,73,24,49,9,24,3,9,10,33,73
2014-03-06 00:00:00.000,ATP World Tour Masters 1000 Indian Wells CA; U.S.A. ATP World Tour Masters 1000,HARD,2,Horacio Zeballos,Rajeev Ram,Horacio Zeballos,6-3; 7-6(4),R128,100,6,2,44,77,34,44,23,33,3,3,11,57,77,8,2,43,69,34,43,11,26,2,3,10,45,69
2014-03-06 00:00:00.000,ATP World Tour Masters 1000 Indian Wells CA; U.S.A. ATP World Tour Masters 1000,HARD,2,Fernando Verdasco,N/A Bye,Fernando Verdasco,,R128,0,0,0,0,0,0,0,0,0,0,0,0,0,0,0,0,0,0,0,0,0,0,0,0,0,0,0
2014-03-06 00:00:00.000,ATP World Tour Masters 1000 Indian Wells CA; U.S.A. ATP World Tour Masters 1000,HARD,2,Philipp Kohlschreiber,N/A Bye,Philipp Kohlschreiber,,R128,0,0,0,0,0,0,0,0,0,0,0,0,0,0,0,0,0,0,0,0,0,0,0,0,0,0,0
2014-03-06 00:00:00.000,ATP World Tour Masters 1000 Indian Wells CA; U.S.A. ATP World Tour Masters 1000,HARD,2,Yen-Hsun Lu,Tobias Kamke,Yen-Hsun Lu,6-0; 6-4,R128,60,1,1,31,45,25,31,6,14,4,5,8,31,45,1,1,32,51,17,32,6,19,4,9,8,23,51
2014-03-06 00:00:00.000,ATP World Tour Masters 1000 Indian Wells CA; U.S.A. ATP World Tour Masters 1000,HARD,2,Nikolay Davydenko,David Goffin,Nikolay Davydenko,7-6(5); 4-6; 7-6(3),R128,150,8,4,72,117,47,72,20,45,6,12,17,67,117,2,8,64,118,43,64,27,54,4,9,17,70,118
2014-03-06 00:00:00.000,ATP World Tour Masters 1000 Indian Wells CA; U.S.A. ATP World Tour Masters 1000,HARD,2,John Isner,N/A Bye,John Isner,,R128,0,0,0,0,0,0,0,0,0,0,0,0,0,0,0,0,0,0,0,0,0,0,0,0,0,0,0
2014-03-06 00:00:00.000,ATP World Tour Masters 1000 Indian Wells CA; U.S.A. ATP World Tour Masters 1000,HARD,2,Grigor Dimitrov,N/A Bye,Grigor Dimitrov,,R128,0,0,0,0,0,0,0,0,0,0,0,0,0,0,0,0,0,0,0,0,0,0,0,0,0,0,0
2014-03-06 00:00:00.000,ATP World Tour Masters 1000 Indian Wells CA; U.S.A. ATP World Tour Masters 1000,HARD,2,Robin Haase,John-Patrick Smith,Robin Haase,6-4; 6-4,R128,84,1,3,28,51,25,28,16,23,0,0,10,41,51,4,2,44,73,32,44,13,29,5,7,10,45,73
2014-03-06 00:00:00.000,ATP World Tour Masters 1000 Indian Wells CA; U.S.A. ATP World Tour Masters 1000,HARD,2,Joao Sousa,Aleksandr Nedovyesov,Joao Sousa,6-4; 6-1,R128,59,2,0,29,38,27,29,5,9,0,0,8,32,38,3,1,37,54,20,37,9,17,5,9,9,29,54
2014-03-06 00:00:00.000,ATP World Tour Masters 1000 Indian Wells CA; U.S.A. ATP World Tour Masters 1000,HARD,2,Ernests Gulbis,N/A Bye,Ernests Gulbis,,R128,0,0,0,0,0,0,0,0,0,0,0,0,0,0,0,0,0,0,0,0,0,0,0,0,0,0,0
2014-03-06 00:00:00.000,ATP World Tour Masters 1000 Indian Wells CA; U.S.A. ATP World Tour Masters 1000,HARD,2,Florian Mayer,N/A Bye,Florian Mayer,,R128,0,0,0,0,0,0,0,0,0,0,0,0,0,0,0,0,0,0,0,0,0,0,0,0,0,0,0
2014-03-06 00:00:00.000,ATP World Tour Masters 1000 Indian Wells CA; U.S.A. ATP World Tour Masters 1000,HARD,2,Jarkko Nieminen,Daniel Brands,Jarkko Nieminen,4-6; 6-2; 6-2,R128,98,2,5,51,78,36,51,16,27,3,5,13,52,78,2,0,61,91,41,61,9,30,8,13,13,50,91
2014-03-06 00:00:00.000,ATP World Tour Masters 1000 Indian Wells CA; U.S.A. ATP World Tour Masters 1000,HARD,2,Roberto Bautista Agut,Steve Johnson,Roberto Bautista Agut,6-3; 6-3,R128,81,1,2,36,57,29,36,12,21,2,2,9,41,57,3,1,47,68,33,47,5,21,3,6,9,38,68
2014-03-06 00:00:00.000,ATP World Tour Masters 1000 Indian Wells CA; U.S.A. ATP World Tour Masters 1000,HARD,2,Tomas Berdych,N/A Bye,Tomas Berdych,,R128,0,0,0,0,0,0,0,0,0,0,0,0,0,0,0,0,0,0,0,0,0,0,0,0,0,0,0
2014-03-06 00:00:00.000,ATP World Tour Masters 1000 Indian Wells CA; U.S.A. ATP World Tour Masters 1000,HARD,2,James Ward,N/A Bye,James Ward,,R128,0,0,0,0,0,0,0,0,0,0,0,0,0,0,0,0,0,0,0,0,0,0,0,0,0,0,0
2014-03-06 00:00:00.000,ATP World Tour Masters 1000 Indian Wells CA; U.S.A. ATP World Tour Masters 1000,HARD,2,Feliciano Lopez,Dudi Sela,Feliciano Lopez,7-5; 6-3,R128,97,9,2,55,79,40,55,13,24,5,5,11,53,79,1,2,43,72,29,43,15,29,5,7,10,44,72
2014-03-06 00:00:00.000,ATP World Tour Masters 1000 Indian Wells CA; U.S.A. ATP World Tour Masters 1000,HARD,2,Mikhail Kukushkin,Sam Groth,Mikhail Kukushkin,6-4; 2-6; 7-6(4),R128,123,3,0,57,92,36,57,21,35,4,8,15,57,92,17,11,56,97,47,56,14,41,4,7,15,61,97
2014-03-06 00:00:00.000,ATP World Tour Masters 1000 Indian Wells CA; U.S.A. ATP World Tour Masters 1000,HARD,2,Vasek Pospisil,N/A Bye,Vasek Pospisil,,R128,0,0,0,0,0,0,0,0,0,0,0,0,0,0,0,0,0,0,0,0,0,0,0,0,0,0,0
2014-03-06 00:00:00.000,ATP World Tour Masters 1000 Indian Wells CA; U.S.A. ATP World Tour Masters 1000,HARD,2,Gilles Simon,N/A Bye,Gilles Simon,,R128,0,0,0,0,0,0,0,0,0,0,0,0,0,0,0,0,0,0,0,0,0,0,0,0,0,0,0
2014-03-06 00:00:00.000,ATP World Tour Masters 1000 Indian Wells CA; U.S.A. ATP World Tour Masters 1000,HARD,2,Dominic Thiem,Daniel Kosakowski,Dominic Thiem,6-2; 7-6(1),R128,89,4,1,27,56,24,27,21,29,2,2,10,45,56,4,2,42,63,29,42,7,21,2,4,10,36,63
2014-03-06 00:00:00.000,ATP World Tour Masters 1000 Indian Wells CA; U.S.A. ATP World Tour Masters 1000,HARD,2,Julien Benneteau,Daniel Munoz-De La Nava,Julien Benneteau,3-6; 6-1; 6-3,R128,124,9,4,38,67,31,38,16,29,1,3,12,47,67,4,7,66,107,39,66,20,41,8,13,13,59,107
2014-03-06 00:00:00.000,ATP World Tour Masters 1000 Indian Wells CA; U.S.A. ATP World Tour Masters 1000,HARD,2,Jo-Wilfried Tsonga,N/A Bye,Jo-Wilfried Tsonga,,R128,0,0,0,0,0,0,0,0,0,0,0,0,0,0,0,0,0,0,0,0,0,0,0,0,0,0,0
2014-03-06 00:00:00.000,ATP World Tour Masters 1000 Indian Wells CA; U.S.A. ATP World Tour Masters 1000,HARD,2,Tommy Robredo,N/A Bye,Tommy Robredo,,R128,0,0,0,0,0,0,0,0,0,0,0,0,0,0,0,0,0,0,0,0,0,0,0,0,0,0,0
2014-03-06 00:00:00.000,ATP World Tour Masters 1000 Indian Wells CA; U.S.A. ATP World Tour Masters 1000,HARD,2,Marinko Matosevic,Bradley Klahn,Marinko Matosevic,6-4; 6-4,R128,85,1,2,31,55,22,31,17,24,2,3,10,39,55,1,4,30,69,22,30,16,39,5,8,10,38,69
2014-03-06 00:00:00.000,ATP World Tour Masters 1000 Indian Wells CA; U.S.A. ATP World Tour Masters 1000,HARD,2,Paolo Lorenzi,Pablo Carreno Busta,Paolo Lorenzi,3-6; 6-1; 6-2,R128,95,4,2,44,66,35,44,13,22,1,2,12,48,66,1,3,49,74,35,49,8,25,3,7,12,43,74
2014-03-06 00:00:00.000,ATP World Tour Masters 1000 Indian Wells CA; U.S.A. ATP World Tour Masters 1000,HARD,2,Marin Cilic,N/A Bye,Marin Cilic,,R128,0,0,0,0,0,0,0,0,0,0,0,0,0,0,0,0,0,0,0,0,0,0,0,0,0,0,0
2014-03-06 00:00:00.000,ATP World Tour Masters 1000 Indian Wells CA; U.S.A. ATP World Tour Masters 1000,HARD,2,Ivan Dodig,N/A Bye,Ivan Dodig,,R128,0,0,0,0,0,0,0,0,0,0,0,0,0,0,0,0,0,0,0,0,0,0,0,0,0,0,0
2014-03-06 00:00:00.000,ATP World Tour Masters 1000 Indian Wells CA; U.S.A. ATP World Tour Masters 1000,HARD,2,Alejandro Gonzalez,Adrian Mannarino,Alejandro Gonzalez,5-7; 6-4; 7-6(6),R128,163,9,2,82,126,52,82,21,44,7,12,17,73,126,3,5,76,126,52,76,21,50,8,13,17,73,126
2014-03-06 00:00:00.000,ATP World Tour Masters 1000 Indian Wells CA; U.S.A. ATP World Tour Masters 1000,HARD,2,Victor Hanescu,Stephane Robert,Victor Hanescu,7-5; 3-6; 6-4,R128,102,8,2,60,86,45,60,12,26,5,8,15,57,86,5,3,54,98,40,54,24,44,9,13,16,64,98
2014-03-06 00:00:00.000,ATP World Tour Masters 1000 Indian Wells CA; U.S.A. ATP World Tour Masters 1000,HARD,2,Novak Djokovic,N/A Bye,Novak Djokovic,,R128,0,0,0,0,0,0,0,0,0,0,0,0,0,0,0,0,0,0,0,0,0,0,0,0,0,0,0
2014-03-06 00:00:00.000,ATP World Tour Masters 1000 Indian Wells CA; U.S.A. ATP World Tour Masters 1000,HARD,2,Rafael Nadal,Radek Stepanek,Rafael Nadal,2-6; 6-4; 7-5,R64,144,2,8,53,81,44,53,11,28,5,8,15,55,81,12,5,58,102,42,58,20,44,7,10,15,62,102
2014-03-06 00:00:00.000,ATP World Tour Masters 1000 Indian Wells CA; U.S.A. ATP World Tour Masters 1000,HARD,2,Alexandr Dolgopolov,Tim Smyczek,Alexandr Dolgopolov,7-6(3); 6-4,R64,88,9,3,39,78,29,39,19,39,5,7,11,48,78,4,4,56,81,33,56,14,25,2,5,11,47,81
2014-03-06 00:00:00.000,ATP World Tour Masters 1000 Indian Wells CA; U.S.A. ATP World Tour Masters 1000,HARD,2,Gael Monfils,Sergiy Stakhovsky,Gael Monfils,6-2; 6-4,R64,61,8,4,38,53,26,38,7,15,2,4,9,33,53,3,1,32,50,17,32,7,18,3,8,9,24,50
2014-03-06 00:00:00.000,ATP World Tour Masters 1000 Indian Wells CA; U.S.A. ATP World Tour Masters 1000,HARD,2,Fabio Fognini,Ryan Harrison,Fabio Fognini,5-7; 6-1; 6-4,R64,126,7,5,68,101,43,68,19,33,7,10,15,62,101,9,3,53,93,37,53,17,40,6,11,14,54,93
2014-03-06 00:00:00.000,ATP World Tour Masters 1000 Indian Wells CA; U.S.A. ATP World Tour Masters 1000,HARD,2,Milos Raonic,Edouard Roger-Vasselin,Milos Raonic,7-6(4); 4-6; 7-6(2),R64,145,33,5,59,102,53,59,25,43,2,3,17,78,102,3,1,70,106,49,70,28,36,0,0,17,77,106
2014-03-06 00:00:00.000,ATP World Tour Masters 1000 Indian Wells CA; U.S.A. ATP World Tour Masters 1000,HARD,2,Alejandro Falla,Jerzy Janowicz,Alejandro Falla,6-3; 2-6; 7-6(5),R64,123,7,4,54,95,36,54,23,41,5,9,15,59,95,10,8,47,88,36,47,20,41,2,5,14,56,88
2014-03-06 00:00:00.000,ATP World Tour Masters 1000 Indian Wells CA; U.S.A. ATP World Tour Masters 1000,HARD,2,Jiri Vesely,Pablo Andujar,Jiri Vesely,6-1; 2-6; 6-1,R64,106,6,6,37,69,26,37,16,32,5,8,11,42,69,0,4,52,77,31,52,6,25,10,16,11,37,77
2014-03-06 00:00:00.000,ATP World Tour Masters 1000 Indian Wells CA; U.S.A. ATP World Tour Masters 1000,HARD,2,Andy Murray,Lukas Rosol,Andy Murray,4-6; 6-3; 6-2,R64,106,4,1,49,80,35,49,19,31,3,6,14,54,80,5,6,39,80,29,39,16,41,3,8,13,45,80
2014-03-06 00:00:00.000,ATP World Tour Masters 1000 Indian Wells CA; U.S.A. ATP World Tour Masters 1000,HARD,2,Stan Wawrinka,Ivo Karlovic,Stan Wawrinka,6-3; 7-5,R64,64,8,1,32,56,28,32,17,24,0,0,11,45,56,9,1,32,46,26,32,8,14,0,2,10,34,46
2014-03-06 00:00:00.000,ATP World Tour Masters 1000 Indian Wells CA; U.S.A. ATP World Tour Masters 1000,HARD,2,Andreas Seppi,Sam Querrey,Andreas Seppi,4-6; 7-6(3); 6-3,R64,132,3,4,61,107,48,61,25,46,10,12,16,73,107,11,8,50,96,40,50,21,46,3,5,15,61,96
2014-03-06 00:00:00.000,ATP World Tour Masters 1000 Indian Wells CA; U.S.A. ATP World Tour Masters 1000,HARD,2,Kevin Anderson,Lleyton Hewitt,Kevin Anderson,7-6(5); 6-4,R64,110,7,2,46,72,36,46,14,26,1,1,11,50,72,2,2,42,78,31,42,21,36,10,11,11,52,78
2014-03-06 00:00:00.000,ATP World Tour Masters 1000 Indian Wells CA; U.S.A. ATP World Tour Masters 1000,HARD,2,Evgeny Donskoy,Michael Russell,Evgeny Donskoy,6-4; 6-3,R64,84,8,0,41,62,33,41,13,21,6,6,10,46,62,0,2,39,65,22,39,18,26,4,6,9,40,65
2014-03-06 00:00:00.000,ATP World Tour Masters 1000 Indian Wells CA; U.S.A. ATP World Tour Masters 1000,HARD,2,Tommy Haas,Jeremy Chardy,Tommy Haas,6-3; 6-4,R64,78,5,2,40,67,30,40,15,27,2,2,10,45,67,1,1,31,53,20,31,14,22,2,4,9,34,53
2014-03-06 00:00:00.000,ATP World Tour Masters 1000 Indian Wells CA; U.S.A. ATP World Tour Masters 1000,HARD,2,Kei Nishikori,Santiago Giraldo,Kei Nishikori,6-1; 6-3,R64,58,1,0,27,43,21,27,12,16,1,1,8,33,43,1,1,31,54,20,31,7,23,4,8,8,27,54
2014-03-06 00:00:00.000,ATP World Tour Masters 1000 Indian Wells CA; U.S.A. ATP World Tour Masters 1000,HARD,2,Dmitry Tursunov,Juan Monaco,Dmitry Tursunov,7-6(4); 6-4,R64,110,3,4,58,95,36,58,19,37,10,12,11,55,95,2,0,49,73,30,49,12,24,4,7,11,42,73
2014-03-06 00:00:00.000,ATP World Tour Masters 1000 Indian Wells CA; U.S.A. ATP World Tour Masters 1000,HARD,2,Roger Federer,Paul-Henri Mathieu,Roger Federer,6-2; 7-6(5),R64,91,9,1,38,62,32,38,12,24,1,2,10,44,62,1,7,38,72,25,38,17,34,2,5,10,42,72
2014-03-06 00:00:00.000,ATP World Tour Masters 1000 Indian Wells CA; U.S.A. ATP World Tour Masters 1000,HARD,2,Richard Gasquet,Teymuraz Gabashvili,Richard Gasquet,6-0; 2-0 RET,R64,35,1,0,11,20,10,11,7,9,1,1,4,17,20,0,0,16,26,6,16,2,10,3,7,4,8,26
2014-03-06 00:00:00.000,ATP World Tour Masters 1000 Indian Wells CA; U.S.A. ATP World Tour Masters 1000,HARD,2,Fernando Verdasco,Horacio Zeballos,Fernando Verdasco,7-5; 7-5,R64,101,2,5,41,73,30,41,15,32,1,4,12,45,73,0,6,35,74,20,35,19,39,4,9,12,39,74
2014-03-06 00:00:00.000,ATP World Tour Masters 1000 Indian Wells CA; U.S.A. ATP World Tour Masters 1000,HARD,2,Yen-Hsun Lu,Philipp Kohlschreiber,Yen-Hsun Lu,6-2; 6-2,R64,68,6,0,37,49,31,37,5,12,3,3,8,36,49,3,1,30,58,21,30,9,28,4,8,8,30,58
2014-03-06 00:00:00.000,ATP World Tour Masters 1000 Indian Wells CA; U.S.A. ATP World Tour Masters 1000,HARD,2,John Isner,Nikolay Davydenko,John Isner,7-6(5); 6-3,R64,81,15,2,37,57,35,37,14,20,0,0,11,49,57,3,3,42,67,29,42,16,25,7,8,10,45,67
2014-03-06 00:00:00.000,ATP World Tour Masters 1000 Indian Wells CA; U.S.A. ATP World Tour Masters 1000,HARD,2,Grigor Dimitrov,Robin Haase,Grigor Dimitrov,6-4; 6-3,R64,71,9,2,23,47,20,23,16,24,0,1,10,36,47,2,5,42,67,27,42,10,25,4,7,9,37,67
2014-03-06 00:00:00.000,ATP World Tour Masters 1000 Indian Wells CA; U.S.A. ATP World Tour Masters 1000,HARD,2,Ernests Gulbis,Joao Sousa,Ernests Gulbis,6-3; 6-3,R64,65,10,3,25,42,25,25,11,17,0,0,9,36,42,1,2,30,59,23,30,12,29,5,8,9,35,59
2014-03-06 00:00:00.000,ATP World Tour Masters 1000 Indian Wells CA; U.S.A. ATP World Tour Masters 1000,HARD,2,Jarkko Nieminen,Florian Mayer,Jarkko Nieminen,6-2; 1-0 RET,R64,36,0,2,17,31,12,17,6,14,0,1,5,18,31,1,3,13,23,7,13,2,10,1,4,4,9,23
2014-03-06 00:00:00.000,ATP World Tour Masters 1000 Indian Wells CA; U.S.A. ATP World Tour Masters 1000,HARD,2,Roberto Bautista Agut,Tomas Berdych,Roberto Bautista Agut,4-6; 6-2; 6-4,R64,143,2,4,70,107,47,70,17,37,12,15,14,64,107,6,2,48,91,34,48,17,43,9,14,14,51,91
2014-03-06 00:00:00.000,ATP World Tour Masters 1000 Indian Wells CA; U.S.A. ATP World Tour Masters 1000,HARD,2,Feliciano Lopez,James Ward,Feliciano Lopez,3-6; 6-2; 6-4,R64,122,9,5,56,96,41,56,21,40,9,10,13,62,96,9,1,52,85,40,52,13,33,5,8,14,53,85
2014-03-06 00:00:00.000,ATP World Tour Masters 1000 Indian Wells CA; U.S.A. ATP World Tour Masters 1000,HARD,2,Mikhail Kukushkin,Vasek Pospisil,Mikhail Kukushkin,6-0; 6-2,R64,65,2,0,22,43,17,22,16,21,4,4,7,33,43,2,1,28,50,15,28,6,22,5,10,7,21,50
2014-03-06 00:00:00.000,ATP World Tour Masters 1000 Indian Wells CA; U.S.A. ATP World Tour Masters 1000,HARD,2,Dominic Thiem,Gilles Simon,Dominic Thiem,7-6(5); 6-2,R64,99,7,4,31,62,26,31,18,31,2,3,10,44,62,5,4,40,80,28,40,18,40,7,10,10,46,80
2014-03-06 00:00:00.000,ATP World Tour Masters 1000 Indian Wells CA; U.S.A. ATP World Tour Masters 1000,HARD,2,Julien Benneteau,Jo-Wilfried Tsonga,Julien Benneteau,6-4; 6-4,R64,85,2,4,35,62,28,35,12,27,1,3,10,40,62,7,2,34,64,22,34,14,30,8,12,10,36,64
2014-03-06 00:00:00.000,ATP World Tour Masters 1000 Indian Wells CA; U.S.A. ATP World Tour Masters 1000,HARD,2,Tommy Robredo,Marinko Matosevic,Tommy Robredo,7-6(6); 5-7; 6-4,R64,153,9,3,66,114,52,66,24,48,4,6,17,76,114,8,4,62,108,49,62,24,46,4,6,17,73,108
2014-03-06 00:00:00.000,ATP World Tour Masters 1000 Indian Wells CA; U.S.A. ATP World Tour Masters 1000,HARD,2,Marin Cilic,Paolo Lorenzi,Marin Cilic,6-2; 6-2,R64,71,6,1,24,44,18,24,13,20,0,1,8,31,44,2,2,30,52,17,30,6,22,8,13,8,23,52
2014-03-06 00:00:00.000,ATP World Tour Masters 1000 Indian Wells CA; U.S.A. ATP World Tour Masters 1000,HARD,2,Alejandro Gonzalez,Ivan Dodig,Alejandro Gonzalez,6-4; 2-6; 7-6(5),R64,138,3,4,54,102,35,54,25,48,3,7,15,60,102,13,8,48,95,37,48,24,47,4,7,15,61,95
2014-03-06 00:00:00.000,ATP World Tour Masters 1000 Indian Wells CA; U.S.A. ATP World Tour Masters 1000,HARD,2,Novak Djokovic,Victor Hanescu,Novak Djokovic,7-6(1); 6-2,R64,84,5,0,53,68,43,53,6,15,5,5,10,49,68,1,1,45,65,29,45,12,20,3,5,10,41,65
2014-03-06 00:00:00.000,ATP World Tour Masters 1000 Indian Wells CA; U.S.A. ATP World Tour Masters 1000,HARD,2,Alexandr Dolgopolov,Rafael Nadal,Alexandr Dolgopolov,6-3; 3-6; 7-6(5),R32,139,11,3,39,96,30,39,27,57,2,6,15,57,96,2,1,55,87,39,55,17,32,1,5,15,56,87
2014-03-06 00:00:00.000,ATP World Tour Masters 1000 Indian Wells CA; U.S.A. ATP World Tour Masters 1000,HARD,2,Fabio Fognini,Gael Monfils,Fabio Fognini,6-2; 3-6; 7-5,R32,110,1,3,39,81,26,39,21,42,6,11,14,47,81,8,10,51,100,32,51,18,49,6,13,15,50,100
2014-03-06 00:00:00.000,ATP World Tour Masters 1000 Indian Wells CA; U.S.A. ATP World Tour Masters 1000,HARD,2,Milos Raonic,Alejandro Falla,Milos Raonic,6-4; 6-3,R32,80,11,1,36,54,30,36,13,18,2,2,10,43,54,1,1,41,63,25,41,12,22,2,4,9,37,63
2014-03-06 00:00:00.000,ATP World Tour Masters 1000 Indian Wells CA; U.S.A. ATP World Tour Masters 1000,HARD,2,Andy Murray,Jiri Vesely,Andy Murray,6-7(2); 6-4; 6-4,R32,168,7,5,60,102,37,60,19,42,6,12,16,56,102,4,11,58,116,39,58,22,58,12,20,16,61,116
2014-03-06 00:00:00.000,ATP World Tour Masters 1000 Indian Wells CA; U.S.A. ATP World Tour Masters 1000,HARD,2,Stan Wawrinka,Andreas Seppi,Stan Wawrinka,6-0; 6-2,R32,49,7,3,22,38,19,22,10,16,0,0,7,29,38,0,3,25,47,11,25,8,22,9,14,7,19,47
2014-03-06 00:00:00.000,ATP World Tour Masters 1000 Indian Wells CA; U.S.A. ATP World Tour Masters 1000,HARD,2,Kevin Anderson,Evgeny Donskoy,Kevin Anderson,4-6; 6-0; 6-3,R32,108,14,4,61,95,43,61,17,34,12,14,13,60,95,1,2,41,70,24,41,14,29,4,9,12,38,70
2014-03-06 00:00:00.000,ATP World Tour Masters 1000 Indian Wells CA; U.S.A. ATP World Tour Masters 1000,HARD,2,Tommy Haas,Kei Nishikori,Tommy Haas,7-6(3); 6-2,R32,91,1,5,36,64,23,36,16,28,1,3,10,39,64,2,2,30,61,21,30,11,31,1,5,10,32,61
2014-03-06 00:00:00.000,ATP World Tour Masters 1000 Indian Wells CA; U.S.A. ATP World Tour Masters 1000,HARD,2,Roger Federer,Dmitry Tursunov,Roger Federer,7-6(7); 7-6(2),R32,106,9,1,53,78,38,53,17,25,1,3,12,55,78,7,6,37,80,27,37,23,43,1,3,12,50,80
2014-03-06 00:00:00.000,ATP World Tour Masters 1000 Indian Wells CA; U.S.A. ATP World Tour Masters 1000,HARD,2,Fernando Verdasco,Richard Gasquet,Fernando Verdasco,7-6(5); 6-1,R32,98,5,1,57,73,41,57,9,16,8,8,10,50,73,2,3,51,79,32,51,14,28,8,10,9,46,79
2014-03-06 00:00:00.000,ATP World Tour Masters 1000 Indian Wells CA; U.S.A. ATP World Tour Masters 1000,HARD,2,John Isner,Yen-Hsun Lu,John Isner,6-4; 6-3,R32,67,13,0,36,55,30,36,12,19,0,0,10,42,55,0,2,36,51,25,36,8,15,3,5,9,33,51
2014-03-06 00:00:00.000,ATP World Tour Masters 1000 Indian Wells CA; U.S.A. ATP World Tour Masters 1000,HARD,2,Ernests Gulbis,Grigor Dimitrov,Ernests Gulbis,2-6; 6-1; 7-5,R32,115,10,6,54,85,41,54,16,31,2,4,14,57,85,5,3,54,81,36,54,13,27,4,7,13,49,81
2014-03-06 00:00:00.000,ATP World Tour Masters 1000 Indian Wells CA; U.S.A. ATP World Tour Masters 1000,HARD,2,Roberto Bautista Agut,Jarkko Nieminen,Roberto Bautista Agut,6-2; 4-6; 7-6(6),R32,130,5,3,64,100,44,64,20,36,4,7,15,64,100,7,0,64,92,41,64,16,28,3,7,15,57,92
2014-03-06 00:00:00.000,ATP World Tour Masters 1000 Indian Wells CA; U.S.A. ATP World Tour Masters 1000,HARD,2,Feliciano Lopez,Mikhail Kukushkin,Feliciano Lopez,1-6; 6-3; 6-4,R32,104,10,6,54,94,40,54,20,40,8,10,13,60,94,4,0,37,67,29,37,18,30,1,3,13,47,67
2014-03-06 00:00:00.000,ATP World Tour Masters 1000 Indian Wells CA; U.S.A. ATP World Tour Masters 1000,HARD,2,Julien Benneteau,Dominic Thiem,Julien Benneteau,7-6(4); 6-3,R32,106,8,4,44,72,32,44,12,28,1,4,10,44,72,2,5,40,74,22,40,17,34,4,9,11,39,74
2014-03-06 00:00:00.000,ATP World Tour Masters 1000 Indian Wells CA; U.S.A. ATP World Tour Masters 1000,HARD,2,Marin Cilic,Tommy Robredo,Marin Cilic,6-4; 6-3,R32,83,6,2,30,63,21,30,25,33,2,2,10,46,63,2,1,38,62,27,38,9,24,4,6,9,36,62
2014-03-06 00:00:00.000,ATP World Tour Masters 1000 Indian Wells CA; U.S.A. ATP World Tour Masters 1000,HARD,2,Novak Djokovic,Alejandro Gonzalez,Novak Djokovic,6-1; 3-6; 6-1,R32,97,7,2,50,64,39,50,9,14,0,1,12,48,64,3,4,50,90,33,50,17,40,8,12,11,50,90
2014-03-06 00:00:00.000,ATP World Tour Masters 1000 Indian Wells CA; U.S.A. ATP World Tour Masters 1000,HARD,2,Alexandr Dolgopolov,Fabio Fognini,Alexandr Dolgopolov,6-2; 6-4,R16,76,6,1,28,56,23,28,17,28,3,3,9,40,56,4,6,36,65,26,36,11,29,3,6,9,37,65
2014-03-06 00:00:00.000,ATP World Tour Masters 1000 Indian Wells CA; U.S.A. ATP World Tour Masters 1000,HARD,2,Milos Raonic,Andy Murray,Milos Raonic,4-6; 7-5; 6-3,R16,130,15,3,53,80,44,53,14,27,0,2,16,58,80,4,3,60,90,43,60,13,30,4,7,15,56,90
2014-03-06 00:00:00.000,ATP World Tour Masters 1000 Indian Wells CA; U.S.A. ATP World Tour Masters 1000,HARD,2,Kevin Anderson,Stan Wawrinka,Kevin Anderson,7-6(1); 4-6; 6-1,R16,140,12,8,67,105,48,67,16,38,10,13,14,64,105,5,2,38,89,28,38,23,51,5,10,15,51,89
2014-03-06 00:00:00.000,ATP World Tour Masters 1000 Indian Wells CA; U.S.A. ATP World Tour Masters 1000,HARD,2,Roger Federer,Tommy Haas,Roger Federer,6-4; 6-4,R16,84,7,1,40,62,33,40,10,22,4,5,10,43,62,3,3,45,69,31,45,10,24,8,11,10,41,69
2014-03-06 00:00:00.000,ATP World Tour Masters 1000 Indian Wells CA; U.S.A. ATP World Tour Masters 1000,HARD,2,John Isner,Fernando Verdasco,John Isner,7-6(3); 3-6; 6-3,R16,112,10,0,62,88,46,62,19,26,0,1,15,65,88,4,3,57,85,44,57,16,28,2,3,15,60,85
2014-03-06 00:00:00.000,ATP World Tour Masters 1000 Indian Wells CA; U.S.A. ATP World Tour Masters 1000,HARD,2,Ernests Gulbis,Roberto Bautista Agut,Ernests Gulbis,7-6(0); 4-6; 6-2,R16,145,7,6,52,99,39,52,23,47,4,7,15,62,99,1,4,63,108,43,63,17,45,8,12,15,60,108
2014-03-06 00:00:00.000,ATP World Tour Masters 1000 Indian Wells CA; U.S.A. ATP World Tour Masters 1000,HARD,2,Julien Benneteau,Feliciano Lopez,Julien Benneteau,6-3; 7-6(4),R16,92,13,2,40,62,35,40,15,22,1,1,11,50,62,8,3,47,80,36,47,14,33,4,5,10,50,80
2014-03-06 00:00:00.000,ATP World Tour Masters 1000 Indian Wells CA; U.S.A. ATP World Tour Masters 1000,HARD,2,Novak Djokovic,Marin Cilic,Novak Djokovic,1-6; 6-2; 6-3,R16,105,2,3,40,72,29,40,18,32,2,4,12,47,72,13,2,41,70,32,41,13,29,4,7,12,45,70
2014-03-06 00:00:00.000,ATP World Tour Masters 1000 Indian Wells CA; U.S.A. ATP World Tour Masters 1000,HARD,2,Alexandr Dolgopolov,Milos Raonic,Alexandr Dolgopolov,6-3; 6-4,Q,79,6,5,29,54,26,29,13,25,0,1,10,39,54,4,3,38,62,27,38,11,24,6,9,9,38,62
2014-03-06 00:00:00.000,ATP World Tour Masters 1000 Indian Wells CA; U.S.A. ATP World Tour Masters 1000,HARD,2,Roger Federer,Kevin Anderson,Roger Federer,7-5; 6-1,Q,69,3,0,33,51,26,33,16,18,1,1,10,42,51,3,1,32,54,23,32,7,22,4,7,9,30,54
2014-03-06 00:00:00.000,ATP World Tour Masters 1000 Indian Wells CA; U.S.A. ATP World Tour Masters 1000,HARD,2,John Isner,Ernests Gulbis,John Isner,7-6(4); 7-6(3),Q,109,13,3,59,80,48,59,9,21,3,4,12,57,80,7,7,49,90,37,49,22,41,5,6,12,59,90
2014-03-06 00:00:00.000,ATP World Tour Masters 1000 Indian Wells CA; U.S.A. ATP World Tour Masters 1000,HARD,2,Novak Djokovic,Julien Benneteau,Novak Djokovic,6-1; 6-3,Q,69,7,3,27,41,25,27,8,14,0,0,8,33,41,2,2,34,64,22,34,9,30,11,15,8,31,64
2014-03-06 00:00:00.000,ATP World Tour Masters 1000 Indian Wells CA; U.S.A. ATP World Tour Masters 1000,HARD,2,Roger Federer,Alexandr Dolgopolov,Roger Federer,6-3; 6-1,S,62,7,1,31,43,23,31,10,12,0,0,8,33,43,2,3,24,61,16,24,14,37,5,9,8,30,61
2014-03-06 00:00:00.000,ATP World Tour Masters 1000 Indian Wells CA; U.S.A. ATP World Tour Masters 1000,HARD,2,Novak Djokovic,John Isner,Novak Djokovic,7-5; 6-7(2); 6-1,S,144,7,2,63,92,47,63,15,29,4,6,16,62,92,8,2,78,114,49,78,16,36,7,12,15,65,114
2014-03-06 00:00:00.000,ATP World Tour Masters 1000 Indian Wells CA; U.S.A. ATP World Tour Masters 1000,HARD,2,Novak Djokovic,Roger Federer,Novak Djokovic,3-6; 6-3; 7-6(3),F,132,6,5,62,96,47,62,17,34,1,3,15,64,96,6,4,64,101,45,64,21,37,4,6,15,66,101
2014-03-19 00:00:00.000,ATP World Tour Masters 1000 Miami FL; U.S.A. ATP World Tour Masters 1000,HARD,2,Rafael Nadal,N/A Bye,Rafael Nadal,,R128,0,0,0,0,0,0,0,0,0,0,0,0,0,0,0,0,0,0,0,0,0,0,0,0,0,0,0
2014-03-19 00:00:00.000,ATP World Tour Masters 1000 Miami FL; U.S.A. ATP World Tour Masters 1000,HARD,2,Lleyton Hewitt,Robin Haase,Lleyton Hewitt,3-6; 6-3; 6-3,R128,117,3,2,40,71,30,40,18,31,3,5,13,48,71,7,5,55,102,36,55,23,47,4,8,14,59,102
2014-03-19 00:00:00.000,ATP World Tour Masters 1000 Miami FL; U.S.A. ATP World Tour Masters 1000,HARD,2,Denis Istomin,Nicolas Mahut,Denis Istomin,7-6(8); 7-6(2),R128,116,9,1,58,85,48,58,12,27,1,2,12,60,85,3,2,56,82,39,56,14,26,0,1,12,53,82
2014-03-19 00:00:00.000,ATP World Tour Masters 1000 Miami FL; U.S.A. ATP World Tour Masters 1000,HARD,2,Dmitry Tursunov,N/A Bye,Dmitry Tursunov,,R128,0,0,0,0,0,0,0,0,0,0,0,0,0,0,0,0,0,0,0,0,0,0,0,0,0,0,0
2014-03-19 00:00:00.000,ATP World Tour Masters 1000 Miami FL; U.S.A. ATP World Tour Masters 1000,HARD,2,Jerzy Janowicz,N/A Bye,Jerzy Janowicz,,R128,0,0,0,0,0,0,0,0,0,0,0,0,0,0,0,0,0,0,0,0,0,0,0,0,0,0,0
2014-03-19 00:00:00.000,ATP World Tour Masters 1000 Miami FL; U.S.A. ATP World Tour Masters 1000,HARD,2,Roberto Bautista Agut,Steve Johnson,Roberto Bautista Agut,4-6; 6-3; 6-1,R128,113,2,5,51,70,41,51,11,19,1,2,13,52,70,17,2,65,101,41,65,15,36,9,13,13,56,101
2014-03-19 00:00:00.000,ATP World Tour Masters 1000 Miami FL; U.S.A. ATP World Tour Masters 1000,HARD,2,Lukas Lacko,Kenny De Schepper,Lukas Lacko,6-4; 6-4,R128,69,10,0,26,57,23,26,21,31,3,3,10,44,57,10,5,38,62,28,38,13,24,4,6,10,41,62
2014-03-19 00:00:00.000,ATP World Tour Masters 1000 Miami FL; U.S.A. ATP World Tour Masters 1000,HARD,2,Fabio Fognini,N/A Bye,Fabio Fognini,,R128,0,0,0,0,0,0,0,0,0,0,0,0,0,0,0,0,0,0,0,0,0,0,0,0,0,0,0
2014-03-19 00:00:00.000,ATP World Tour Masters 1000 Miami FL; U.S.A. ATP World Tour Masters 1000,HARD,2,Milos Raonic,N/A Bye,Milos Raonic,,R128,0,0,0,0,0,0,0,0,0,0,0,0,0,0,0,0,0,0,0,0,0,0,0,0,0,0,0
2014-03-19 00:00:00.000,ATP World Tour Masters 1000 Miami FL; U.S.A. ATP World Tour Masters 1000,HARD,2,Jack Sock,Guido Pella,Jack Sock,6-3; 6-4,R128,64,8,3,31,60,25,31,18,29,0,0,10,43,60,8,1,26,45,19,26,12,19,1,3,9,31,45
2014-03-19 00:00:00.000,ATP World Tour Masters 1000 Miami FL; U.S.A. ATP World Tour Masters 1000,HARD,2,Guillermo Garcia-Lopez,Bradley Klahn,Guillermo Garcia-Lopez,1-6; 6-1; 6-4,R128,83,7,2,35,60,28,35,18,25,4,6,12,46,60,6,3,35,68,24,35,19,33,2,5,12,43,68
2014-03-19 00:00:00.000,ATP World Tour Masters 1000 Miami FL; U.S.A. ATP World Tour Masters 1000,HARD,2,Gael Monfils,N/A Bye,Gael Monfils,,R128,0,0,0,0,0,0,0,0,0,0,0,0,0,0,0,0,0,0,0,0,0,0,0,0,0,0,0
2014-03-19 00:00:00.000,ATP World Tour Masters 1000 Miami FL; U.S.A. ATP World Tour Masters 1000,HARD,2,Vasek Pospisil,N/A Bye,Vasek Pospisil,,R128,0,0,0,0,0,0,0,0,0,0,0,0,0,0,0,0,0,0,0,0,0,0,0,0,0,0,0
2014-03-19 00:00:00.000,ATP World Tour Masters 1000 Miami FL; U.S.A. ATP World Tour Masters 1000,HARD,2,Aljaz Bedene,Jimmy Wang,Aljaz Bedene,1-6; 6-2; 6-4,R128,113,18,5,42,81,35,42,15,39,8,11,12,50,81,3,2,50,87,32,50,17,37,1,5,13,49,87
2014-03-19 00:00:00.000,ATP World Tour Masters 1000 Miami FL; U.S.A. ATP World Tour Masters 1000,HARD,2,Ryan Harrison,Federico Delbonis,Ryan Harrison,6-2; 6-4,R128,75,4,1,28,52,19,28,16,24,2,3,9,35,52,2,3,39,59,19,39,12,20,7,11,9,31,59
2014-03-19 00:00:00.000,ATP World Tour Masters 1000 Miami FL; U.S.A. ATP World Tour Masters 1000,HARD,2,Benjamin Becker,N/A Bye,Benjamin Becker,,R128,0,0,0,0,0,0,0,0,0,0,0,0,0,0,0,0,0,0,0,0,0,0,0,0,0,0,0
2014-03-19 00:00:00.000,ATP World Tour Masters 1000 Miami FL; U.S.A. ATP World Tour Masters 1000,HARD,2,Stan Wawrinka,N/A Bye,Stan Wawrinka,,R128,0,0,0,0,0,0,0,0,0,0,0,0,0,0,0,0,0,0,0,0,0,0,0,0,0,0,0
2014-03-19 00:00:00.000,ATP World Tour Masters 1000 Miami FL; U.S.A. ATP World Tour Masters 1000,HARD,2,Daniel Gimeno-Traver,Karen Khachanov,Daniel Gimeno-Traver,6-7(8); 6-1; 6-1,R128,108,6,2,43,79,36,43,22,36,1,2,13,58,79,5,4,52,94,33,52,18,42,6,12,13,51,94
2014-03-19 00:00:00.000,ATP World Tour Masters 1000 Miami FL; U.S.A. ATP World Tour Masters 1000,HARD,2,Edouard Roger-Vasselin,Igor Sijsling,Edouard Roger-Vasselin,3-6; 6-3; 7-6(3),R128,121,6,2,62,94,48,62,19,32,3,4,15,67,94,10,1,56,99,46,56,22,43,8,9,15,68,99
2014-03-19 00:00:00.000,ATP World Tour Masters 1000 Miami FL; U.S.A. ATP World Tour Masters 1000,HARD,2,Marin Cilic,N/A Bye,Marin Cilic,,R128,0,0,0,0,0,0,0,0,0,0,0,0,0,0,0,0,0,0,0,0,0,0,0,0,0,0,0
2014-03-19 00:00:00.000,ATP World Tour Masters 1000 Miami FL; U.S.A. ATP World Tour Masters 1000,HARD,2,Alexandr Dolgopolov,N/A Bye,Alexandr Dolgopolov,,R128,0,0,0,0,0,0,0,0,0,0,0,0,0,0,0,0,0,0,0,0,0,0,0,0,0,0,0
2014-03-19 00:00:00.000,ATP World Tour Masters 1000 Miami FL; U.S.A. ATP World Tour Masters 1000,HARD,2,Jarkko Nieminen,Bernard Tomic,Jarkko Nieminen,6-0; 6-1,R128,28,2,0,28,34,24,28,4,6,0,0,7,28,34,2,1,17,27,6,17,1,10,0,5,6,7,27
2014-03-19 00:00:00.000,ATP World Tour Masters 1000 Miami FL; U.S.A. ATP World Tour Masters 1000,HARD,2,Yen-Hsun Lu,Mikhail Kukushkin,Yen-Hsun Lu,6-1; 3-1 RET,R128,40,2,1,19,29,16,19,8,10,0,0,6,24,29,2,3,30,40,14,30,5,10,1,4,5,19,40
2014-03-19 00:00:00.000,ATP World Tour Masters 1000 Miami FL; U.S.A. ATP World Tour Masters 1000,HARD,2,Dusan Lajovic,N/A Bye,Dusan Lajovic,,R128,0,0,0,0,0,0,0,0,0,0,0,0,0,0,0,0,0,0,0,0,0,0,0,0,0,0,0
2014-03-19 00:00:00.000,ATP World Tour Masters 1000 Miami FL; U.S.A. ATP World Tour Masters 1000,HARD,2,John Isner,N/A Bye,John Isner,,R128,0,0,0,0,0,0,0,0,0,0,0,0,0,0,0,0,0,0,0,0,0,0,0,0,0,0,0
2014-03-19 00:00:00.000,ATP World Tour Masters 1000 Miami FL; U.S.A. ATP World Tour Masters 1000,HARD,2,Donald Young,Carlos Berlocq,Donald Young,6-2; 6-2,R128,68,3,3,28,51,20,28,13,23,4,5,8,33,51,1,3,33,54,17,33,7,21,2,7,8,24,54
2014-03-19 00:00:00.000,ATP World Tour Masters 1000 Miami FL; U.S.A. ATP World Tour Masters 1000,HARD,2,Sam Querrey,Sergiy Stakhovsky,Sam Querrey,7-6(2); 6-3,R128,75,6,2,33,60,29,33,17,27,1,1,10,46,60,4,3,44,72,31,44,15,28,8,10,11,46,72
2014-03-19 00:00:00.000,ATP World Tour Masters 1000 Miami FL; U.S.A. ATP World Tour Masters 1000,HARD,2,Nicolas Almagro,N/A Bye,Nicolas Almagro,,R128,0,0,0,0,0,0,0,0,0,0,0,0,0,0,0,0,0,0,0,0,0,0,0,0,0,0,0
2014-03-19 00:00:00.000,ATP World Tour Masters 1000 Miami FL; U.S.A. ATP World Tour Masters 1000,HARD,2,Gilles Simon,N/A Bye,Gilles Simon,,R128,0,0,0,0,0,0,0,0,0,0,0,0,0,0,0,0,0,0,0,0,0,0,0,0,0,0,0
2014-03-19 00:00:00.000,ATP World Tour Masters 1000 Miami FL; U.S.A. ATP World Tour Masters 1000,HARD,2,Joao Sousa,Pablo Carreno Busta,Joao Sousa,6-4; 7-6(3),R128,109,3,0,64,87,42,64,12,23,9,11,11,54,87,6,0,44,74,29,44,16,30,6,9,11,45,74
2014-03-19 00:00:00.000,ATP World Tour Masters 1000 Miami FL; U.S.A. ATP World Tour Masters 1000,HARD,2,Stephane Robert,Alex Bogomolov Jr.,Stephane Robert,7-5; 6-4,R128,91,8,4,29,61,24,29,18,32,3,5,11,42,61,2,0,46,86,26,46,22,40,7,11,11,48,86
2014-03-19 00:00:00.000,ATP World Tour Masters 1000 Miami FL; U.S.A. ATP World Tour Masters 1000,HARD,2,Tomas Berdych,N/A Bye,Tomas Berdych,,R128,0,0,0,0,0,0,0,0,0,0,0,0,0,0,0,0,0,0,0,0,0,0,0,0,0,0,0
2014-03-19 00:00:00.000,ATP World Tour Masters 1000 Miami FL; U.S.A. ATP World Tour Masters 1000,HARD,2,Roger Federer,N/A Bye,Roger Federer,,R128,0,0,0,0,0,0,0,0,0,0,0,0,0,0,0,0,0,0,0,0,0,0,0,0,0,0,0
2014-03-19 00:00:00.000,ATP World Tour Masters 1000 Miami FL; U.S.A. ATP World Tour Masters 1000,HARD,2,Ivo Karlovic,Paul-Henri Mathieu,Ivo Karlovic,7-6(3); 7-6(5),R128,100,21,1,45,72,36,45,22,27,0,0,12,58,72,3,1,50,80,39,50,17,30,0,0,12,56,80
2014-03-19 00:00:00.000,ATP World Tour Masters 1000 Miami FL; U.S.A. ATP World Tour Masters 1000,HARD,2,Thiemo de Bakker,Victor Hanescu,Thiemo de Bakker,6-3; 6-2,R128,64,4,1,27,48,23,27,14,21,2,2,9,37,48,1,1,39,58,23,39,9,19,3,6,8,32,58
2014-03-19 00:00:00.000,ATP World Tour Masters 1000 Miami FL; U.S.A. ATP World Tour Masters 1000,HARD,2,Fernando Verdasco,N/A Bye,Fernando Verdasco,,R128,0,0,0,0,0,0,0,0,0,0,0,0,0,0,0,0,0,0,0,0,0,0,0,0,0,0,0
2014-03-19 00:00:00.000,ATP World Tour Masters 1000 Miami FL; U.S.A. ATP World Tour Masters 1000,HARD,2,Kevin Anderson,N/A Bye,Kevin Anderson,,R128,0,0,0,0,0,0,0,0,0,0,0,0,0,0,0,0,0,0,0,0,0,0,0,0,0,0,0
2014-03-19 00:00:00.000,ATP World Tour Masters 1000 Miami FL; U.S.A. ATP World Tour Masters 1000,HARD,2,Horacio Zeballos,David Goffin,Horacio Zeballos,7-5; 6-3,R128,77,3,2,32,65,25,32,18,33,3,5,11,43,65,6,2,28,49,19,28,10,21,2,6,10,29,49
2014-03-19 00:00:00.000,ATP World Tour Masters 1000 Miami FL; U.S.A. ATP World Tour Masters 1000,HARD,2,Alejandro Gonzalez,Malek Jaziri,Alejandro Gonzalez,7-6(9); 6-1,R128,87,2,3,34,65,27,34,20,31,6,6,9,47,65,4,3,37,65,25,37,15,28,3,6,10,40,65
2014-03-19 00:00:00.000,ATP World Tour Masters 1000 Miami FL; U.S.A. ATP World Tour Masters 1000,HARD,2,Richard Gasquet,N/A Bye,Richard Gasquet,,R128,0,0,0,0,0,0,0,0,0,0,0,0,0,0,0,0,0,0,0,0,0,0,0,0,0,0,0
2014-03-19 00:00:00.000,ATP World Tour Masters 1000 Miami FL; U.S.A. ATP World Tour Masters 1000,HARD,2,Grigor Dimitrov,N/A Bye,Grigor Dimitrov,,R128,0,0,0,0,0,0,0,0,0,0,0,0,0,0,0,0,0,0,0,0,0,0,0,0,0,0,0
2014-03-19 00:00:00.000,ATP World Tour Masters 1000 Miami FL; U.S.A. ATP World Tour Masters 1000,HARD,2,Albert Montanes,Michal Przysiezny,Albert Montanes,5-7; 7-6(5); 6-3,R128,121,5,3,58,100,47,58,23,42,2,4,17,70,100,12,7,62,104,44,62,27,42,7,9,16,71,104
2014-03-19 00:00:00.000,ATP World Tour Masters 1000 Miami FL; U.S.A. ATP World Tour Masters 1000,HARD,2,Marinko Matosevic,Alejandro Falla,Marinko Matosevic,1-6; 6-4; 7-6(6),R128,145,2,4,60,109,39,60,23,49,5,10,15,62,109,7,5,58,122,40,58,30,64,13,16,14,70,122
2014-03-19 00:00:00.000,ATP World Tour Masters 1000 Miami FL; U.S.A. ATP World Tour Masters 1000,HARD,2,Kei Nishikori,N/A Bye,Kei Nishikori,,R128,0,0,0,0,0,0,0,0,0,0,0,0,0,0,0,0,0,0,0,0,0,0,0,0,0,0,0
2014-03-19 00:00:00.000,ATP World Tour Masters 1000 Miami FL; U.S.A. ATP World Tour Masters 1000,HARD,2,Andreas Seppi,N/A Bye,Andreas Seppi,,R128,0,0,0,0,0,0,0,0,0,0,0,0,0,0,0,0,0,0,0,0,0,0,0,0,0,0,0
2014-03-19 00:00:00.000,ATP World Tour Masters 1000 Miami FL; U.S.A. ATP World Tour Masters 1000,HARD,2,Radek Stepanek,Daniel Brands,Radek Stepanek,6-3; 6-0,R128,58,7,0,25,37,21,25,8,12,3,3,7,29,37,4,3,33,51,19,33,3,18,6,11,8,22,51
2014-03-19 00:00:00.000,ATP World Tour Masters 1000 Miami FL; U.S.A. ATP World Tour Masters 1000,HARD,2,Teymuraz Gabashvili,Marcel Granollers,Teymuraz Gabashvili,6-4; 6-3,R128,77,5,2,23,52,20,23,17,29,0,0,9,37,52,9,3,34,62,25,34,11,28,5,8,10,36,62
2014-03-19 00:00:00.000,ATP World Tour Masters 1000 Miami FL; U.S.A. ATP World Tour Masters 1000,HARD,2,David Ferrer,N/A Bye,David Ferrer,,R128,0,0,0,0,0,0,0,0,0,0,0,0,0,0,0,0,0,0,0,0,0,0,0,0,0,0,0
2014-03-19 00:00:00.000,ATP World Tour Masters 1000 Miami FL; U.S.A. ATP World Tour Masters 1000,HARD,2,Andy Murray,N/A Bye,Andy Murray,,R128,0,0,0,0,0,0,0,0,0,0,0,0,0,0,0,0,0,0,0,0,0,0,0,0,0,0,0
2014-03-19 00:00:00.000,ATP World Tour Masters 1000 Miami FL; U.S.A. ATP World Tour Masters 1000,HARD,2,Matthew Ebden,Lukasz Kubot,Matthew Ebden,4-6; 6-4; 6-4,R128,115,6,8,56,88,44,56,16,32,4,6,15,60,88,8,9,45,84,35,45,21,39,4,7,15,56,84
2014-03-19 00:00:00.000,ATP World Tour Masters 1000 Miami FL; U.S.A. ATP World Tour Masters 1000,HARD,2,Jiri Vesely,Filippo Volandri,Jiri Vesely,6-4; 7-6(1),R128,88,8,3,54,76,41,54,12,22,4,5,11,53,76,1,3,43,72,32,43,14,29,8,10,11,46,72
2014-03-19 00:00:00.000,ATP World Tour Masters 1000 Miami FL; U.S.A. ATP World Tour Masters 1000,HARD,2,Feliciano Lopez,N/A Bye,Feliciano Lopez,,R128,0,0,0,0,0,0,0,0,0,0,0,0,0,0,0,0,0,0,0,0,0,0,0,0,0,0,0
2014-03-19 00:00:00.000,ATP World Tour Masters 1000 Miami FL; U.S.A. ATP World Tour Masters 1000,HARD,2,Philipp Kohlschreiber,N/A Bye,Philipp Kohlschreiber,,R128,0,0,0,0,0,0,0,0,0,0,0,0,0,0,0,0,0,0,0,0,0,0,0,0,0,0,0
2014-03-19 00:00:00.000,ATP World Tour Masters 1000 Miami FL; U.S.A. ATP World Tour Masters 1000,HARD,2,Marcos Baghdatis,Santiago Giraldo,Marcos Baghdatis,1-6; 6-2; 7-5,R128,111,5,4,40,75,25,40,21,35,3,7,13,46,75,4,3,48,91,33,48,18,43,9,14,14,51,91
2014-03-19 00:00:00.000,ATP World Tour Masters 1000 Miami FL; U.S.A. ATP World Tour Masters 1000,HARD,2,Adrian Mannarino,Nikolay Davydenko,Adrian Mannarino,6-4; 7-5,R128,84,3,1,44,61,35,44,6,17,2,4,11,41,61,2,7,51,72,32,51,7,21,2,6,11,39,72
2014-03-19 00:00:00.000,ATP World Tour Masters 1000 Miami FL; U.S.A. ATP World Tour Masters 1000,HARD,2,Jo-Wilfried Tsonga,N/A Bye,Jo-Wilfried Tsonga,,R128,0,0,0,0,0,0,0,0,0,0,0,0,0,0,0,0,0,0,0,0,0,0,0,0,0,0,0
2014-03-19 00:00:00.000,ATP World Tour Masters 1000 Miami FL; U.S.A. ATP World Tour Masters 1000,HARD,2,Tommy Robredo,N/A Bye,Tommy Robredo,,R128,0,0,0,0,0,0,0,0,0,0,0,0,0,0,0,0,0,0,0,0,0,0,0,0,0,0,0
2014-03-19 00:00:00.000,ATP World Tour Masters 1000 Miami FL; U.S.A. ATP World Tour Masters 1000,HARD,2,Dominic Thiem,Lukas Rosol,Dominic Thiem,7-6(6); 6-4,R128,94,5,2,35,70,30,35,21,35,3,4,11,51,70,10,5,47,84,35,47,17,37,6,8,11,52,84
2014-03-19 00:00:00.000,ATP World Tour Masters 1000 Miami FL; U.S.A. ATP World Tour Masters 1000,HARD,2,Julien Benneteau,Kyle Edmund,Julien Benneteau,6-7(2); 6-3; 6-2,R128,116,15,3,48,91,39,48,24,43,3,5,15,63,91,6,3,52,85,35,52,16,33,5,10,14,51,85
2014-03-19 00:00:00.000,ATP World Tour Masters 1000 Miami FL; U.S.A. ATP World Tour Masters 1000,HARD,2,Ernests Gulbis,N/A Bye,Ernests Gulbis,,R128,0,0,0,0,0,0,0,0,0,0,0,0,0,0,0,0,0,0,0,0,0,0,0,0,0,0,0
2014-03-19 00:00:00.000,ATP World Tour Masters 1000 Miami FL; U.S.A. ATP World Tour Masters 1000,HARD,2,Florian Mayer,N/A Bye,Florian Mayer,,R128,0,0,0,0,0,0,0,0,0,0,0,0,0,0,0,0,0,0,0,0,0,0,0,0,0,0,0
2014-03-19 00:00:00.000,ATP World Tour Masters 1000 Miami FL; U.S.A. ATP World Tour Masters 1000,HARD,2,Ivan Dodig,Andrey Golubev,Ivan Dodig,4-6; 6-1; 6-4,R128,119,5,5,49,74,36,49,14,25,1,4,14,50,74,7,6,55,100,38,55,18,45,8,13,13,56,100
2014-03-19 00:00:00.000,ATP World Tour Masters 1000 Miami FL; U.S.A. ATP World Tour Masters 1000,HARD,2,Jeremy Chardy,Juan Monaco,Jeremy Chardy,7-5; 3-6; 7-6(5),R128,159,22,9,63,118,51,63,22,55,11,14,16,73,118,3,4,83,116,53,83,19,33,8,11,17,72,116
2014-03-19 00:00:00.000,ATP World Tour Masters 1000 Miami FL; U.S.A. ATP World Tour Masters 1000,HARD,2,Novak Djokovic,N/A Bye,Novak Djokovic,,R128,0,0,0,0,0,0,0,0,0,0,0,0,0,0,0,0,0,0,0,0,0,0,0,0,0,0,0
2014-03-19 00:00:00.000,ATP World Tour Masters 1000 Miami FL; U.S.A. ATP World Tour Masters 1000,HARD,2,Rafael Nadal,Lleyton Hewitt,Rafael Nadal,6-1; 6-3,R64,69,1,0,25,40,20,25,13,15,0,0,8,33,40,3,0,37,50,19,37,7,13,1,5,8,26,50
2014-03-19 00:00:00.000,ATP World Tour Masters 1000 Miami FL; U.S.A. ATP World Tour Masters 1000,HARD,2,Denis Istomin,Dmitry Tursunov,Denis Istomin,6-7(8); 6-0; 6-3,R64,125,19,2,73,102,53,73,13,29,5,6,14,66,102,8,14,46,91,32,46,20,45,5,10,13,52,91
2014-03-19 00:00:00.000,ATP World Tour Masters 1000 Miami FL; U.S.A. ATP World Tour Masters 1000,HARD,2,Roberto Bautista Agut,Jerzy Janowicz,Roberto Bautista Agut,6-4; 6-1,R64,70,3,3,36,55,27,36,12,19,5,5,9,39,55,1,3,31,52,16,31,11,21,2,5,8,27,52
2014-03-19 00:00:00.000,ATP World Tour Masters 1000 Miami FL; U.S.A. ATP World Tour Masters 1000,HARD,2,Fabio Fognini,Lukas Lacko,Fabio Fognini,6-4; 6-4,R64,72,4,3,26,52,23,26,18,26,0,0,10,41,52,3,3,30,65,26,30,16,35,4,6,10,42,65
2014-03-19 00:00:00.000,ATP World Tour Masters 1000 Miami FL; U.S.A. ATP World Tour Masters 1000,HARD,2,Milos Raonic,Jack Sock,Milos Raonic,6-4; 7-6(1),R64,87,14,2,32,57,30,32,18,25,0,0,11,48,57,2,1,35,62,28,35,18,27,1,2,11,46,62
2014-03-19 00:00:00.000,ATP World Tour Masters 1000 Miami FL; U.S.A. ATP World Tour Masters 1000,HARD,2,Guillermo Garcia-Lopez,Gael Monfils,Guillermo Garcia-Lopez,6-2; 7-5,R64,73,2,3,22,51,18,22,15,29,0,3,10,33,51,2,6,35,59,20,35,7,24,4,10,10,27,59
2014-03-19 00:00:00.000,ATP World Tour Masters 1000 Miami FL; U.S.A. ATP World Tour Masters 1000,HARD,2,Aljaz Bedene,Vasek Pospisil,Aljaz Bedene,6-7(5); 7-5; 6-3,R64,145,8,3,46,93,42,46,31,47,0,0,17,73,93,7,2,59,106,44,59,28,47,2,4,16,72,106
2014-03-19 00:00:00.000,ATP World Tour Masters 1000 Miami FL; U.S.A. ATP World Tour Masters 1000,HARD,2,Benjamin Becker,Ryan Harrison,Benjamin Becker,7-5; 3-6; 7-6(2),R64,141,7,3,55,95,45,55,16,40,1,5,16,61,95,11,5,78,116,52,78,18,38,6,10,17,70,116
2014-03-19 00:00:00.000,ATP World Tour Masters 1000 Miami FL; U.S.A. ATP World Tour Masters 1000,HARD,2,Stan Wawrinka,Daniel Gimeno-Traver,Stan Wawrinka,6-0; 3-6; 6-3,R64,89,8,3,49,83,40,49,15,34,4,6,12,55,83,4,2,42,70,25,42,12,28,1,6,12,37,70
2014-03-19 00:00:00.000,ATP World Tour Masters 1000 Miami FL; U.S.A. ATP World Tour Masters 1000,HARD,2,Edouard Roger-Vasselin,Marin Cilic,Edouard Roger-Vasselin,6-2; 7-6(5),R64,97,4,1,37,59,29,37,18,22,3,3,10,47,59,10,4,34,77,28,34,17,43,6,8,10,45,77
2014-03-19 00:00:00.000,ATP World Tour Masters 1000 Miami FL; U.S.A. ATP World Tour Masters 1000,HARD,2,Alexandr Dolgopolov,Jarkko Nieminen,Alexandr Dolgopolov,6-4; 6-2,R64,72,2,1,31,55,21,31,16,24,5,6,9,37,55,2,2,41,67,21,41,15,26,7,11,9,36,67
2014-03-19 00:00:00.000,ATP World Tour Masters 1000 Miami FL; U.S.A. ATP World Tour Masters 1000,HARD,2,Dusan Lajovic,Yen-Hsun Lu,Dusan Lajovic,6-1; 6-7(3); 6-3,R64,104,8,2,55,103,44,55,27,48,5,6,15,71,103,4,1,51,75,40,51,10,24,1,5,13,50,75
2014-03-19 00:00:00.000,ATP World Tour Masters 1000 Miami FL; U.S.A. ATP World Tour Masters 1000,HARD,2,John Isner,Donald Young,John Isner,6-7(5); 6-3; 6-4,R64,116,16,1,62,88,50,62,14,26,0,2,16,64,88,7,5,61,94,41,61,20,33,2,6,15,61,94
2014-03-19 00:00:00.000,ATP World Tour Masters 1000 Miami FL; U.S.A. ATP World Tour Masters 1000,HARD,2,Nicolas Almagro,Sam Querrey,Nicolas Almagro,6-4; 6-4,R64,68,13,0,29,50,27,29,13,21,0,0,10,40,50,8,2,29,62,23,29,17,33,4,6,10,40,62
2014-03-19 00:00:00.000,ATP World Tour Masters 1000 Miami FL; U.S.A. ATP World Tour Masters 1000,HARD,2,Joao Sousa,Gilles Simon,Joao Sousa,7-6(5); 3-6; 6-3,R64,184,1,2,60,100,38,60,20,40,5,9,15,58,100,7,3,59,109,34,59,30,50,6,10,15,64,109
2014-03-19 00:00:00.000,ATP World Tour Masters 1000 Miami FL; U.S.A. ATP World Tour Masters 1000,HARD,2,Tomas Berdych,Stephane Robert,Tomas Berdych,7-6(5); 6-1,R64,76,9,0,31,50,27,31,11,19,2,3,9,38,50,3,7,22,76,18,22,24,54,2,6,10,42,76
2014-03-19 00:00:00.000,ATP World Tour Masters 1000 Miami FL; U.S.A. ATP World Tour Masters 1000,HARD,2,Roger Federer,Ivo Karlovic,Roger Federer,6-4; 7-6(4),R64,75,6,0,39,52,37,39,12,13,0,0,11,49,52,13,1,44,68,36,44,11,24,2,3,11,47,68
2014-03-19 00:00:00.000,ATP World Tour Masters 1000 Miami FL; U.S.A. ATP World Tour Masters 1000,HARD,2,Thiemo de Bakker,Fernando Verdasco,Thiemo de Bakker,7-6(4); 6-7(3); 6-2,R64,139,16,3,61,108,48,61,25,47,5,7,16,73,108,6,10,77,113,55,77,15,36,7,11,16,70,113
2014-03-19 00:00:00.000,ATP World Tour Masters 1000 Miami FL; U.S.A. ATP World Tour Masters 1000,HARD,2,Kevin Anderson,Horacio Zeballos,Kevin Anderson,6-4; 6-3,R64,65,8,1,33,43,30,33,7,10,0,0,9,37,43,0,0,35,56,24,35,10,21,1,4,10,34,56
2014-03-19 00:00:00.000,ATP World Tour Masters 1000 Miami FL; U.S.A. ATP World Tour Masters 1000,HARD,2,Richard Gasquet,Alejandro Gonzalez,Richard Gasquet,7-6(7); 6-4,R64,121,7,0,41,62,30,41,15,21,0,2,11,45,62,4,2,58,106,41,58,22,48,10,13,11,63,106
2014-03-19 00:00:00.000,ATP World Tour Masters 1000 Miami FL; U.S.A. ATP World Tour Masters 1000,HARD,2,Grigor Dimitrov,Albert Montanes,Grigor Dimitrov,6-1; 6-7(5); 6-3,R64,100,12,3,48,82,46,48,20,34,2,2,15,66,82,3,4,56,89,40,56,17,33,5,8,13,57,89
2014-03-19 00:00:00.000,ATP World Tour Masters 1000 Miami FL; U.S.A. ATP World Tour Masters 1000,HARD,2,Kei Nishikori,Marinko Matosevic,Kei Nishikori,6-4; 6-1,R64,79,6,2,37,59,25,37,10,22,3,5,8,35,59,5,5,32,59,20,32,5,27,5,11,9,25,59
2014-03-19 00:00:00.000,ATP World Tour Masters 1000 Miami FL; U.S.A. ATP World Tour Masters 1000,HARD,2,Andreas Seppi,Radek Stepanek,Andreas Seppi,7-6(8); 4-6; 6-4,R64,172,6,6,48,113,28,48,33,65,10,16,16,61,113,6,6,50,115,32,50,32,65,8,14,16,64,115
2014-03-19 00:00:00.000,ATP World Tour Masters 1000 Miami FL; U.S.A. ATP World Tour Masters 1000,HARD,2,David Ferrer,Teymuraz Gabashvili,David Ferrer,6-4; 6-0,R64,78,2,2,42,66,32,42,13,24,6,6,8,45,66,1,5,15,43,9,15,15,28,5,9,8,24,43
2014-03-19 00:00:00.000,ATP World Tour Masters 1000 Miami FL; U.S.A. ATP World Tour Masters 1000,HARD,2,Andy Murray,Matthew Ebden,Andy Murray,3-6; 6-0; 6-1,R64,97,5,3,46,69,32,46,13,23,9,11,11,45,69,3,7,47,83,24,47,16,36,10,16,11,40,83
2014-03-19 00:00:00.000,ATP World Tour Masters 1000 Miami FL; U.S.A. ATP World Tour Masters 1000,HARD,2,Feliciano Lopez,Jiri Vesely,Feliciano Lopez,6-2; 7-6(3),R64,93,12,2,37,73,31,37,20,36,4,4,10,51,73,9,3,44,63,28,44,11,19,3,5,10,39,63
2014-03-19 00:00:00.000,ATP World Tour Masters 1000 Miami FL; U.S.A. ATP World Tour Masters 1000,HARD,2,Marcos Baghdatis,Philipp Kohlschreiber,Marcos Baghdatis,3-6; 7-6(1); 7-6(5),R64,136,8,6,56,112,43,56,35,56,5,8,17,78,112,7,1,50,98,39,50,29,48,0,1,16,68,98
2014-03-19 00:00:00.000,ATP World Tour Masters 1000 Miami FL; U.S.A. ATP World Tour Masters 1000,HARD,2,Jo-Wilfried Tsonga,Adrian Mannarino,Jo-Wilfried Tsonga,6-2; 6-4,R64,61,4,4,26,47,22,26,15,21,0,0,9,37,47,1,3,33,53,23,33,7,20,3,6,9,30,53
2014-03-19 00:00:00.000,ATP World Tour Masters 1000 Miami FL; U.S.A. ATP World Tour Masters 1000,HARD,2,Tommy Robredo,Dominic Thiem,Tommy Robredo,6-4; 7-6(8),R64,101,7,1,39,70,28,39,18,31,0,2,11,46,70,1,4,52,74,38,52,7,22,4,7,11,45,74
2014-03-19 00:00:00.000,ATP World Tour Masters 1000 Miami FL; U.S.A. ATP World Tour Masters 1000,HARD,2,Julien Benneteau,Ernests Gulbis,Julien Benneteau,6-4; 4-6; 7-5,R64,142,7,5,55,96,43,55,21,41,2,4,16,64,96,14,10,51,105,36,51,30,54,6,9,16,66,105
2014-03-19 00:00:00.000,ATP World Tour Masters 1000 Miami FL; U.S.A. ATP World Tour Masters 1000,HARD,2,Florian Mayer,Ivan Dodig,Florian Mayer,6-3; 6-2,R64,66,5,0,41,50,31,41,5,9,2,2,8,36,50,6,4,26,55,14,26,14,29,4,8,9,28,55
2014-03-19 00:00:00.000,ATP World Tour Masters 1000 Miami FL; U.S.A. ATP World Tour Masters 1000,HARD,2,Novak Djokovic,Jeremy Chardy,Novak Djokovic,6-4; 6-3,R64,85,8,2,44,65,31,44,11,21,2,3,10,42,65,2,2,25,49,18,25,9,24,0,3,9,27,49
2014-03-19 00:00:00.000,ATP World Tour Masters 1000 Miami FL; U.S.A. ATP World Tour Masters 1000,HARD,2,Rafael Nadal,Denis Istomin,Rafael Nadal,6-1; 6-0,R32,60,3,0,27,35,19,27,7,8,3,3,6,26,35,4,1,25,44,11,25,5,19,1,7,7,16,44
2014-03-19 00:00:00.000,ATP World Tour Masters 1000 Miami FL; U.S.A. ATP World Tour Masters 1000,HARD,2,Fabio Fognini,Roberto Bautista Agut,Fabio Fognini,4-6; 6-3; 6-3,R32,121,6,4,45,82,35,45,19,37,2,4,14,54,82,3,2,65,92,39,65,15,27,3,7,14,54,92
2014-03-19 00:00:00.000,ATP World Tour Masters 1000 Miami FL; U.S.A. ATP World Tour Masters 1000,HARD,2,Milos Raonic,Guillermo Garcia-Lopez,Milos Raonic,6-1; 6-2,R32,57,10,0,22,37,20,22,12,15,0,0,8,32,37,0,1,23,50,18,23,6,27,3,7,7,24,50
2014-03-19 00:00:00.000,ATP World Tour Masters 1000 Miami FL; U.S.A. ATP World Tour Masters 1000,HARD,2,Benjamin Becker,Aljaz Bedene,Benjamin Becker,6-3; 7-5,R32,91,7,4,39,71,30,39,19,32,4,5,11,49,71,12,1,31,60,23,31,14,29,5,8,10,37,60
2014-03-19 00:00:00.000,ATP World Tour Masters 1000 Miami FL; U.S.A. ATP World Tour Masters 1000,HARD,2,Stan Wawrinka,Edouard Roger-Vasselin,Stan Wawrinka,7-5; 6-4,R32,94,6,2,34,63,26,34,17,29,2,3,11,43,63,1,0,56,81,33,56,14,25,7,10,11,47,81
2014-03-19 00:00:00.000,ATP World Tour Masters 1000 Miami FL; U.S.A. ATP World Tour Masters 1000,HARD,2,Alexandr Dolgopolov,Dusan Lajovic,Alexandr Dolgopolov,3-6; 6-0; 7-6(5),R32,120,6,5,43,84,35,43,20,41,1,4,13,55,84,6,3,66,100,44,66,15,34,6,11,14,59,100
2014-03-19 00:00:00.000,ATP World Tour Masters 1000 Miami FL; U.S.A. ATP World Tour Masters 1000,HARD,2,John Isner,Nicolas Almagro,John Isner,7-5; 6-3,R32,71,17,1,43,61,34,43,11,18,2,2,11,45,61,7,2,40,58,31,40,9,18,3,5,10,40,58
2014-03-19 00:00:00.000,ATP World Tour Masters 1000 Miami FL; U.S.A. ATP World Tour Masters 1000,HARD,2,Tomas Berdych,Joao Sousa,Tomas Berdych,6-2; 6-4,R32,82,4,1,26,50,16,26,17,24,3,5,9,33,50,0,5,37,69,26,37,9,32,4,9,9,35,69
2014-03-19 00:00:00.000,ATP World Tour Masters 1000 Miami FL; U.S.A. ATP World Tour Masters 1000,HARD,2,Roger Federer,Thiemo de Bakker,Roger Federer,6-3; 6-3,R32,63,6,1,26,43,22,26,14,17,0,0,9,36,43,7,2,41,68,27,41,11,27,6,9,9,38,68
2014-03-19 00:00:00.000,ATP World Tour Masters 1000 Miami FL; U.S.A. ATP World Tour Masters 1000,HARD,2,Richard Gasquet,Kevin Anderson,Richard Gasquet,6-3; 6-4,R32,91,6,0,44,66,32,44,14,22,5,5,10,46,66,8,1,45,67,30,45,11,22,6,8,9,41,67
2014-03-19 00:00:00.000,ATP World Tour Masters 1000 Miami FL; U.S.A. ATP World Tour Masters 1000,HARD,2,Kei Nishikori,Grigor Dimitrov,Kei Nishikori,7-6(1); 7-5,R32,102,9,0,44,74,38,44,16,30,1,1,12,54,74,11,4,46,76,34,46,16,30,1,2,12,50,76
2014-03-19 00:00:00.000,ATP World Tour Masters 1000 Miami FL; U.S.A. ATP World Tour Masters 1000,HARD,2,David Ferrer,Andreas Seppi,David Ferrer,6-3; 6-2,R32,70,1,2,24,48,18,24,17,24,0,1,9,35,48,2,2,24,48,14,24,10,24,4,8,8,24,48
2014-03-19 00:00:00.000,ATP World Tour Masters 1000 Miami FL; U.S.A. ATP World Tour Masters 1000,HARD,2,Andy Murray,Feliciano Lopez,Andy Murray,6-4; 6-1,R32,73,1,3,23,48,18,23,15,25,3,4,8,33,48,2,4,20,47,10,20,12,27,1,6,9,22,47
2014-03-19 00:00:00.000,ATP World Tour Masters 1000 Miami FL; U.S.A. ATP World Tour Masters 1000,HARD,2,Jo-Wilfried Tsonga,Marcos Baghdatis,Jo-Wilfried Tsonga,4-6; 7-6(6); 7-5,R32,150,16,5,66,115,51,66,25,49,5,6,17,76,115,9,4,55,101,44,55,28,46,3,4,17,72,101
2014-03-19 00:00:00.000,ATP World Tour Masters 1000 Miami FL; U.S.A. ATP World Tour Masters 1000,HARD,2,Tommy Robredo,Julien Benneteau,Tommy Robredo,6-3; 6-4,R32,78,8,3,36,63,25,36,15,27,6,8,10,40,63,6,0,33,46,21,33,6,13,0,4,9,27,46
2014-03-19 00:00:00.000,ATP World Tour Masters 1000 Miami FL; U.S.A. ATP World Tour Masters 1000,HARD,2,Novak Djokovic,Florian Mayer,Novak Djokovic,W/O,R32,0,0,0,0,0,0,0,0,0,0,0,0,0,0,0,0,0,0,0,0,0,0,0,0,0,0,0
2014-03-19 00:00:00.000,ATP World Tour Masters 1000 Miami FL; U.S.A. ATP World Tour Masters 1000,HARD,2,Rafael Nadal,Fabio Fognini,Rafael Nadal,6-2; 6-2,R16,62,3,1,23,35,22,23,10,12,0,0,8,32,35,2,1,27,48,17,27,9,21,4,8,8,26,48
2014-03-19 00:00:00.000,ATP World Tour Masters 1000 Miami FL; U.S.A. ATP World Tour Masters 1000,HARD,2,Milos Raonic,Benjamin Becker,Milos Raonic,6-3; 6-4,R16,90,15,3,41,67,35,41,14,26,8,8,10,49,67,0,3,32,60,23,32,13,28,4,6,9,36,60
2014-03-19 00:00:00.000,ATP World Tour Masters 1000 Miami FL; U.S.A. ATP World Tour Masters 1000,HARD,2,Alexandr Dolgopolov,Stan Wawrinka,Alexandr Dolgopolov,6-4; 3-6; 6-1,R16,105,5,2,30,68,24,30,23,38,2,4,13,47,68,4,7,43,94,28,43,26,51,2,6,13,54,94
2014-03-19 00:00:00.000,ATP World Tour Masters 1000 Miami FL; U.S.A. ATP World Tour Masters 1000,HARD,2,Tomas Berdych,John Isner,Tomas Berdych,6-3; 7-5,R16,91,7,3,34,59,30,34,15,25,2,2,11,45,59,9,1,47,73,30,47,13,26,6,8,10,43,73
2014-03-19 00:00:00.000,ATP World Tour Masters 1000 Miami FL; U.S.A. ATP World Tour Masters 1000,HARD,2,Roger Federer,Richard Gasquet,Roger Federer,6-1; 6-2,R16,49,6,0,25,37,22,25,7,12,1,1,7,29,37,0,4,26,43,14,26,6,17,1,6,8,20,43
2014-03-19 00:00:00.000,ATP World Tour Masters 1000 Miami FL; U.S.A. ATP World Tour Masters 1000,HARD,2,Kei Nishikori,David Ferrer,Kei Nishikori,7-6(7); 2-6; 7-6(9),R16,185,4,3,64,114,43,64,20,50,7,14,16,63,114,2,5,72,123,45,72,26,51,8,13,16,71,123
2014-03-19 00:00:00.000,ATP World Tour Masters 1000 Miami FL; U.S.A. ATP World Tour Masters 1000,HARD,2,Andy Murray,Jo-Wilfried Tsonga,Andy Murray,6-4; 6-1,R16,74,2,1,27,38,24,27,8,11,0,0,8,32,38,3,3,37,68,17,37,17,31,8,12,9,34,68
2014-03-19 00:00:00.000,ATP World Tour Masters 1000 Miami FL; U.S.A. ATP World Tour Masters 1000,HARD,2,Novak Djokovic,Tommy Robredo,Novak Djokovic,6-3; 7-5,R16,82,5,2,39,60,32,39,14,21,1,1,11,46,60,2,1,44,58,31,44,6,14,0,2,10,37,58
2014-03-19 00:00:00.000,ATP World Tour Masters 1000 Miami FL; U.S.A. ATP World Tour Masters 1000,HARD,2,Rafael Nadal,Milos Raonic,Rafael Nadal,4-6; 6-2; 6-4,Q,156,2,2,63,84,47,63,12,21,2,3,14,59,84,8,5,57,103,43,57,18,46,6,9,14,61,103
2014-03-19 00:00:00.000,ATP World Tour Masters 1000 Miami FL; U.S.A. ATP World Tour Masters 1000,HARD,2,Tomas Berdych,Alexandr Dolgopolov,Tomas Berdych,6-4; 7-6(3),Q,105,11,2,44,64,36,44,10,20,1,3,11,46,64,9,3,40,83,33,40,15,43,6,9,11,48,83
2014-03-19 00:00:00.000,ATP World Tour Masters 1000 Miami FL; U.S.A. ATP World Tour Masters 1000,HARD,2,Kei Nishikori,Roger Federer,Kei Nishikori,3-6; 7-5; 6-4,Q,129,6,5,71,108,46,71,18,37,5,9,15,64,108,7,3,47,88,33,47,20,41,7,12,16,53,88
2014-03-19 00:00:00.000,ATP World Tour Masters 1000 Miami FL; U.S.A. ATP World Tour Masters 1000,HARD,2,Novak Djokovic,Andy Murray,Novak Djokovic,7-5; 6-3,Q,90,7,3,48,66,35,48,10,18,1,2,11,45,66,1,5,39,60,25,39,10,21,3,6,10,35,60
2014-03-19 00:00:00.000,ATP World Tour Masters 1000 Miami FL; U.S.A. ATP World Tour Masters 1000,HARD,2,Rafael Nadal,Tomas Berdych,Rafael Nadal,W/O,S,0,0,0,0,0,0,0,0,0,0,0,0,0,0,0,0,0,0,0,0,0,0,0,0,0,0,0
2014-03-19 00:00:00.000,ATP World Tour Masters 1000 Miami FL; U.S.A. ATP World Tour Masters 1000,HARD,2,Novak Djokovic,Kei Nishikori,Novak Djokovic,W/O,S,0,0,0,0,0,0,0,0,0,0,0,0,0,0,0,0,0,0,0,0,0,0,0,0,0,0,0
2014-03-19 00:00:00.000,ATP World Tour Masters 1000 Miami FL; U.S.A. ATP World Tour Masters 1000,HARD,2,Novak Djokovic,Rafael Nadal,Novak Djokovic,6-3; 6-3,F,84,5,0,35,49,30,35,8,14,1,1,9,38,49,2,1,37,52,22,37,7,15,1,4,9,29,52
2014-04-07 00:00:00.000,Casablanca Morocco ATP World Tour 250,CLAY,2,Kevin Anderson,N/A Bye,Kevin Anderson,,R32,0,0,0,0,0,0,0,0,0,0,0,0,0,0,0,0,0,0,0,0,0,0,0,0,0,0,0
2014-04-07 00:00:00.000,Casablanca Morocco ATP World Tour 250,CLAY,2,Victor Hanescu,Hicham Khaddari,Victor Hanescu,7-6(3); 6-3,R32,102,3,6,33,56,27,33,9,23,1,4,10,36,56,3,2,42,80,27,42,15,38,8,13,11,42,80
2014-04-07 00:00:00.000,Casablanca Morocco ATP World Tour 250,CLAY,2,Filip Peliwo,Filippo Volandri,Filip Peliwo,7-6(6); 6-3,R32,89,1,1,26,64,18,26,24,38,5,7,10,42,64,2,5,50,82,33,50,12,32,3,7,11,45,82
2014-04-07 00:00:00.000,Casablanca Morocco ATP World Tour 250,CLAY,2,Federico Delbonis,Gilles Simon,Federico Delbonis,6-4; 6-4,R32,84,1,2,38,63,29,38,15,25,2,2,10,44,63,1,2,26,57,21,26,16,31,1,3,10,37,57
2014-04-07 00:00:00.000,Casablanca Morocco ATP World Tour 250,CLAY,2,Marcel Granollers,N/A Bye,Marcel Granollers,,R32,0,0,0,0,0,0,0,0,0,0,0,0,0,0,0,0,0,0,0,0,0,0,0,0,0,0,0
2014-04-07 00:00:00.000,Casablanca Morocco ATP World Tour 250,CLAY,2,Albert Ramos-Vinolas,Lamine Ouahab,Albert Ramos-Vinolas,6-3; 2-6; 6-1,R32,100,2,1,39,62,24,39,11,23,2,7,12,35,62,0,1,48,81,27,48,12,33,4,11,12,39,81
2014-04-07 00:00:00.000,Casablanca Morocco ATP World Tour 250,CLAY,2,Pablo Carreno Busta,Tobias Kamke,Pablo Carreno Busta,6-1; 6-2,R32,52,7,0,25,47,20,25,14,22,0,0,8,34,47,0,5,21,36,11,21,4,15,0,4,7,15,36
2014-04-07 00:00:00.000,Casablanca Morocco ATP World Tour 250,CLAY,2,Aleksandr Nedovyesov,Robin Haase,Aleksandr Nedovyesov,7-6(6); 6-4,R32,92,4,1,45,73,30,45,12,28,4,8,11,42,73,4,2,42,68,29,42,10,26,4,9,11,39,68
2014-04-07 00:00:00.000,Casablanca Morocco ATP World Tour 250,CLAY,2,Guillermo Garcia-Lopez,Mikhail Kukushkin,Guillermo Garcia-Lopez,7-6(5); 7-6(6),R32,136,3,7,46,91,32,46,20,45,1,5,12,52,91,0,1,59,106,38,59,21,47,7,11,12,59,106
2014-04-07 00:00:00.000,Casablanca Morocco ATP World Tour 250,CLAY,2,Carlos Berlocq,Teymuraz Gabashvili,Carlos Berlocq,6-4; 6-1,R32,76,3,2,36,52,25,36,11,16,2,3,9,36,52,1,8,18,48,15,18,10,30,4,8,8,25,48
2014-04-07 00:00:00.000,Casablanca Morocco ATP World Tour 250,CLAY,2,Albert Montanes,Kenny De Schepper,Albert Montanes,6-2; 6-3,R32,70,4,3,29,48,27,29,8,19,4,4,8,35,48,3,8,45,71,28,45,10,26,7,11,9,38,71
2014-04-07 00:00:00.000,Casablanca Morocco ATP World Tour 250,CLAY,2,Benoit Paire,N/A Bye,Benoit Paire,,R32,0,0,0,0,0,0,0,0,0,0,0,0,0,0,0,0,0,0,0,0,0,0,0,0,0,0,0
2014-04-07 00:00:00.000,Casablanca Morocco ATP World Tour 250,CLAY,2,Joao Sousa,Igor Sijsling,Joao Sousa,6-2; 6-4,R32,58,2,0,27,46,22,27,11,19,1,2,9,33,46,3,4,26,60,16,26,15,34,7,11,9,31,60
2014-04-07 00:00:00.000,Casablanca Morocco ATP World Tour 250,CLAY,2,Roberto Carballes Baena,David Goffin,Roberto Carballes Baena,6-2; 7-5,R32,108,3,1,39,79,27,39,22,40,5,6,10,49,79,1,3,26,59,17,26,15,33,1,5,10,32,59
2014-04-07 00:00:00.000,Casablanca Morocco ATP World Tour 250,CLAY,2,Jiri Vesely,Leonardo Mayer,Jiri Vesely,6-4; 6-3,R32,85,1,3,28,58,24,28,17,30,1,2,10,41,58,1,8,24,59,18,24,17,35,5,8,9,35,59
2014-04-07 00:00:00.000,Casablanca Morocco ATP World Tour 250,CLAY,2,Andrey Kuznetsov,N/A Bye,Andrey Kuznetsov,,R32,0,0,0,0,0,0,0,0,0,0,0,0,0,0,0,0,0,0,0,0,0,0,0,0,0,0,0
2014-04-07 00:00:00.000,Casablanca Morocco ATP World Tour 250,CLAY,2,Victor Hanescu,Kevin Anderson,Victor Hanescu,6-4; 6-4,R16,86,0,5,48,71,36,48,12,23,5,5,10,48,71,4,4,30,55,24,30,13,25,3,5,10,37,55
2014-04-07 00:00:00.000,Casablanca Morocco ATP World Tour 250,CLAY,2,Federico Delbonis,Filip Peliwo,Federico Delbonis,6-2; 6-7(5); 6-4,R16,130,5,3,53,93,40,53,22,40,1,3,15,62,93,7,10,54,99,42,54,15,45,5,10,15,57,99
2014-04-07 00:00:00.000,Casablanca Morocco ATP World Tour 250,CLAY,2,Marcel Granollers,Albert Ramos-Vinolas,Marcel Granollers,6-3; 7-6(3),R16,100,8,0,38,61,33,38,15,23,0,0,11,48,61,0,2,31,63,23,31,19,32,3,4,10,42,63
2014-04-07 00:00:00.000,Casablanca Morocco ATP World Tour 250,CLAY,2,Pablo Carreno Busta,Aleksandr Nedovyesov,Pablo Carreno Busta,3-6; 6-1; 7-6(3),R16,111,4,3,42,88,30,42,30,46,4,6,14,60,88,3,3,57,85,43,57,11,28,3,6,14,54,85
2014-04-07 00:00:00.000,Casablanca Morocco ATP World Tour 250,CLAY,2,Guillermo Garcia-Lopez,Carlos Berlocq,Guillermo Garcia-Lopez,6-2; 7-5,R16,113,0,1,33,62,21,33,17,29,0,2,10,38,62,0,5,45,73,25,45,11,28,4,9,10,36,73
2014-04-07 00:00:00.000,Casablanca Morocco ATP World Tour 250,CLAY,2,Benoit Paire,Albert Montanes,Benoit Paire,6-4; 5-7; 6-4,R16,98,13,3,53,93,40,53,24,40,3,5,16,64,93,3,6,58,98,43,58,21,40,4,7,16,64,98
2014-04-07 00:00:00.000,Casablanca Morocco ATP World Tour 250,CLAY,2,Roberto Carballes Baena,Joao Sousa,Roberto Carballes Baena,6-7(7); 7-6(5); 6-2,R16,193,2,9,71,132,44,71,28,61,3,10,16,72,132,1,4,60,128,36,60,29,68,9,18,16,65,128
2014-04-07 00:00:00.000,Casablanca Morocco ATP World Tour 250,CLAY,2,Andrey Kuznetsov,Jiri Vesely,Andrey Kuznetsov,6-2; 3-1 RET,R16,44,1,0,23,36,18,23,6,13,0,1,6,24,36,0,3,20,35,11,20,5,15,2,6,6,16,35
2014-04-07 00:00:00.000,Casablanca Morocco ATP World Tour 250,CLAY,2,Federico Delbonis,Victor Hanescu,Federico Delbonis,7-6(5); 6-3,Q,100,1,1,49,77,35,49,12,28,7,9,10,47,77,3,3,52,74,37,52,6,22,2,6,11,43,74
2014-04-07 00:00:00.000,Casablanca Morocco ATP World Tour 250,CLAY,2,Marcel Granollers,Pablo Carreno Busta,Marcel Granollers,6-7(4); 6-3; 6-0,Q,142,9,6,49,94,41,49,21,45,2,3,13,62,94,3,0,48,96,31,48,24,48,9,15,14,55,96
2014-04-07 00:00:00.000,Casablanca Morocco ATP World Tour 250,CLAY,2,Guillermo Garcia-Lopez,Benoit Paire,Guillermo Garcia-Lopez,7-5; 7-6(4),Q,97,0,5,48,77,34,48,13,29,3,7,12,47,77,3,5,31,75,22,31,16,44,1,6,12,38,75
2014-04-07 00:00:00.000,Casablanca Morocco ATP World Tour 250,CLAY,2,Roberto Carballes Baena,Andrey Kuznetsov,Roberto Carballes Baena,6-4; 6-2,Q,88,2,2,58,91,35,58,19,33,14,15,9,54,91,2,2,24,52,17,24,10,28,2,6,9,27,52
2014-04-07 00:00:00.000,Casablanca Morocco ATP World Tour 250,CLAY,2,Marcel Granollers,Federico Delbonis,Marcel Granollers,6-1; 6-4,S,75,1,0,24,46,17,24,14,22,0,1,8,31,46,0,3,31,53,11,31,12,22,2,7,9,23,53
2014-04-07 00:00:00.000,Casablanca Morocco ATP World Tour 250,CLAY,2,Guillermo Garcia-Lopez,Roberto Carballes Baena,Guillermo Garcia-Lopez,6-2; 6-7(6); 6-4,S,167,1,5,75,107,48,75,14,32,3,7,15,62,107,1,4,72,108,42,72,13,36,7,14,15,55,108
2014-04-07 00:00:00.000,Casablanca Morocco ATP World Tour 250,CLAY,2,Guillermo Garcia-Lopez,Marcel Granollers,Guillermo Garcia-Lopez,5-7; 6-4; 6-3,F,159,1,6,56,89,43,56,16,33,3,7,16,59,89,3,2,53,88,32,53,19,35,7,12,15,51,88
2014-04-07 00:00:00.000,Houston TX; U.S.A. ATP World Tour 250,CLAY,2,John Isner,N/A Bye,John Isner,,R32,0,0,0,0,0,0,0,0,0,0,0,0,0,0,0,0,0,0,0,0,0,0,0,0,0,0,0
2014-04-07 00:00:00.000,Houston TX; U.S.A. ATP World Tour 250,CLAY,2,Dustin Brown,Rhyne Williams,Dustin Brown,6-1; 6-2,R32,49,5,1,24,43,20,24,12,19,0,0,8,32,43,0,0,26,42,13,26,7,16,3,7,7,20,42
2014-04-07 00:00:00.000,Houston TX; U.S.A. ATP World Tour 250,CLAY,2,Sam Querrey,Alex Bogomolov Jr.,Sam Querrey,6-4; 7-6(6),R32,97,17,4,46,83,31,46,14,37,4,8,11,45,83,1,3,53,81,31,53,12,28,6,11,11,43,81
2014-04-07 00:00:00.000,Houston TX; U.S.A. ATP World Tour 250,CLAY,2,Lleyton Hewitt,Peter Polansky,Lleyton Hewitt,6-4; 3-6; 6-4,R32,124,1,12,59,101,30,59,19,42,8,16,15,49,101,3,3,51,80,32,51,7,29,5,13,14,39,80
2014-04-07 00:00:00.000,Houston TX; U.S.A. ATP World Tour 250,CLAY,2,Nicolas Almagro,N/A Bye,Nicolas Almagro,,R32,0,0,0,0,0,0,0,0,0,0,0,0,0,0,0,0,0,0,0,0,0,0,0,0,0,0,0
2014-04-07 00:00:00.000,Houston TX; U.S.A. ATP World Tour 250,CLAY,2,Michael Russell,Daniel Gimeno-Traver,Michael Russell,6-3; 7-6(2),R32,90,1,2,52,72,40,52,9,20,1,2,11,49,72,6,2,52,85,34,52,15,33,4,6,10,49,85
2014-04-07 00:00:00.000,Houston TX; U.S.A. ATP World Tour 250,CLAY,2,Benjamin Becker,Ruben Ramirez Hidalgo,Benjamin Becker,6-1; 1-6; 6-3,R32,99,7,9,39,72,31,39,13,33,1,4,12,44,72,1,5,41,73,27,41,12,32,6,10,11,39,73
2014-04-07 00:00:00.000,Houston TX; U.S.A. ATP World Tour 250,CLAY,2,Jack Sock,Ivo Karlovic,Jack Sock,6-1; 6-4,R32,56,3,4,31,44,29,31,5,13,1,2,9,34,44,8,2,24,46,19,24,6,22,2,6,8,25,46
2014-04-07 00:00:00.000,Houston TX; U.S.A. ATP World Tour 250,CLAY,2,Juan Monaco,Somdev Devvarman,Juan Monaco,7-6(4); 6-2,R32,85,3,0,36,59,24,36,15,23,0,2,10,39,59,3,1,39,67,26,39,11,28,4,8,10,37,67
2014-04-07 00:00:00.000,Houston TX; U.S.A. ATP World Tour 250,CLAY,2,Donald Young,Ryan Harrison,Donald Young,6-0; 6-1,R32,41,1,0,21,32,18,21,10,11,0,0,7,28,32,0,1,24,37,12,24,2,13,3,8,6,14,37
2014-04-07 00:00:00.000,Houston TX; U.S.A. ATP World Tour 250,CLAY,2,Steve Johnson,Denis Kudla,Steve Johnson,6-3; 7-6(4),R32,112,5,2,39,76,29,39,20,37,2,3,11,49,76,1,4,56,88,34,56,16,32,6,8,10,50,88
2014-04-07 00:00:00.000,Houston TX; U.S.A. ATP World Tour 250,CLAY,2,Fernando Verdasco,N/A Bye,Fernando Verdasco,,R32,0,0,0,0,0,0,0,0,0,0,0,0,0,0,0,0,0,0,0,0,0,0,0,0,0,0,0
2014-04-07 00:00:00.000,Houston TX; U.S.A. ATP World Tour 250,CLAY,2,Feliciano Lopez,Robby Ginepri,Feliciano Lopez,7-5; 6-2,R32,84,6,1,29,59,20,29,18,30,2,4,10,38,59,2,2,38,62,20,38,12,24,7,12,10,32,62
2014-04-07 00:00:00.000,Houston TX; U.S.A. ATP World Tour 250,CLAY,2,Alejandro Gonzalez,Marcos Baghdatis,Alejandro Gonzalez,4-6; 6-2; 6-1,R32,119,0,1,52,100,31,52,26,48,10,13,12,57,100,5,9,41,77,28,41,10,36,2,9,13,38,77
2014-04-07 00:00:00.000,Houston TX; U.S.A. ATP World Tour 250,CLAY,2,Santiago Giraldo,Matthew Ebden,Santiago Giraldo,6-1; 6-2,R32,58,0,0,28,39,20,28,9,11,0,0,7,29,39,3,9,22,48,18,22,3,26,3,8,8,21,48
2014-04-07 00:00:00.000,Houston TX; U.S.A. ATP World Tour 250,CLAY,2,Tommy Robredo,N/A Bye,Tommy Robredo,,R32,0,0,0,0,0,0,0,0,0,0,0,0,0,0,0,0,0,0,0,0,0,0,0,0,0,0,0
2014-04-07 00:00:00.000,Houston TX; U.S.A. ATP World Tour 250,CLAY,2,Dustin Brown,John Isner,Dustin Brown,6-4; 6-7(7); 7-6(4),R16,139,12,10,83,135,68,83,26,52,9,9,17,94,135,13,2,68,116,50,68,29,48,2,3,17,79,116
2014-04-07 00:00:00.000,Houston TX; U.S.A. ATP World Tour 250,CLAY,2,Sam Querrey,Lleyton Hewitt,Sam Querrey,6-3; 6-4,R16,76,8,3,39,62,31,39,8,23,3,5,10,39,62,1,4,21,57,17,21,13,36,1,5,9,30,57
2014-04-07 00:00:00.000,Houston TX; U.S.A. ATP World Tour 250,CLAY,2,Nicolas Almagro,Michael Russell,Nicolas Almagro,6-2; 6-3,R16,68,7,6,23,53,20,23,17,30,1,2,9,37,53,2,2,27,52,15,27,12,25,4,8,8,27,52
2014-04-07 00:00:00.000,Houston TX; U.S.A. ATP World Tour 250,CLAY,2,Jack Sock,Benjamin Becker,Jack Sock,6-4; 6-3,R16,74,3,2,22,48,15,22,20,26,4,5,9,35,48,3,3,35,70,21,35,17,35,6,10,10,38,70
2014-04-07 00:00:00.000,Houston TX; U.S.A. ATP World Tour 250,CLAY,2,Donald Young,Juan Monaco,Donald Young,6-7(4); 6-4; 6-3,R16,135,3,6,55,94,43,55,19,39,10,14,15,62,94,1,2,63,99,36,63,18,36,1,8,16,54,99
2014-04-07 00:00:00.000,Houston TX; U.S.A. ATP World Tour 250,CLAY,2,Fernando Verdasco,Steve Johnson,Fernando Verdasco,6-0; 4-6; 6-3,R16,95,3,4,45,69,38,45,13,24,3,4,13,51,69,1,3,36,73,29,36,14,37,1,5,12,43,73
2014-04-07 00:00:00.000,Houston TX; U.S.A. ATP World Tour 250,CLAY,2,Alejandro Gonzalez,Feliciano Lopez,Alejandro Gonzalez,6-3; 2-0 RET,R16,46,3,2,17,32,15,17,10,15,0,0,6,25,32,4,3,14,32,11,14,7,18,0,2,5,18,32
2014-04-07 00:00:00.000,Houston TX; U.S.A. ATP World Tour 250,CLAY,2,Santiago Giraldo,Tommy Robredo,Santiago Giraldo,6-3; 6-4,R16,80,5,1,36,65,25,36,20,29,4,4,10,45,65,3,2,34,58,23,34,11,24,2,4,9,34,58
2014-04-07 00:00:00.000,Houston TX; U.S.A. ATP World Tour 250,CLAY,2,Sam Querrey,Dustin Brown,Sam Querrey,6-3; 6-7(8); 6-3,Q,104,15,6,59,106,49,59,24,47,4,4,16,73,106,10,6,57,101,42,57,21,44,4,6,14,63,101
2014-04-07 00:00:00.000,Houston TX; U.S.A. ATP World Tour 250,CLAY,2,Nicolas Almagro,Jack Sock,Nicolas Almagro,6-2; 6-4,Q,73,7,0,25,41,22,25,14,16,0,0,9,36,41,5,5,31,57,20,31,13,26,3,6,9,33,57
2014-04-07 00:00:00.000,Houston TX; U.S.A. ATP World Tour 250,CLAY,2,Fernando Verdasco,Donald Young,Fernando Verdasco,7-6(1); 6-1,Q,83,5,2,50,64,34,50,10,14,4,5,10,44,64,0,5,39,60,25,39,7,21,0,3,9,32,60
2014-04-07 00:00:00.000,Houston TX; U.S.A. ATP World Tour 250,CLAY,2,Santiago Giraldo,Alejandro Gonzalez,Santiago Giraldo,6-3; 6-4,Q,88,1,0,40,67,28,40,16,27,7,8,10,44,67,1,2,22,49,13,22,18,27,3,6,9,31,49
2014-04-07 00:00:00.000,Houston TX; U.S.A. ATP World Tour 250,CLAY,2,Nicolas Almagro,Sam Querrey,Nicolas Almagro,W/O,S,0,0,0,0,0,0,0,0,0,0,0,0,0,0,0,0,0,0,0,0,0,0,0,0,0,0,0
2014-04-07 00:00:00.000,Houston TX; U.S.A. ATP World Tour 250,CLAY,2,Fernando Verdasco,Santiago Giraldo,Fernando Verdasco,6-4; 7-5,S,92,1,4,47,64,32,47,9,17,3,6,11,41,64,1,3,35,62,20,35,13,27,1,6,11,33,62
2014-04-07 00:00:00.000,Houston TX; U.S.A. ATP World Tour 250,CLAY,2,Fernando Verdasco,Nicolas Almagro,Fernando Verdasco,6-3; 7-6(4),F,112,4,1,76,96,50,76,10,20,6,7,11,60,96,8,1,36,66,26,36,16,30,7,9,10,42,66
2014-04-13 00:00:00.000,ATP World Tour Masters 1000 Monte Carlo Monaco ATP World Tour Masters 1000,CLAY,2,Rafael Nadal,N/A Bye,Rafael Nadal,,R64,0,0,0,0,0,0,0,0,0,0,0,0,0,0,0,0,0,0,0,0,0,0,0,0,0,0,0
2014-04-13 00:00:00.000,ATP World Tour Masters 1000 Monte Carlo Monaco ATP World Tour Masters 1000,CLAY,2,Teymuraz Gabashvili,Gilles Simon,Teymuraz Gabashvili,4-6; 6-4; 6-4,R64,163,5,2,60,113,39,60,23,53,5,10,15,62,113,4,3,65,111,42,65,18,46,5,11,15,60,111
2014-04-13 00:00:00.000,ATP World Tour Masters 1000 Monte Carlo Monaco ATP World Tour Masters 1000,CLAY,2,Pablo Andujar,Edouard Roger-Vasselin,Pablo Andujar,2-6; 7-5; 7-6(5),R64,156,5,4,67,110,41,67,25,43,6,11,16,66,110,0,2,68,113,48,68,19,45,7,11,16,67,113
2014-04-13 00:00:00.000,ATP World Tour Masters 1000 Monte Carlo Monaco ATP World Tour Masters 1000,CLAY,2,Andreas Seppi,Mikhail Youzhny,Andreas Seppi,6-3; 7-6(4),R64,121,2,0,51,79,37,51,17,28,6,7,11,54,79,3,2,66,91,43,66,10,25,9,11,10,53,91
2014-04-13 00:00:00.000,ATP World Tour Masters 1000 Monte Carlo Monaco ATP World Tour Masters 1000,CLAY,2,Grigor Dimitrov,Marcel Granollers,Grigor Dimitrov,6-2; 4-6; 6-2,R64,122,5,2,44,69,32,44,16,25,0,2,13,48,69,1,3,58,98,40,58,12,40,5,10,13,52,98
2014-04-13 00:00:00.000,ATP World Tour Masters 1000 Monte Carlo Monaco ATP World Tour Masters 1000,CLAY,2,Albert Ramos-Vinolas,Jarkko Nieminen,Albert Ramos-Vinolas,6-2; 7-5,R64,82,5,0,42,59,27,42,11,17,3,5,10,38,59,1,1,33,57,16,33,11,24,4,9,10,27,57
2014-04-13 00:00:00.000,ATP World Tour Masters 1000 Monte Carlo Monaco ATP World Tour Masters 1000,CLAY,2,Jeremy Chardy,Igor Sijsling,Jeremy Chardy,1-6; 6-2; 7-6(5),R64,127,5,6,43,97,33,43,20,54,5,10,13,53,97,4,4,54,96,34,54,20,42,6,11,14,54,96
2014-04-13 00:00:00.000,ATP World Tour Masters 1000 Monte Carlo Monaco ATP World Tour Masters 1000,CLAY,2,David Ferrer,N/A Bye,David Ferrer,,R64,0,0,0,0,0,0,0,0,0,0,0,0,0,0,0,0,0,0,0,0,0,0,0,0,0,0,0
2014-04-13 00:00:00.000,ATP World Tour Masters 1000 Monte Carlo Monaco ATP World Tour Masters 1000,CLAY,2,Stan Wawrinka,N/A Bye,Stan Wawrinka,,R64,0,0,0,0,0,0,0,0,0,0,0,0,0,0,0,0,0,0,0,0,0,0,0,0,0,0,0
2014-04-13 00:00:00.000,ATP World Tour Masters 1000 Monte Carlo Monaco ATP World Tour Masters 1000,CLAY,2,Marin Cilic,Marinko Matosevic,Marin Cilic,6-1; 3-6; 6-2,R64,103,9,2,37,64,32,37,9,27,1,4,12,41,64,5,3,50,87,23,50,22,37,7,13,12,45,87
2014-04-13 00:00:00.000,ATP World Tour Masters 1000 Monte Carlo Monaco ATP World Tour Masters 1000,CLAY,2,Nicolas Mahut,Dominic Thiem,Nicolas Mahut,4-6; 6-3; 6-2,R64,127,11,4,62,102,48,62,16,40,10,12,14,64,102,1,2,66,96,38,66,17,30,7,11,13,55,96
2014-04-13 00:00:00.000,ATP World Tour Masters 1000 Monte Carlo Monaco ATP World Tour Masters 1000,CLAY,2,Nicolas Almagro,Paul-Henri Mathieu,Nicolas Almagro,6-3; 6-2,R64,65,4,1,25,46,22,25,11,21,1,1,8,33,46,0,2,34,55,21,34,8,21,2,6,9,29,55
2014-04-13 00:00:00.000,ATP World Tour Masters 1000 Monte Carlo Monaco ATP World Tour Masters 1000,CLAY,2,Tommy Robredo,David Goffin,Tommy Robredo,6-4; 6-1,R64,83,3,2,43,67,29,43,14,24,8,9,9,43,67,1,2,30,49,19,30,6,19,7,11,8,25,49
2014-04-13 00:00:00.000,ATP World Tour Masters 1000 Monte Carlo Monaco ATP World Tour Masters 1000,CLAY,2,Julien Benneteau,Jurgen Melzer,Julien Benneteau,6-4; 3-6; 6-4,R64,121,4,4,57,83,40,57,15,26,2,5,15,55,83,3,7,57,92,40,57,16,35,5,8,14,56,92
2014-04-13 00:00:00.000,ATP World Tour Masters 1000 Monte Carlo Monaco ATP World Tour Masters 1000,CLAY,2,Yen-Hsun Lu,Federico Delbonis,Yen-Hsun Lu,7-6(5); 6-1,R64,83,1,0,45,65,30,45,14,20,5,7,10,44,65,2,4,41,64,26,41,9,23,3,7,9,35,64
2014-04-13 00:00:00.000,ATP World Tour Masters 1000 Monte Carlo Monaco ATP World Tour Masters 1000,CLAY,2,Milos Raonic,N/A Bye,Milos Raonic,,R64,0,0,0,0,0,0,0,0,0,0,0,0,0,0,0,0,0,0,0,0,0,0,0,0,0,0,0
2014-04-13 00:00:00.000,ATP World Tour Masters 1000 Monte Carlo Monaco ATP World Tour Masters 1000,CLAY,2,Jo-Wilfried Tsonga,N/A Bye,Jo-Wilfried Tsonga,,R64,0,0,0,0,0,0,0,0,0,0,0,0,0,0,0,0,0,0,0,0,0,0,0,0,0,0,0
2014-04-13 00:00:00.000,ATP World Tour Masters 1000 Monte Carlo Monaco ATP World Tour Masters 1000,CLAY,2,Philipp Kohlschreiber,Simone Bolelli,Philipp Kohlschreiber,6-3; 6-4,R64,76,2,1,37,59,28,37,15,22,0,0,10,43,59,2,1,42,62,25,42,14,20,1,3,9,39,62
2014-04-13 00:00:00.000,ATP World Tour Masters 1000 Monte Carlo Monaco ATP World Tour Masters 1000,CLAY,2,Roberto Bautista Agut,Vasek Pospisil,Roberto Bautista Agut,6-2; 6-2,R64,83,1,0,43,60,31,43,9,17,5,5,8,40,60,2,5,40,61,23,40,8,21,6,10,8,31,61
2014-04-13 00:00:00.000,ATP World Tour Masters 1000 Monte Carlo Monaco ATP World Tour Masters 1000,CLAY,2,Fabio Fognini,Joao Sousa,Fabio Fognini,5-7; 7-5; 6-4,R64,141,1,3,54,100,33,54,26,46,4,9,17,59,100,0,0,69,109,37,69,25,40,3,9,17,62,109
2014-04-13 00:00:00.000,ATP World Tour Masters 1000 Monte Carlo Monaco ATP World Tour Masters 1000,CLAY,2,Michael Llodra,Jerzy Janowicz,Michael Llodra,6-4; 6-2,R64,66,4,1,32,46,27,32,8,14,2,3,9,35,46,1,7,31,61,22,31,9,30,3,7,9,31,61
2014-04-13 00:00:00.000,ATP World Tour Masters 1000 Monte Carlo Monaco ATP World Tour Masters 1000,CLAY,2,Lukas Rosol,Evgeny Donskoy,Lukas Rosol,7-5; 6-1,R64,68,2,2,33,54,25,33,12,21,2,3,9,37,54,2,0,41,60,21,41,9,19,2,7,10,30,60
2014-04-13 00:00:00.000,ATP World Tour Masters 1000 Monte Carlo Monaco ATP World Tour Masters 1000,CLAY,2,Radek Stepanek,Ivo Karlovic,Radek Stepanek,6-1; 6-2,R64,58,1,3,25,42,21,25,12,17,1,1,8,33,42,2,4,25,46,16,25,7,21,7,11,7,23,46
2014-04-13 00:00:00.000,ATP World Tour Masters 1000 Monte Carlo Monaco ATP World Tour Masters 1000,CLAY,2,Roger Federer,N/A Bye,Roger Federer,,R64,0,0,0,0,0,0,0,0,0,0,0,0,0,0,0,0,0,0,0,0,0,0,0,0,0,0,0
2014-04-13 00:00:00.000,ATP World Tour Masters 1000 Monte Carlo Monaco ATP World Tour Masters 1000,CLAY,2,Tomas Berdych,N/A Bye,Tomas Berdych,,R64,0,0,0,0,0,0,0,0,0,0,0,0,0,0,0,0,0,0,0,0,0,0,0,0,0,0,0
2014-04-13 00:00:00.000,ATP World Tour Masters 1000 Monte Carlo Monaco ATP World Tour Masters 1000,CLAY,2,Dmitry Tursunov,Robin Haase,Dmitry Tursunov,6-1; 5-7; 6-3,R64,108,7,1,62,99,45,62,15,37,8,11,14,60,99,8,4,52,79,34,52,11,27,2,8,14,45,79
2014-04-13 00:00:00.000,ATP World Tour Masters 1000 Monte Carlo Monaco ATP World Tour Masters 1000,CLAY,2,Guillermo Garcia-Lopez,Benjamin Balleret,Guillermo Garcia-Lopez,7-5; 6-2,R64,78,0,4,31,52,28,31,13,21,1,1,10,41,52,3,1,38,69,20,38,18,31,6,9,10,38,69
2014-04-13 00:00:00.000,ATP World Tour Masters 1000 Monte Carlo Monaco ATP World Tour Masters 1000,CLAY,2,Alexandr Dolgopolov,Ernests Gulbis,Alexandr Dolgopolov,6-2; 6-4,R64,82,5,1,24,54,20,24,17,30,1,2,9,37,54,7,7,40,77,28,40,13,37,7,11,9,41,77
2014-04-13 00:00:00.000,ATP World Tour Masters 1000 Monte Carlo Monaco ATP World Tour Masters 1000,CLAY,2,Gael Monfils,Kevin Anderson,Gael Monfils,6-4; 7-6(4),R64,92,7,0,36,61,31,36,18,25,0,0,11,49,61,6,2,54,82,35,54,18,28,6,7,11,53,82
2014-04-13 00:00:00.000,ATP World Tour Masters 1000 Monte Carlo Monaco ATP World Tour Masters 1000,CLAY,2,Pablo Carreno Busta,Ivan Dodig,Pablo Carreno Busta,6-3; 6-3,R64,65,4,1,21,41,19,21,17,20,0,0,9,36,41,3,3,32,60,23,32,12,28,5,8,9,35,60
2014-04-13 00:00:00.000,ATP World Tour Masters 1000 Monte Carlo Monaco ATP World Tour Masters 1000,CLAY,2,Albert Montanes,Benoit Paire,Albert Montanes,7-5; 4-6; 6-2,R64,118,3,1,61,89,44,61,18,28,4,6,15,62,89,5,6,52,109,39,52,24,57,11,15,15,63,109
2014-04-13 00:00:00.000,ATP World Tour Masters 1000 Monte Carlo Monaco ATP World Tour Masters 1000,CLAY,2,Novak Djokovic,N/A Bye,Novak Djokovic,,R64,0,0,0,0,0,0,0,0,0,0,0,0,0,0,0,0,0,0,0,0,0,0,0,0,0,0,0
2014-04-13 00:00:00.000,ATP World Tour Masters 1000 Monte Carlo Monaco ATP World Tour Masters 1000,CLAY,2,Rafael Nadal,Teymuraz Gabashvili,Rafael Nadal,6-4; 6-1,R32,73,2,0,39,52,31,39,3,13,2,4,9,34,52,1,2,21,42,10,21,6,21,0,5,8,16,42
2014-04-13 00:00:00.000,ATP World Tour Masters 1000 Monte Carlo Monaco ATP World Tour Masters 1000,CLAY,2,Andreas Seppi,Pablo Andujar,Andreas Seppi,7-6(5); 5-7; 6-4,R32,169,10,1,64,122,45,64,31,58,12,15,17,76,122,5,2,82,112,53,82,16,30,6,9,17,69,112
2014-04-13 00:00:00.000,ATP World Tour Masters 1000 Monte Carlo Monaco ATP World Tour Masters 1000,CLAY,2,Grigor Dimitrov,Albert Ramos-Vinolas,Grigor Dimitrov,4-6; 6-3; 6-4,R32,121,8,2,48,76,42,48,17,28,0,1,15,59,76,3,1,53,83,35,53,19,30,3,5,14,54,83
2014-04-13 00:00:00.000,ATP World Tour Masters 1000 Monte Carlo Monaco ATP World Tour Masters 1000,CLAY,2,David Ferrer,Jeremy Chardy,David Ferrer,6-3; 6-0,R32,66,0,3,29,45,25,29,8,16,0,1,8,33,45,0,5,15,46,5,15,15,31,4,9,7,20,46
2014-04-13 00:00:00.000,ATP World Tour Masters 1000 Monte Carlo Monaco ATP World Tour Masters 1000,CLAY,2,Stan Wawrinka,Marin Cilic,Stan Wawrinka,6-0; 6-2,R32,46,3,1,23,34,18,23,10,11,0,0,7,28,34,0,1,17,36,12,17,3,19,2,7,7,15,36
2014-04-13 00:00:00.000,ATP World Tour Masters 1000 Monte Carlo Monaco ATP World Tour Masters 1000,CLAY,2,Nicolas Almagro,Nicolas Mahut,Nicolas Almagro,7-6(3); 6-3,R32,96,7,1,51,86,41,51,18,35,4,4,11,59,86,2,1,42,66,32,42,10,24,1,2,10,42,66
2014-04-13 00:00:00.000,ATP World Tour Masters 1000 Monte Carlo Monaco ATP World Tour Masters 1000,CLAY,2,Tommy Robredo,Julien Benneteau,Tommy Robredo,4-6; 6-0; 6-1,R32,92,4,0,46,65,32,46,14,19,5,7,12,46,65,1,0,57,70,29,57,5,13,6,12,11,34,70
2014-04-13 00:00:00.000,ATP World Tour Masters 1000 Monte Carlo Monaco ATP World Tour Masters 1000,CLAY,2,Milos Raonic,Yen-Hsun Lu,Milos Raonic,6-7(4); 6-2; 6-1,R32,119,19,3,53,84,43,53,18,31,2,3,14,61,84,4,6,76,107,41,76,16,31,14,19,13,57,107
2014-04-13 00:00:00.000,ATP World Tour Masters 1000 Monte Carlo Monaco ATP World Tour Masters 1000,CLAY,2,Jo-Wilfried Tsonga,Philipp Kohlschreiber,Jo-Wilfried Tsonga,6-4; 1-6; 6-4,R32,113,4,0,41,68,31,41,14,27,0,2,13,45,68,3,1,51,95,37,51,23,44,5,7,14,60,95
2014-04-13 00:00:00.000,ATP World Tour Masters 1000 Monte Carlo Monaco ATP World Tour Masters 1000,CLAY,2,Fabio Fognini,Roberto Bautista Agut,Fabio Fognini,7-6(6); 6-4,R32,104,2,5,43,77,28,43,14,34,0,5,11,42,77,0,4,53,73,31,53,6,20,1,7,11,37,73
2014-04-13 00:00:00.000,ATP World Tour Masters 1000 Monte Carlo Monaco ATP World Tour Masters 1000,CLAY,2,Lukas Rosol,Michael Llodra,Lukas Rosol,6-4; 6-4,R32,62,7,2,38,56,29,38,11,18,3,4,10,40,56,2,1,41,61,28,41,8,20,4,7,10,36,61
2014-04-13 00:00:00.000,ATP World Tour Masters 1000 Monte Carlo Monaco ATP World Tour Masters 1000,CLAY,2,Roger Federer,Radek Stepanek,Roger Federer,6-1; 6-2,R32,52,2,1,33,42,29,33,4,9,2,2,8,33,42,0,5,25,41,14,25,7,16,0,4,7,21,41
2014-04-13 00:00:00.000,ATP World Tour Masters 1000 Monte Carlo Monaco ATP World Tour Masters 1000,CLAY,2,Tomas Berdych,Dmitry Tursunov,Tomas Berdych,7-5; 6-4,R32,101,7,3,37,58,29,37,12,21,4,6,11,41,58,1,6,59,86,35,59,13,27,5,9,11,48,86
2014-04-13 00:00:00.000,ATP World Tour Masters 1000 Monte Carlo Monaco ATP World Tour Masters 1000,CLAY,2,Guillermo Garcia-Lopez,Alexandr Dolgopolov,Guillermo Garcia-Lopez,6-1; 7-5,R32,78,1,1,38,56,23,38,11,18,7,9,9,34,56,2,2,24,56,12,24,12,32,3,9,10,24,56
2014-04-13 00:00:00.000,ATP World Tour Masters 1000 Monte Carlo Monaco ATP World Tour Masters 1000,CLAY,2,Pablo Carreno Busta,Gael Monfils,Pablo Carreno Busta,6-3; 7-6(6),R32,98,2,2,53,84,36,53,16,31,7,9,10,52,84,5,4,44,69,26,44,13,25,3,7,11,39,69
2014-04-13 00:00:00.000,ATP World Tour Masters 1000 Monte Carlo Monaco ATP World Tour Masters 1000,CLAY,2,Novak Djokovic,Albert Montanes,Novak Djokovic,6-1; 6-0,R32,45,5,0,29,41,24,29,7,12,4,4,7,31,41,0,1,21,37,7,21,6,16,7,12,6,13,37
2014-04-13 00:00:00.000,ATP World Tour Masters 1000 Monte Carlo Monaco ATP World Tour Masters 1000,CLAY,2,Rafael Nadal,Andreas Seppi,Rafael Nadal,6-1; 6-3,R16,74,2,2,29,45,24,29,7,16,5,6,8,31,45,1,0,27,49,15,27,7,22,0,5,8,22,49
2014-04-13 00:00:00.000,ATP World Tour Masters 1000 Monte Carlo Monaco ATP World Tour Masters 1000,CLAY,2,David Ferrer,Grigor Dimitrov,David Ferrer,6-4; 6-2,R16,96,0,0,36,58,21,36,14,22,2,4,9,35,58,1,1,35,70,21,35,15,35,8,13,9,36,70
2014-04-13 00:00:00.000,ATP World Tour Masters 1000 Monte Carlo Monaco ATP World Tour Masters 1000,CLAY,2,Stan Wawrinka,Nicolas Almagro,Stan Wawrinka,W/O,R16,0,0,0,0,0,0,0,0,0,0,0,0,0,0,0,0,0,0,0,0,0,0,0,0,0,0,0
2014-04-13 00:00:00.000,ATP World Tour Masters 1000 Monte Carlo Monaco ATP World Tour Masters 1000,CLAY,2,Milos Raonic,Tommy Robredo,Milos Raonic,6-4; 6-3,R16,73,7,2,29,53,27,29,14,24,0,0,10,41,53,1,1,33,49,18,33,14,16,4,6,9,32,49
2014-04-13 00:00:00.000,ATP World Tour Masters 1000 Monte Carlo Monaco ATP World Tour Masters 1000,CLAY,2,Jo-Wilfried Tsonga,Fabio Fognini,Jo-Wilfried Tsonga,5-7; 6-3; 6-0,R16,116,6,2,49,86,36,49,19,37,7,10,14,55,86,1,3,51,75,30,51,9,24,2,8,13,39,75
2014-04-13 00:00:00.000,ATP World Tour Masters 1000 Monte Carlo Monaco ATP World Tour Masters 1000,CLAY,2,Roger Federer,Lukas Rosol,Roger Federer,6-4; 6-1,R16,58,6,1,31,53,28,31,9,22,3,4,9,37,53,0,1,25,43,14,25,6,18,0,4,8,20,43
2014-04-13 00:00:00.000,ATP World Tour Masters 1000 Monte Carlo Monaco ATP World Tour Masters 1000,CLAY,2,Guillermo Garcia-Lopez,Tomas Berdych,Guillermo Garcia-Lopez,4-6; 6-3; 6-1,R16,126,0,1,59,77,41,59,7,18,2,5,13,48,77,6,2,42,85,28,42,16,43,4,10,13,44,85
2014-04-13 00:00:00.000,ATP World Tour Masters 1000 Monte Carlo Monaco ATP World Tour Masters 1000,CLAY,2,Novak Djokovic,Pablo Carreno Busta,Novak Djokovic,6-0; 6-1,R16,48,2,0,25,34,19,25,9,9,0,0,7,28,34,0,0,22,38,8,22,6,16,2,7,6,14,38
2014-04-13 00:00:00.000,ATP World Tour Masters 1000 Monte Carlo Monaco ATP World Tour Masters 1000,CLAY,2,David Ferrer,Rafael Nadal,David Ferrer,7-6(1); 6-4,Q,134,1,1,55,90,33,55,20,35,7,10,11,53,90,1,2,49,80,29,49,14,31,6,10,11,43,80
2014-04-13 00:00:00.000,ATP World Tour Masters 1000 Monte Carlo Monaco ATP World Tour Masters 1000,CLAY,2,Stan Wawrinka,Milos Raonic,Stan Wawrinka,7-6(5); 6-2,Q,91,5,3,30,63,24,30,22,33,0,0,10,46,63,6,0,38,62,28,38,14,24,1,3,10,42,62
2014-04-13 00:00:00.000,ATP World Tour Masters 1000 Monte Carlo Monaco ATP World Tour Masters 1000,CLAY,2,Roger Federer,Jo-Wilfried Tsonga,Roger Federer,2-6; 7-6(6); 6-1,Q,146,4,0,61,92,42,61,18,31,2,4,14,60,92,3,2,93,139,57,93,22,46,17,19,13,79,139
2014-04-13 00:00:00.000,ATP World Tour Masters 1000 Monte Carlo Monaco ATP World Tour Masters 1000,CLAY,2,Novak Djokovic,Guillermo Garcia-Lopez,Novak Djokovic,4-6; 6-3; 6-1,Q,132,6,1,55,87,41,55,16,32,3,5,13,57,87,0,1,55,93,33,55,18,38,6,11,13,51,93
2014-04-13 00:00:00.000,ATP World Tour Masters 1000 Monte Carlo Monaco ATP World Tour Masters 1000,CLAY,2,Stan Wawrinka,David Ferrer,Stan Wawrinka,6-1; 7-6(3),S,90,6,1,34,66,29,34,18,32,2,2,10,47,66,1,2,39,65,27,39,13,26,4,6,9,40,65
2014-04-13 00:00:00.000,ATP World Tour Masters 1000 Monte Carlo Monaco ATP World Tour Masters 1000,CLAY,2,Roger Federer,Novak Djokovic,Roger Federer,7-5; 6-2,S,75,3,1,40,57,33,40,10,17,2,2,10,43,57,2,0,40,59,24,40,12,19,2,5,10,36,59
2014-04-13 00:00:00.000,ATP World Tour Masters 1000 Monte Carlo Monaco ATP World Tour Masters 1000,CLAY,2,Stan Wawrinka,Roger Federer,Stan Wawrinka,4-6; 7-6(5); 6-2,F,134,5,2,54,93,43,54,22,39,1,3,15,65,93,3,1,69,103,51,69,15,34,4,7,15,66,103
2014-04-21 00:00:00.000,Barcelona Spain ATP World Tour 500,CLAY,2,Rafael Nadal,N/A Bye,Rafael Nadal,,R64,0,0,0,0,0,0,0,0,0,0,0,0,0,0,0,0,0,0,0,0,0,0,0,0,0,0,0
2014-04-21 00:00:00.000,Barcelona Spain ATP World Tour 500,CLAY,2,Albert Ramos-Vinolas,Nikolay Davydenko,Albert Ramos-Vinolas,6-4; 6-4,R64,84,3,0,37,57,28,37,12,20,1,2,10,40,57,3,3,34,60,24,34,13,26,1,4,10,37,60
2014-04-21 00:00:00.000,Barcelona Spain ATP World Tour 500,CLAY,2,Ivan Dodig,Facundo Arguello,Ivan Dodig,6-3; 6-7(5); 6-2,R64,120,6,2,53,90,41,53,26,37,6,7,15,67,90,3,3,65,95,46,65,12,30,6,10,14,58,95
2014-04-21 00:00:00.000,Barcelona Spain ATP World Tour 500,CLAY,2,Feliciano Lopez,N/A Bye,Feliciano Lopez,,R64,0,0,0,0,0,0,0,0,0,0,0,0,0,0,0,0,0,0,0,0,0,0,0,0,0,0,0
2014-04-21 00:00:00.000,Barcelona Spain ATP World Tour 500,CLAY,2,Fernando Verdasco,N/A Bye,Fernando Verdasco,,R64,0,0,0,0,0,0,0,0,0,0,0,0,0,0,0,0,0,0,0,0,0,0,0,0,0,0,0
2014-04-21 00:00:00.000,Barcelona Spain ATP World Tour 500,CLAY,2,Kenny De Schepper,Marsel Ilhan,Kenny De Schepper,6-3; 7-5,R64,85,6,3,62,83,45,62,10,21,6,6,11,55,83,4,0,42,61,28,42,11,19,1,3,10,39,61
2014-04-21 00:00:00.000,Barcelona Spain ATP World Tour 500,CLAY,2,Martin Klizan,Somdev Devvarman,Martin Klizan,6-2; 6-4,R64,79,0,1,34,50,24,34,10,16,3,4,9,34,50,8,2,44,72,25,44,13,28,7,11,9,38,72
2014-04-21 00:00:00.000,Barcelona Spain ATP World Tour 500,CLAY,2,Nicolas Almagro,N/A Bye,Nicolas Almagro,,R64,0,0,0,0,0,0,0,0,0,0,0,0,0,0,0,0,0,0,0,0,0,0,0,0,0,0,0
2014-04-21 00:00:00.000,Barcelona Spain ATP World Tour 500,CLAY,2,Fabio Fognini,N/A Bye,Fabio Fognini,,R64,0,0,0,0,0,0,0,0,0,0,0,0,0,0,0,0,0,0,0,0,0,0,0,0,0,0,0
2014-04-21 00:00:00.000,Barcelona Spain ATP World Tour 500,CLAY,2,Santiago Giraldo,Igor Sijsling,Santiago Giraldo,6-4; 6-2,R64,59,3,0,41,54,28,41,10,13,0,0,9,38,54,5,1,38,57,21,38,13,19,3,6,9,34,57
2014-04-21 00:00:00.000,Barcelona Spain ATP World Tour 500,CLAY,2,Dominic Thiem,Radek Stepanek,Dominic Thiem,6-4; 6-4,R64,71,5,3,33,65,28,33,14,32,3,4,10,42,65,5,5,38,55,27,38,8,17,3,6,10,35,55
2014-04-21 00:00:00.000,Barcelona Spain ATP World Tour 500,CLAY,2,Marcel Granollers,N/A Bye,Marcel Granollers,,R64,0,0,0,0,0,0,0,0,0,0,0,0,0,0,0,0,0,0,0,0,0,0,0,0,0,0,0
2014-04-21 00:00:00.000,Barcelona Spain ATP World Tour 500,CLAY,2,Philipp Kohlschreiber,N/A Bye,Philipp Kohlschreiber,,R64,0,0,0,0,0,0,0,0,0,0,0,0,0,0,0,0,0,0,0,0,0,0,0,0,0,0,0
2014-04-21 00:00:00.000,Barcelona Spain ATP World Tour 500,CLAY,2,Edouard Roger-Vasselin,Andreas Beck,Edouard Roger-Vasselin,6-2; 6-2,R64,68,11,1,36,53,28,36,10,17,6,6,8,38,53,3,2,37,56,24,37,5,19,6,10,8,29,56
2014-04-21 00:00:00.000,Barcelona Spain ATP World Tour 500,CLAY,2,Jurgen Melzer,Mikhail Kukushkin,Jurgen Melzer,7-6(5); 3-6; 6-3,R64,149,5,4,49,93,40,49,20,44,2,6,15,60,93,6,3,73,113,48,73,21,40,7,11,15,69,113
2014-04-21 00:00:00.000,Barcelona Spain ATP World Tour 500,CLAY,2,Jerzy Janowicz,N/A Bye,Jerzy Janowicz,,R64,0,0,0,0,0,0,0,0,0,0,0,0,0,0,0,0,0,0,0,0,0,0,0,0,0,0,0
2014-04-21 00:00:00.000,Barcelona Spain ATP World Tour 500,CLAY,2,Tommy Robredo,N/A Bye,Tommy Robredo,,R64,0,0,0,0,0,0,0,0,0,0,0,0,0,0,0,0,0,0,0,0,0,0,0,0,0,0,0
2014-04-21 00:00:00.000,Barcelona Spain ATP World Tour 500,CLAY,2,Marinko Matosevic,Joao Sousa,Marinko Matosevic,6-3; 6-2,R64,74,4,0,34,53,26,34,10,19,1,2,9,36,53,0,1,39,63,24,39,8,24,10,14,8,32,63
2014-04-21 00:00:00.000,Barcelona Spain ATP World Tour 500,CLAY,2,Andrey Kuznetsov,Pablo Carreno Busta,Andrey Kuznetsov,2-6; 6-1; 6-2,R64,94,3,2,33,69,23,33,18,36,2,5,12,41,69,2,1,33,69,19,33,16,36,6,11,11,35,69
2014-04-21 00:00:00.000,Barcelona Spain ATP World Tour 500,CLAY,2,Marin Cilic,N/A Bye,Marin Cilic,,R64,0,0,0,0,0,0,0,0,0,0,0,0,0,0,0,0,0,0,0,0,0,0,0,0,0,0,0
2014-04-21 00:00:00.000,Barcelona Spain ATP World Tour 500,CLAY,2,Benoit Paire,N/A Bye,Benoit Paire,,R64,0,0,0,0,0,0,0,0,0,0,0,0,0,0,0,0,0,0,0,0,0,0,0,0,0,0,0
2014-04-21 00:00:00.000,Barcelona Spain ATP World Tour 500,CLAY,2,Andrey Golubev,Matteo Viola,Andrey Golubev,6-4; 6-3,R64,75,4,2,36,53,26,36,10,17,4,5,9,36,53,2,2,46,66,26,46,10,20,4,8,10,36,66
2014-04-21 00:00:00.000,Barcelona Spain ATP World Tour 500,CLAY,2,Roberto Bautista Agut,Lukasz Kubot,Roberto Bautista Agut,6-1; 6-0,R64,61,2,1,34,47,27,34,7,13,8,8,7,34,47,1,1,22,39,7,22,7,17,2,7,6,14,39
2014-04-21 00:00:00.000,Barcelona Spain ATP World Tour 500,CLAY,2,Kei Nishikori,N/A Bye,Kei Nishikori,,R64,0,0,0,0,0,0,0,0,0,0,0,0,0,0,0,0,0,0,0,0,0,0,0,0,0,0,0
2014-04-21 00:00:00.000,Barcelona Spain ATP World Tour 500,CLAY,2,Alexandr Dolgopolov,N/A Bye,Alexandr Dolgopolov,,R64,0,0,0,0,0,0,0,0,0,0,0,0,0,0,0,0,0,0,0,0,0,0,0,0,0,0,0
2014-04-21 00:00:00.000,Barcelona Spain ATP World Tour 500,CLAY,2,Albert Montanes,Marc Lopez,Albert Montanes,7-6(4); 6-2,R64,102,2,4,48,67,34,48,9,19,6,8,10,43,67,1,0,57,74,30,57,8,17,1,5,10,38,74
2014-04-21 00:00:00.000,Barcelona Spain ATP World Tour 500,CLAY,2,Daniel Gimeno-Traver,Roberto Carballes Baena,Daniel Gimeno-Traver,6-3; 7-5,R64,92,2,1,35,66,26,35,15,31,5,7,10,41,66,0,2,45,68,25,45,10,23,2,7,11,35,68
2014-04-21 00:00:00.000,Barcelona Spain ATP World Tour 500,CLAY,2,Ernests Gulbis,N/A Bye,Ernests Gulbis,,R64,0,0,0,0,0,0,0,0,0,0,0,0,0,0,0,0,0,0,0,0,0,0,0,0,0,0,0
2014-04-21 00:00:00.000,Barcelona Spain ATP World Tour 500,CLAY,2,Dmitry Tursunov,N/A Bye,Dmitry Tursunov,,R64,0,0,0,0,0,0,0,0,0,0,0,0,0,0,0,0,0,0,0,0,0,0,0,0,0,0,0
2014-04-21 00:00:00.000,Barcelona Spain ATP World Tour 500,CLAY,2,Inigo Cervantes,Aleksandr Nedovyesov,Inigo Cervantes,3-6; 6-2; 6-4,R64,124,1,3,56,107,42,56,25,51,9,11,14,67,107,1,1,62,86,37,62,14,24,2,5,13,51,86
2014-04-21 00:00:00.000,Barcelona Spain ATP World Tour 500,CLAY,2,Teymuraz Gabashvili,Michal Przysiezny,Teymuraz Gabashvili,6-3; 6-4,R64,71,5,1,42,58,34,42,9,16,4,5,10,43,58,3,0,30,54,20,30,13,24,2,5,9,33,54
2014-04-21 00:00:00.000,Barcelona Spain ATP World Tour 500,CLAY,2,David Ferrer,N/A Bye,David Ferrer,,R64,0,0,0,0,0,0,0,0,0,0,0,0,0,0,0,0,0,0,0,0,0,0,0,0,0,0,0
2014-04-21 00:00:00.000,Barcelona Spain ATP World Tour 500,CLAY,2,Rafael Nadal,Albert Ramos-Vinolas,Rafael Nadal,7-6(2); 6-4,R32,117,1,0,51,70,35,51,12,19,2,4,11,47,70,1,3,40,67,26,40,11,27,0,3,11,37,67
2014-04-21 00:00:00.000,Barcelona Spain ATP World Tour 500,CLAY,2,Ivan Dodig,Feliciano Lopez,Ivan Dodig,6-1; 6-4,R32,61,10,0,28,45,23,28,13,17,0,0,9,36,45,4,2,25,44,17,25,8,19,4,7,8,25,44
2014-04-21 00:00:00.000,Barcelona Spain ATP World Tour 500,CLAY,2,Fernando Verdasco,Kenny De Schepper,Fernando Verdasco,6-4; 6-3,R32,79,1,1,40,54,28,40,9,14,7,8,9,37,54,3,3,43,64,28,43,8,21,3,7,10,36,64
2014-04-21 00:00:00.000,Barcelona Spain ATP World Tour 500,CLAY,2,Nicolas Almagro,Martin Klizan,Nicolas Almagro,7-5; 7-6(4),R32,109,12,2,40,71,32,40,19,31,2,3,12,51,71,4,2,62,100,38,62,21,38,8,10,12,59,100
2014-04-21 00:00:00.000,Barcelona Spain ATP World Tour 500,CLAY,2,Santiago Giraldo,Fabio Fognini,Santiago Giraldo,6-0; 4-0 RET,R32,38,2,0,22,30,18,22,4,8,0,0,5,22,30,0,1,16,27,5,16,2,11,1,6,5,7,27
2014-04-21 00:00:00.000,Barcelona Spain ATP World Tour 500,CLAY,2,Dominic Thiem,Marcel Granollers,Dominic Thiem,3-6; 6-3; 6-2,R32,135,0,1,63,103,36,63,22,40,9,13,13,58,103,3,1,49,77,30,49,11,28,7,13,13,41,77
2014-04-21 00:00:00.000,Barcelona Spain ATP World Tour 500,CLAY,2,Philipp Kohlschreiber,Edouard Roger-Vasselin,Philipp Kohlschreiber,7-6(4); 6-2,R32,81,10,2,37,63,30,37,15,26,1,2,10,45,63,2,1,42,63,26,42,14,21,5,8,10,40,63
2014-04-21 00:00:00.000,Barcelona Spain ATP World Tour 500,CLAY,2,Jurgen Melzer,Jerzy Janowicz,Jurgen Melzer,6-4; 7-6(1),R32,92,5,3,45,68,29,45,11,23,3,7,11,40,68,6,5,34,77,19,34,17,43,4,9,11,36,77
2014-04-21 00:00:00.000,Barcelona Spain ATP World Tour 500,CLAY,2,Tommy Robredo,Marinko Matosevic,Tommy Robredo,6-3; 6-4,R32,82,1,0,43,62,30,43,9,19,3,5,10,39,62,1,3,36,61,23,36,9,25,5,9,9,32,61
2014-04-21 00:00:00.000,Barcelona Spain ATP World Tour 500,CLAY,2,Marin Cilic,Andrey Kuznetsov,Marin Cilic,6-1; 7-6(2),R32,77,10,1,39,67,34,39,13,28,4,5,10,47,67,0,2,34,63,24,34,11,29,2,5,9,35,63
2014-04-21 00:00:00.000,Barcelona Spain ATP World Tour 500,CLAY,2,Andrey Golubev,Benoit Paire,Andrey Golubev,6-4; 5-1 RET,R32,61,1,2,36,51,28,36,5,15,2,3,8,33,51,0,2,30,48,19,30,6,18,4,8,8,25,48
2014-04-21 00:00:00.000,Barcelona Spain ATP World Tour 500,CLAY,2,Kei Nishikori,Roberto Bautista Agut,Kei Nishikori,6-1; 4-6; 6-3,R32,118,5,2,45,77,31,45,15,32,3,7,13,46,77,1,1,60,90,33,60,14,30,8,15,13,47,90
2014-04-21 00:00:00.000,Barcelona Spain ATP World Tour 500,CLAY,2,Albert Montanes,Alexandr Dolgopolov,Albert Montanes,7-6(5); 6-3,R32,93,3,1,53,74,44,53,7,21,4,4,11,51,74,4,0,34,68,28,34,18,34,1,2,10,46,68
2014-04-21 00:00:00.000,Barcelona Spain ATP World Tour 500,CLAY,2,Ernests Gulbis,Daniel Gimeno-Traver,Ernests Gulbis,7-5; 7-6(1),R32,97,4,1,43,68,36,43,14,25,1,3,12,50,68,7,0,50,76,35,50,11,26,1,4,12,46,76
2014-04-21 00:00:00.000,Barcelona Spain ATP World Tour 500,CLAY,2,Inigo Cervantes,Dmitry Tursunov,Inigo Cervantes,5-7; 6-0; 6-3,R32,103,2,2,37,72,29,37,14,35,3,7,13,43,72,3,2,51,79,31,51,5,28,1,9,14,36,79
2014-04-21 00:00:00.000,Barcelona Spain ATP World Tour 500,CLAY,2,Teymuraz Gabashvili,David Ferrer,Teymuraz Gabashvili,6-4; 6-2,R32,81,1,2,33,65,22,33,19,32,7,8,9,41,65,0,4,32,52,19,32,7,20,4,8,9,26,52
2014-04-21 00:00:00.000,Barcelona Spain ATP World Tour 500,CLAY,2,Rafael Nadal,Ivan Dodig,Rafael Nadal,6-3; 6-3,R16,84,1,0,36,48,25,36,9,12,0,1,9,34,48,5,3,32,57,21,32,9,25,4,8,9,30,57
2014-04-21 00:00:00.000,Barcelona Spain ATP World Tour 500,CLAY,2,Nicolas Almagro,Fernando Verdasco,Nicolas Almagro,6-3; 6-3,R16,73,4,0,23,48,20,23,15,25,3,4,9,35,48,2,2,50,64,27,50,7,14,5,9,9,34,64
2014-04-21 00:00:00.000,Barcelona Spain ATP World Tour 500,CLAY,2,Santiago Giraldo,Dominic Thiem,Santiago Giraldo,4-6; 6-4; 7-5,R16,147,4,1,82,119,55,82,19,37,18,21,16,74,119,4,6,67,110,44,67,20,43,10,14,16,64,110
2014-04-21 00:00:00.000,Barcelona Spain ATP World Tour 500,CLAY,2,Philipp Kohlschreiber,Jurgen Melzer,Philipp Kohlschreiber,7-5; 6-3,R16,86,3,1,37,62,27,37,17,25,2,2,10,44,62,2,3,52,80,35,52,12,28,4,7,11,47,80
2014-04-21 00:00:00.000,Barcelona Spain ATP World Tour 500,CLAY,2,Marin Cilic,Tommy Robredo,Marin Cilic,7-5; 6-7(3); 7-6(5),R16,167,8,2,61,117,46,61,34,56,5,6,18,80,117,2,3,81,113,59,81,18,32,3,5,18,77,113
2014-04-21 00:00:00.000,Barcelona Spain ATP World Tour 500,CLAY,2,Kei Nishikori,Andrey Golubev,Kei Nishikori,6-0; 6-4,R16,76,3,2,42,59,26,42,8,17,4,6,8,34,59,0,2,34,55,14,34,9,21,6,12,8,23,55
2014-04-21 00:00:00.000,Barcelona Spain ATP World Tour 500,CLAY,2,Ernests Gulbis,Albert Montanes,Ernests Gulbis,7-5; 6-1,R16,75,6,1,36,51,28,36,9,15,0,1,10,37,51,0,3,37,66,24,37,11,29,2,6,9,35,66
2014-04-21 00:00:00.000,Barcelona Spain ATP World Tour 500,CLAY,2,Teymuraz Gabashvili,Inigo Cervantes,Teymuraz Gabashvili,6-4; 6-2,R16,80,1,1,26,51,23,26,13,25,1,2,9,36,51,4,3,31,55,21,31,9,24,2,6,9,30,55
2014-04-21 00:00:00.000,Barcelona Spain ATP World Tour 500,CLAY,2,Nicolas Almagro,Rafael Nadal,Nicolas Almagro,2-6; 7-6(5); 6-4,Q,167,4,2,65,121,43,65,25,56,13,18,15,68,121,2,4,61,91,43,61,14,30,3,7,15,57,91
2014-04-21 00:00:00.000,Barcelona Spain ATP World Tour 500,CLAY,2,Santiago Giraldo,Philipp Kohlschreiber,Santiago Giraldo,6-4; 4-3 RET,Q,67,4,0,34,54,23,34,11,20,1,3,9,34,54,3,1,26,47,18,26,9,21,1,4,8,27,47
2014-04-21 00:00:00.000,Barcelona Spain ATP World Tour 500,CLAY,2,Kei Nishikori,Marin Cilic,Kei Nishikori,6-1; 6-3,Q,71,2,2,29,47,22,29,9,18,1,2,8,31,47,5,2,25,53,17,25,7,28,3,8,8,24,53
2014-04-21 00:00:00.000,Barcelona Spain ATP World Tour 500,CLAY,2,Ernests Gulbis,Teymuraz Gabashvili,Ernests Gulbis,6-1; 6-4,Q,88,1,0,38,54,28,38,11,16,5,5,9,39,54,0,3,45,71,28,45,9,26,5,8,8,37,71
2014-04-21 00:00:00.000,Barcelona Spain ATP World Tour 500,CLAY,2,Santiago Giraldo,Nicolas Almagro,Santiago Giraldo,7-5; 6-3,S,86,7,0,52,75,40,52,11,23,6,7,11,51,75,5,4,37,56,25,37,10,19,2,5,10,35,56
2014-04-21 00:00:00.000,Barcelona Spain ATP World Tour 500,CLAY,2,Kei Nishikori,Ernests Gulbis,Kei Nishikori,6-2; 6-4,S,86,1,3,31,50,25,31,12,19,0,0,9,37,50,5,2,39,66,25,39,12,27,7,10,9,37,66
2014-04-21 00:00:00.000,Barcelona Spain ATP World Tour 500,CLAY,2,Kei Nishikori,Santiago Giraldo,Kei Nishikori,6-2; 6-2,F,73,2,1,28,53,21,28,13,25,1,2,8,34,53,2,5,25,53,17,25,7,28,2,7,8,24,53
2014-04-21 00:00:00.000,Bucharest Romania ATP World Tour 250,CLAY,2,Grigor Dimitrov,N/A Bye,Grigor Dimitrov,,R32,0,0,0,0,0,0,0,0,0,0,0,0,0,0,0,0,0,0,0,0,0,0,0,0,0,0,0
2014-04-21 00:00:00.000,Bucharest Romania ATP World Tour 250,CLAY,2,Jiri Vesely,Jeremy Chardy,Jiri Vesely,7-6(3); 6-0,R32,89,4,0,38,54,32,38,9,16,1,1,9,41,54,2,5,51,83,29,51,16,32,7,10,9,45,83
2014-04-21 00:00:00.000,Bucharest Romania ATP World Tour 250,CLAY,2,Sergiy Stakhovsky,Patrick Ciorcila,Sergiy Stakhovsky,2-6; 6-2; 6-1,R32,92,1,3,55,74,40,55,8,19,5,7,12,48,74,0,0,45,69,25,45,15,24,4,8,11,40,69
2014-04-21 00:00:00.000,Bucharest Romania ATP World Tour 250,CLAY,2,Carlos Berlocq,Andreas Seppi,Carlos Berlocq,6-0; 2-6; 7-6(4),R32,151,2,1,72,84,42,72,4,12,5,10,13,46,84,1,0,73,106,42,73,14,33,13,19,13,56,106
2014-04-21 00:00:00.000,Bucharest Romania ATP World Tour 250,CLAY,2,Gael Monfils,N/A Bye,Gael Monfils,,R32,0,0,0,0,0,0,0,0,0,0,0,0,0,0,0,0,0,0,0,0,0,0,0,0,0,0,0
2014-04-21 00:00:00.000,Bucharest Romania ATP World Tour 250,CLAY,2,Ricardas Berankis,Nikoloz Basilashvili,Ricardas Berankis,6-7(2); 6-3; 6-4,R32,131,3,1,64,106,47,64,19,42,6,8,16,66,106,4,5,61,103,42,61,19,42,4,8,15,61,103
2014-04-21 00:00:00.000,Bucharest Romania ATP World Tour 250,CLAY,2,Marius Copil,Adrian Mannarino,Marius Copil,6-1; 6-4,R32,64,11,1,46,60,31,46,9,14,3,3,9,40,60,0,1,29,45,20,29,7,16,3,6,8,27,45
2014-04-21 00:00:00.000,Bucharest Romania ATP World Tour 250,CLAY,2,Paul-Henri Mathieu,Nicolas Mahut,Paul-Henri Mathieu,6-3; 6-1,R32,83,1,0,26,47,17,26,15,21,1,2,8,32,47,3,1,36,58,21,36,6,22,2,7,8,27,58
2014-04-21 00:00:00.000,Bucharest Romania ATP World Tour 250,CLAY,2,Jarkko Nieminen,Leonardo Mayer,Jarkko Nieminen,6-3; 3-6; 7-6(4),R32,137,2,2,68,98,49,68,13,30,8,11,15,62,98,9,8,54,103,39,54,24,49,6,9,15,63,103
2014-04-21 00:00:00.000,Bucharest Romania ATP World Tour 250,CLAY,2,Lukas Rosol,Filippo Volandri,Lukas Rosol,6-1; 7-6(6),R32,67,8,1,39,61,30,39,13,22,1,2,10,43,61,0,1,45,58,29,45,4,13,1,4,9,33,58
2014-04-21 00:00:00.000,Bucharest Romania ATP World Tour 250,CLAY,2,Victor Hanescu,Dudi Sela,Victor Hanescu,6-3; 6-4,R32,75,1,0,46,61,34,46,6,15,4,5,10,40,61,1,2,34,57,21,34,12,23,2,5,9,33,57
2014-04-21 00:00:00.000,Bucharest Romania ATP World Tour 250,CLAY,2,Gilles Simon,N/A Bye,Gilles Simon,,R32,0,0,0,0,0,0,0,0,0,0,0,0,0,0,0,0,0,0,0,0,0,0,0,0,0,0,0
2014-04-21 00:00:00.000,Bucharest Romania ATP World Tour 250,CLAY,2,Adrian Ungur,Vasek Pospisil,Adrian Ungur,5-7; 6-2; 6-1,R32,113,1,2,48,76,34,48,15,28,4,7,13,49,76,3,3,56,95,33,56,15,39,10,17,14,48,95
2014-04-21 00:00:00.000,Bucharest Romania ATP World Tour 250,CLAY,2,Denis Istomin,Thomaz Bellucci,Denis Istomin,7-6(6); 7-6(6),R32,124,6,3,58,84,42,58,14,26,4,6,12,56,84,1,3,40,74,32,40,20,34,0,2,12,52,74
2014-04-21 00:00:00.000,Bucharest Romania ATP World Tour 250,CLAY,2,Robin Haase,Matthew Ebden,Robin Haase,6-4; 6-3,R32,84,4,2,34,59,22,34,12,25,4,7,9,34,59,3,5,48,69,27,48,5,21,2,8,10,32,69
2014-04-21 00:00:00.000,Bucharest Romania ATP World Tour 250,CLAY,2,Mikhail Youzhny,N/A Bye,Mikhail Youzhny,,R32,0,0,0,0,0,0,0,0,0,0,0,0,0,0,0,0,0,0,0,0,0,0,0,0,0,0,0
2014-04-21 00:00:00.000,Bucharest Romania ATP World Tour 250,CLAY,2,Grigor Dimitrov,Jiri Vesely,Grigor Dimitrov,7-6(5); 6-2,R16,83,9,0,45,60,34,45,11,15,1,1,10,45,60,5,1,39,58,26,39,13,19,6,8,10,39,58
2014-04-21 00:00:00.000,Bucharest Romania ATP World Tour 250,CLAY,2,Sergiy Stakhovsky,Carlos Berlocq,Sergiy Stakhovsky,4-6; 7-6(5); 6-2,R16,142,3,3,74,100,52,74,12,26,3,6,15,64,100,1,1,59,97,39,59,20,38,2,6,15,59,97
2014-04-21 00:00:00.000,Bucharest Romania ATP World Tour 250,CLAY,2,Gael Monfils,Ricardas Berankis,Gael Monfils,6-1; 6-3,R16,59,7,1,43,61,32,43,9,18,5,5,8,41,61,0,0,23,42,11,23,9,19,1,5,8,20,42
2014-04-21 00:00:00.000,Bucharest Romania ATP World Tour 250,CLAY,2,Paul-Henri Mathieu,Marius Copil,Paul-Henri Mathieu,6-3; 6-2,R16,70,0,0,38,52,29,38,9,14,2,2,9,38,52,3,3,35,54,21,35,8,19,3,6,8,29,54
2014-04-21 00:00:00.000,Bucharest Romania ATP World Tour 250,CLAY,2,Lukas Rosol,Jarkko Nieminen,Lukas Rosol,6-2; 6-4,R16,69,4,3,38,64,29,38,12,26,7,8,9,41,64,0,3,38,56,19,38,10,18,2,6,9,29,56
2014-04-21 00:00:00.000,Bucharest Romania ATP World Tour 250,CLAY,2,Gilles Simon,Victor Hanescu,Gilles Simon,2-6; 6-3; 6-3,R16,124,5,3,48,88,37,48,17,40,3,5,13,54,88,1,1,70,91,48,70,6,21,5,8,13,54,91
2014-04-21 00:00:00.000,Bucharest Romania ATP World Tour 250,CLAY,2,Denis Istomin,Adrian Ungur,Denis Istomin,4-6; 6-0; 6-3,R16,104,3,0,54,77,43,54,12,23,2,3,13,55,77,1,2,57,80,36,57,11,23,2,6,12,47,80
2014-04-21 00:00:00.000,Bucharest Romania ATP World Tour 250,CLAY,2,Robin Haase,Mikhail Youzhny,Robin Haase,6-3; 6-3,R16,69,3,2,25,49,20,25,16,24,1,2,9,36,49,0,5,31,52,20,31,8,21,1,5,9,28,52
2014-04-21 00:00:00.000,Bucharest Romania ATP World Tour 250,CLAY,2,Grigor Dimitrov,Sergiy Stakhovsky,Grigor Dimitrov,6-3; 6-4,Q,68,2,2,35,55,28,35,12,20,1,2,10,40,55,0,1,33,52,21,33,9,19,3,6,9,30,52
2014-04-21 00:00:00.000,Bucharest Romania ATP World Tour 250,CLAY,2,Gael Monfils,Paul-Henri Mathieu,Gael Monfils,3-6; 7-6(8); 6-2,Q,141,5,3,66,100,48,66,16,34,5,7,14,64,100,1,1,77,106,51,77,13,29,10,13,15,64,106
2014-04-21 00:00:00.000,Bucharest Romania ATP World Tour 250,CLAY,2,Lukas Rosol,Gilles Simon,Lukas Rosol,7-6(2); 6-2,Q,99,3,2,45,73,30,45,15,28,2,5,10,45,73,3,3,60,93,40,60,7,33,7,12,10,47,93
2014-04-21 00:00:00.000,Bucharest Romania ATP World Tour 250,CLAY,2,Robin Haase,Denis Istomin,Robin Haase,3-6; 6-1; 6-3,Q,97,1,2,44,73,34,44,15,29,4,6,12,49,73,3,1,51,74,36,51,7,23,6,11,13,43,74
2014-04-21 00:00:00.000,Bucharest Romania ATP World Tour 250,CLAY,2,Grigor Dimitrov,Gael Monfils,Grigor Dimitrov,5-1 RET,S,16,2,2,11,15,11,11,1,4,0,0,3,12,15,0,0,11,15,5,11,1,4,0,2,3,6,15
2014-04-21 00:00:00.000,Bucharest Romania ATP World Tour 250,CLAY,2,Lukas Rosol,Robin Haase,Lukas Rosol,3-6; 6-3; 6-2,S,106,4,1,51,80,29,51,21,29,3,6,13,50,80,5,2,53,84,34,53,13,31,2,7,13,47,84
2014-04-21 00:00:00.000,Bucharest Romania ATP World Tour 250,CLAY,2,Grigor Dimitrov,Lukas Rosol,Grigor Dimitrov,7-6(2); 6-1,F,81,4,1,31,53,26,31,12,22,1,2,9,38,53,1,0,49,79,29,49,12,30,5,9,10,41,79
2014-04-28 00:00:00.000,Munich Germany ATP World Tour 250,CLAY,2,Fabio Fognini,N/A Bye,Fabio Fognini,,R32,0,0,0,0,0,0,0,0,0,0,0,0,0,0,0,0,0,0,0,0,0,0,0,0,0,0,0
2014-04-28 00:00:00.000,Munich Germany ATP World Tour 250,CLAY,2,Dustin Brown,Ivo Karlovic,Dustin Brown,7-6(4); 7-6(5),R32,87,3,1,49,74,40,49,19,25,1,1,12,59,74,11,0,55,80,42,55,17,25,1,1,12,59,80
2014-04-28 00:00:00.000,Munich Germany ATP World Tour 250,CLAY,2,Federico Delbonis,Nikolay Davydenko,Federico Delbonis,6-2; 7-6(4),R32,93,1,0,45,56,39,45,7,11,0,0,10,46,56,6,1,53,87,37,53,16,34,7,9,10,53,87
2014-04-28 00:00:00.000,Munich Germany ATP World Tour 250,CLAY,2,Thomaz Bellucci,Ivan Dodig,Thomaz Bellucci,7-6(0); 6-4,R32,102,2,3,43,77,34,43,18,34,5,6,11,52,77,4,3,32,70,24,32,18,38,1,3,11,42,70
2014-04-28 00:00:00.000,Munich Germany ATP World Tour 250,CLAY,2,Ricardas Berankis,N/A Bye,Ricardas Berankis,,R32,0,0,0,0,0,0,0,0,0,0,0,0,0,0,0,0,0,0,0,0,0,0,0,0,0,0,0
2014-04-28 00:00:00.000,Munich Germany ATP World Tour 250,CLAY,2,Jurgen Melzer,Alexander Zverev,Jurgen Melzer,6-1; 6-2,R32,63,2,4,30,47,24,30,9,17,6,7,8,33,47,1,1,20,44,9,20,8,24,2,7,7,17,44
2014-04-28 00:00:00.000,Munich Germany ATP World Tour 250,CLAY,2,Sergiy Stakhovsky,Peter Gojowczyk,Sergiy Stakhovsky,3-6; 6-4; 6-1,R32,87,6,2,52,75,37,52,11,23,4,6,13,48,75,11,4,48,84,35,48,15,36,5,9,13,50,84
2014-04-28 00:00:00.000,Munich Germany ATP World Tour 250,CLAY,2,Jan-Lennard Struff,Feliciano Lopez,Jan-Lennard Struff,6-3; 6-4,R32,79,5,0,29,58,24,29,18,29,3,3,10,42,58,6,2,45,60,28,45,6,15,5,7,9,34,60
2014-04-28 00:00:00.000,Munich Germany ATP World Tour 250,CLAY,2,Denis Istomin,Philipp Kohlschreiber,Denis Istomin,7-5; 2-6; 6-4,R32,123,7,1,74,97,50,74,12,23,11,14,15,62,97,5,0,54,86,35,54,21,32,4,7,15,56,86
2014-04-28 00:00:00.000,Munich Germany ATP World Tour 250,CLAY,2,Marinko Matosevic,Michal Przysiezny,Marinko Matosevic,2-6; 6-5 RET,R32,88,5,2,38,65,25,38,11,27,7,11,9,36,65,4,0,36,58,25,36,9,22,1,4,10,34,58
2014-04-28 00:00:00.000,Munich Germany ATP World Tour 250,CLAY,2,Martin Klizan,Dudi Sela,Martin Klizan,6-1; 6-2,R32,52,5,1,24,46,19,24,13,22,3,4,8,32,46,1,2,16,39,10,16,7,23,4,9,7,17,39
2014-04-28 00:00:00.000,Munich Germany ATP World Tour 250,CLAY,2,Mikhail Youzhny,N/A Bye,Mikhail Youzhny,,R32,0,0,0,0,0,0,0,0,0,0,0,0,0,0,0,0,0,0,0,0,0,0,0,0,0,0,0
2014-04-28 00:00:00.000,Munich Germany ATP World Tour 250,CLAY,2,Andreas Seppi,Michael Berrer,Andreas Seppi,6-3; 7-5,R32,84,3,2,40,62,27,40,17,22,0,1,11,44,62,4,1,57,78,37,57,6,21,6,9,10,43,78
2014-04-28 00:00:00.000,Munich Germany ATP World Tour 250,CLAY,2,Albert Ramos-Vinolas,Lleyton Hewitt,Albert Ramos-Vinolas,6-7(6); 6-1; 6-0,R32,137,4,2,62,91,43,62,16,29,3,4,13,59,91,6,6,46,86,31,46,14,40,3,9,12,45,86
2014-04-28 00:00:00.000,Munich Germany ATP World Tour 250,CLAY,2,Alejandro Falla,Jarkko Nieminen,Alejandro Falla,6-2; 6-1,R32,52,2,0,22,40,17,22,9,18,3,4,7,26,40,0,3,26,48,13,26,6,22,4,10,8,19,48
2014-04-28 00:00:00.000,Munich Germany ATP World Tour 250,CLAY,2,Tommy Haas,N/A Bye,Tommy Haas,,R32,0,0,0,0,0,0,0,0,0,0,0,0,0,0,0,0,0,0,0,0,0,0,0,0,0,0,0
2014-04-28 00:00:00.000,Munich Germany ATP World Tour 250,CLAY,2,Fabio Fognini,Dustin Brown,Fabio Fognini,7-6(4); 6-2,R16,65,2,1,37,54,27,37,11,17,1,3,10,38,54,4,3,48,72,31,48,9,24,3,7,10,40,72
2014-04-28 00:00:00.000,Munich Germany ATP World Tour 250,CLAY,2,Thomaz Bellucci,Federico Delbonis,Thomaz Bellucci,5-7; 6-3; 6-2,R16,127,7,2,59,104,40,59,25,45,5,7,15,65,104,3,4,64,94,42,64,15,30,10,14,14,57,94
2014-04-28 00:00:00.000,Munich Germany ATP World Tour 250,CLAY,2,Ricardas Berankis,Jurgen Melzer,Ricardas Berankis,7-6(5); 3-6; 7-6(6),R16,146,3,1,67,114,48,67,21,47,5,10,16,69,114,9,1,72,116,50,72,23,44,5,9,17,73,116
2014-04-28 00:00:00.000,Munich Germany ATP World Tour 250,CLAY,2,Jan-Lennard Struff,Sergiy Stakhovsky,Jan-Lennard Struff,6-3; 6-3,R16,73,1,0,43,62,30,43,12,19,6,6,9,42,62,3,2,52,63,35,52,2,11,8,11,9,37,63
2014-04-28 00:00:00.000,Munich Germany ATP World Tour 250,CLAY,2,Denis Istomin,Marinko Matosevic,Denis Istomin,6-7(6); 6-3; 7-5,R16,131,8,1,78,99,58,78,11,21,5,6,16,69,99,11,2,62,104,46,62,21,42,3,7,17,67,104
2014-04-28 00:00:00.000,Munich Germany ATP World Tour 250,CLAY,2,Martin Klizan,Mikhail Youzhny,Martin Klizan,6-7(5); 6-2; 7-6(2),R16,170,10,1,71,106,51,71,20,35,4,7,16,71,106,5,2,66,114,41,66,26,48,7,12,16,67,114
2014-04-28 00:00:00.000,Munich Germany ATP World Tour 250,CLAY,2,Andreas Seppi,Albert Ramos-Vinolas,Andreas Seppi,6-3; 6-4,R16,87,3,0,46,66,31,46,6,20,9,12,9,37,66,4,0,44,57,20,44,5,13,5,11,10,25,57
2014-04-28 00:00:00.000,Munich Germany ATP World Tour 250,CLAY,2,Tommy Haas,Alejandro Falla,Tommy Haas,6-2; 6-4,R16,74,4,1,44,65,31,44,10,21,5,7,9,41,65,1,2,36,56,22,36,6,20,2,7,9,28,56
2014-04-28 00:00:00.000,Munich Germany ATP World Tour 250,CLAY,2,Fabio Fognini,Thomaz Bellucci,Fabio Fognini,6-2; 6-2,Q,69,2,0,32,44,18,32,7,12,1,4,8,25,44,5,3,41,56,19,41,3,15,2,9,8,22,56
2014-04-28 00:00:00.000,Munich Germany ATP World Tour 250,CLAY,2,Jan-Lennard Struff,Ricardas Berankis,Jan-Lennard Struff,4-6; 6-3; 6-4,Q,120,12,2,60,107,47,60,23,47,9,10,15,70,107,2,0,39,77,30,39,24,38,1,3,14,54,77
2014-04-28 00:00:00.000,Munich Germany ATP World Tour 250,CLAY,2,Martin Klizan,Denis Istomin,Martin Klizan,7-6(3); 1-6; 6-1,Q,109,3,0,55,88,42,55,14,33,3,6,13,56,88,2,1,57,76,41,57,11,19,2,5,13,52,76
2014-04-28 00:00:00.000,Munich Germany ATP World Tour 250,CLAY,2,Tommy Haas,Andreas Seppi,Tommy Haas,6-3; 3-6; 6-3,Q,116,3,0,55,84,38,55,17,29,3,5,14,55,84,8,2,55,98,38,55,23,43,4,7,13,61,98
2014-04-28 00:00:00.000,Munich Germany ATP World Tour 250,CLAY,2,Fabio Fognini,Jan-Lennard Struff,Fabio Fognini,6-3; 6-1,S,63,2,1,33,48,25,33,9,15,1,1,8,34,48,0,0,34,53,21,34,6,19,7,11,8,27,53
2014-04-28 00:00:00.000,Munich Germany ATP World Tour 250,CLAY,2,Martin Klizan,Tommy Haas,Martin Klizan,6-3; 6-2,S,64,7,1,24,46,20,24,12,22,2,3,8,32,46,1,1,44,61,20,44,8,17,5,10,9,28,61
2014-04-28 00:00:00.000,Munich Germany ATP World Tour 250,CLAY,2,Martin Klizan,Fabio Fognini,Martin Klizan,2-6; 6-1; 6-2,F,89,5,5,42,74,30,42,14,32,4,7,12,44,74,4,1,40,60,25,40,9,20,0,5,11,34,60
2014-04-28 00:00:00.000,Oeiras Portugal ATP World Tour 250,CLAY,2,Tomas Berdych,N/A Bye,Tomas Berdych,,R32,0,0,0,0,0,0,0,0,0,0,0,0,0,0,0,0,0,0,0,0,0,0,0,0,0,0,0
2014-04-28 00:00:00.000,Oeiras Portugal ATP World Tour 250,CLAY,2,Somdev Devvarman,Matthew Ebden,Somdev Devvarman,6-2; 6-3,R32,73,3,0,22,49,14,22,19,27,3,4,8,33,49,3,5,37,60,22,37,7,23,3,8,9,29,60
2014-04-28 00:00:00.000,Oeiras Portugal ATP World Tour 250,CLAY,2,Andrey Golubev,Adrian Mannarino,Andrey Golubev,6-3; 3-6; 6-4,R32,123,2,6,46,85,30,46,21,39,3,8,14,51,85,1,5,48,85,28,48,15,37,1,7,14,43,85
2014-04-28 00:00:00.000,Oeiras Portugal ATP World Tour 250,CLAY,2,Leonardo Mayer,Joao Sousa,Leonardo Mayer,3-6; 6-1; 6-2,R32,118,5,10,43,85,35,43,19,42,7,9,12,54,85,2,5,44,84,34,44,12,40,9,14,12,46,84
2014-04-28 00:00:00.000,Oeiras Portugal ATP World Tour 250,CLAY,2,Guillermo Garcia-Lopez,N/A Bye,Guillermo Garcia-Lopez,,R32,0,0,0,0,0,0,0,0,0,0,0,0,0,0,0,0,0,0,0,0,0,0,0,0,0,0,0
2014-04-28 00:00:00.000,Oeiras Portugal ATP World Tour 250,CLAY,2,Gastao Elias,Filippo Volandri,Gastao Elias,6-4; 6-3,R32,105,8,4,35,75,22,35,22,40,7,9,9,44,75,1,5,72,111,37,72,18,39,16,21,10,55,111
2014-04-28 00:00:00.000,Oeiras Portugal ATP World Tour 250,CLAY,2,Victor Hanescu,Radu Albot,Victor Hanescu,3-6; 6-4; 6-4,R32,126,3,4,63,91,39,63,12,28,7,12,14,51,91,0,4,78,98,44,78,6,20,6,12,15,50,98
2014-04-28 00:00:00.000,Oeiras Portugal ATP World Tour 250,CLAY,2,Pablo Carreno Busta,Mikhail Kukushkin,Pablo Carreno Busta,6-1; 7-6(3),R32,76,6,4,33,56,25,33,13,23,1,4,10,38,56,1,1,29,57,17,29,11,28,2,7,9,28,57
2014-04-28 00:00:00.000,Oeiras Portugal ATP World Tour 250,CLAY,2,Rui Machado,Dmitry Tursunov,Rui Machado,6-0; 6-0,R32,48,3,1,26,38,17,26,10,12,0,0,6,27,38,0,4,16,32,4,16,3,16,0,6,6,7,32
2014-04-28 00:00:00.000,Oeiras Portugal ATP World Tour 250,CLAY,2,Daniel Gimeno-Traver,Alejandro Gonzalez,Daniel Gimeno-Traver,6-4; 6-1,R32,70,4,4,36,63,28,36,13,27,2,3,9,41,63,0,0,37,54,20,37,7,17,8,12,8,27,54
2014-04-28 00:00:00.000,Oeiras Portugal ATP World Tour 250,CLAY,2,Albert Montanes,Roberto Carballes Baena,Albert Montanes,7-6(4); 6-3,R32,99,4,2,40,70,30,40,17,30,1,3,11,47,70,2,3,42,72,24,42,17,30,3,6,10,41,72
2014-04-28 00:00:00.000,Oeiras Portugal ATP World Tour 250,CLAY,2,Marcel Granollers,N/A Bye,Marcel Granollers,,R32,0,0,0,0,0,0,0,0,0,0,0,0,0,0,0,0,0,0,0,0,0,0,0,0,0,0,0
2014-04-28 00:00:00.000,Oeiras Portugal ATP World Tour 250,CLAY,2,Lukasz Kubot,Teymuraz Gabashvili,Lukasz Kubot,6-3; 7-5,R32,97,2,3,55,83,36,55,14,28,4,6,11,50,83,2,0,34,53,21,34,8,19,0,4,10,29,53
2014-04-28 00:00:00.000,Oeiras Portugal ATP World Tour 250,CLAY,2,Carlos Berlocq,Taro Daniel,Carlos Berlocq,6-3; 6-2,R32,82,8,2,32,53,23,32,8,21,2,5,8,31,53,0,3,31,51,11,31,8,20,4,11,9,19,51
2014-04-28 00:00:00.000,Oeiras Portugal ATP World Tour 250,CLAY,2,Pablo Cuevas,Aleksandr Nedovyesov,Pablo Cuevas,4-6; 6-3; 6-4,R32,113,3,1,44,79,28,44,23,35,3,7,15,51,79,4,1,57,86,33,57,16,29,3,8,14,49,86
2014-04-28 00:00:00.000,Oeiras Portugal ATP World Tour 250,CLAY,2,Milos Raonic,N/A Bye,Milos Raonic,,R32,0,0,0,0,0,0,0,0,0,0,0,0,0,0,0,0,0,0,0,0,0,0,0,0,0,0,0
2014-04-28 00:00:00.000,Oeiras Portugal ATP World Tour 250,CLAY,2,Tomas Berdych,Somdev Devvarman,Tomas Berdych,6-3; 6-2,R16,76,6,4,34,54,29,34,10,20,3,3,9,39,54,1,0,25,53,13,25,16,28,2,5,8,29,53
2014-04-28 00:00:00.000,Oeiras Portugal ATP World Tour 250,CLAY,2,Leonardo Mayer,Andrey Golubev,Leonardo Mayer,6-1; 7-6(3),R16,94,1,3,30,65,22,30,25,35,4,5,10,47,65,0,5,36,70,23,36,15,34,4,7,9,38,70
2014-04-28 00:00:00.000,Oeiras Portugal ATP World Tour 250,CLAY,2,Gastao Elias,Guillermo Garcia-Lopez,Gastao Elias,6-4; 3-6; 6-2,R16,124,2,4,36,83,27,36,23,47,2,5,13,50,83,0,2,61,84,37,61,12,23,2,7,14,49,84
2014-04-28 00:00:00.000,Oeiras Portugal ATP World Tour 250,CLAY,2,Victor Hanescu,Pablo Carreno Busta,Victor Hanescu,6-3; 4-6; 6-3,R16,129,2,2,59,88,38,59,18,29,5,8,14,56,88,1,6,38,82,25,38,23,44,7,12,14,48,82
2014-04-28 00:00:00.000,Oeiras Portugal ATP World Tour 250,CLAY,2,Daniel Gimeno-Traver,Rui Machado,Daniel Gimeno-Traver,6-3; 7-6(2),R16,97,7,4,38,80,31,38,22,42,5,6,11,53,80,1,3,45,67,30,45,10,22,2,4,10,40,67
2014-04-28 00:00:00.000,Oeiras Portugal ATP World Tour 250,CLAY,2,Marcel Granollers,Albert Montanes,Marcel Granollers,3-6; 7-6(5); 6-2,R16,139,6,2,50,99,37,50,25,49,7,10,15,62,99,1,9,63,102,40,63,22,39,4,7,14,62,102
2014-04-28 00:00:00.000,Oeiras Portugal ATP World Tour 250,CLAY,2,Carlos Berlocq,Lukasz Kubot,Carlos Berlocq,6-4; 6-3,R16,79,5,2,35,50,30,35,8,15,2,2,9,38,50,0,8,42,66,26,42,12,24,3,6,10,38,66
2014-04-28 00:00:00.000,Oeiras Portugal ATP World Tour 250,CLAY,2,Milos Raonic,Pablo Cuevas,Milos Raonic,6-3; 6-2,R16,68,6,5,27,47,23,27,13,20,0,0,9,36,47,0,3,25,48,16,25,10,23,5,8,8,26,48
2014-04-28 00:00:00.000,Oeiras Portugal ATP World Tour 250,CLAY,2,Tomas Berdych,Leonardo Mayer,Tomas Berdych,3-6; 6-4; 6-4,Q,129,5,2,52,86,38,52,13,34,1,6,14,51,86,7,5,58,91,40,58,12,33,6,12,15,52,91
2014-04-28 00:00:00.000,Oeiras Portugal ATP World Tour 250,CLAY,2,Victor Hanescu,Gastao Elias,Victor Hanescu,6-1; 7-5,Q,82,2,0,44,65,30,44,10,21,3,5,10,40,65,2,3,23,50,15,23,9,27,4,9,9,24,50
2014-04-28 00:00:00.000,Oeiras Portugal ATP World Tour 250,CLAY,2,Daniel Gimeno-Traver,Marcel Granollers,Daniel Gimeno-Traver,6-1; 6-2,Q,73,2,1,28,58,21,28,19,30,2,2,8,40,58,0,0,24,41,11,24,9,17,2,6,7,20,41
2014-04-28 00:00:00.000,Oeiras Portugal ATP World Tour 250,CLAY,2,Carlos Berlocq,Milos Raonic,Carlos Berlocq,7-5; 6-4,Q,86,2,2,42,57,31,42,8,15,1,3,11,39,57,6,6,37,65,28,37,11,28,2,6,11,39,65
2014-04-28 00:00:00.000,Oeiras Portugal ATP World Tour 250,CLAY,2,Tomas Berdych,Victor Hanescu,Tomas Berdych,6-2; 6-2,S,63,5,2,28,43,24,28,9,15,1,1,8,33,43,0,1,35,48,20,35,4,13,0,4,8,24,48
2014-04-28 00:00:00.000,Oeiras Portugal ATP World Tour 250,CLAY,2,Carlos Berlocq,Daniel Gimeno-Traver,Carlos Berlocq,7-6(6); 6-2,S,94,2,4,51,68,41,51,7,17,2,3,10,48,68,1,3,33,66,23,33,20,33,4,7,10,43,66
2014-04-28 00:00:00.000,Oeiras Portugal ATP World Tour 250,CLAY,2,Carlos Berlocq,Tomas Berdych,Carlos Berlocq,0-6; 7-5; 6-1,F,130,0,3,55,77,32,55,6,22,6,12,12,38,77,6,3,55,97,34,55,13,42,3,10,13,47,97
2014-05-04 00:00:00.000,ATP World Tour Masters 1000 Madrid Spain ATP World Tour Masters 1000,CLAY,2,Rafael Nadal,N/A Bye,Rafael Nadal,,R64,0,0,0,0,0,0,0,0,0,0,0,0,0,0,0,0,0,0,0,0,0,0,0,0,0,0,0
2014-05-04 00:00:00.000,ATP World Tour Masters 1000 Madrid Spain ATP World Tour Masters 1000,CLAY,2,Juan Monaco,Jurgen Melzer,Juan Monaco,6-4; 6-3,R64,68,2,0,34,48,24,34,9,14,1,2,9,33,48,2,2,44,61,26,44,10,17,3,7,10,36,61
2014-05-04 00:00:00.000,ATP World Tour Masters 1000 Madrid Spain ATP World Tour Masters 1000,CLAY,2,Jarkko Nieminen,Robin Haase,Jarkko Nieminen,6-3; 6-2,R64,61,1,1,38,56,31,38,6,18,3,4,9,37,56,4,4,25,45,16,25,6,20,1,5,8,22,45
2014-05-04 00:00:00.000,ATP World Tour Masters 1000 Madrid Spain ATP World Tour Masters 1000,CLAY,2,Igor Sijsling,Tommy Haas,Igor Sijsling,3-6; 6-1; 6-4,R64,94,6,1,56,81,39,56,12,25,9,12,13,51,81,4,0,53,76,36,53,6,23,3,8,13,42,76
2014-05-04 00:00:00.000,ATP World Tour Masters 1000 Madrid Spain ATP World Tour Masters 1000,CLAY,2,Grigor Dimitrov,Pablo Carreno Busta,Grigor Dimitrov,6-2; 6-4,R64,71,3,1,31,51,24,31,11,20,0,1,9,35,51,1,2,32,53,19,32,9,21,2,6,9,28,53
2014-05-04 00:00:00.000,ATP World Tour Masters 1000 Madrid Spain ATP World Tour Masters 1000,CLAY,2,Marius Copil,Marcel Granollers,Marius Copil,6-3; 6-4,R64,90,5,3,39,66,30,39,12,27,4,5,10,42,66,0,2,44,63,27,44,10,19,4,7,9,37,63
2014-05-04 00:00:00.000,ATP World Tour Masters 1000 Madrid Spain ATP World Tour Masters 1000,CLAY,2,Kevin Anderson,Radek Stepanek,Kevin Anderson,3-6; 6-3; 6-4,R64,114,10,1,54,79,36,54,17,25,1,3,14,53,79,6,0,43,80,35,43,18,37,3,6,14,53,80
2014-05-04 00:00:00.000,ATP World Tour Masters 1000 Madrid Spain ATP World Tour Masters 1000,CLAY,2,Tomas Berdych,N/A Bye,Tomas Berdych,,R64,0,0,0,0,0,0,0,0,0,0,0,0,0,0,0,0,0,0,0,0,0,0,0,0,0,0,0
2014-05-04 00:00:00.000,ATP World Tour Masters 1000 Madrid Spain ATP World Tour Masters 1000,CLAY,2,Lukasz Kubot,N/A Bye,Lukasz Kubot,,R64,0,0,0,0,0,0,0,0,0,0,0,0,0,0,0,0,0,0,0,0,0,0,0,0,0,0,0
2014-05-04 00:00:00.000,ATP World Tour Masters 1000 Madrid Spain ATP World Tour Masters 1000,CLAY,2,Gilles Simon,Benoit Paire,Gilles Simon,2-0 RET,R64,10,1,0,7,10,7,7,0,3,0,0,1,7,10,0,1,1,5,1,1,0,4,1,2,1,1,5
2014-05-04 00:00:00.000,ATP World Tour Masters 1000 Madrid Spain ATP World Tour Masters 1000,CLAY,2,Fernando Verdasco,Andreas Seppi,Fernando Verdasco,6-3; 7-6(3),R64,99,2,2,59,74,40,59,10,15,5,7,11,50,74,4,5,46,74,31,46,12,28,7,10,10,43,74
2014-05-04 00:00:00.000,ATP World Tour Masters 1000 Madrid Spain ATP World Tour Masters 1000,CLAY,2,Roberto Bautista Agut,Tommy Robredo,Roberto Bautista Agut,6-4; 6-4,R64,87,0,5,47,71,35,47,13,24,3,3,10,48,71,1,2,25,52,20,25,14,27,2,4,10,34,52
2014-05-04 00:00:00.000,ATP World Tour Masters 1000 Madrid Spain ATP World Tour Masters 1000,CLAY,2,Jo-Wilfried Tsonga,Edouard Roger-Vasselin,Jo-Wilfried Tsonga,6-3; 4-6; 6-3,R64,129,8,3,64,93,47,64,13,29,2,5,14,60,93,4,1,72,99,45,72,10,27,5,10,14,55,99
2014-05-04 00:00:00.000,ATP World Tour Masters 1000 Madrid Spain ATP World Tour Masters 1000,CLAY,2,Santiago Giraldo,Lleyton Hewitt,Santiago Giraldo,7-5; 4-6; 6-2,R64,145,4,1,49,84,35,49,23,35,2,4,15,58,84,7,3,60,101,42,60,20,41,10,14,15,62,101
2014-05-04 00:00:00.000,ATP World Tour Masters 1000 Madrid Spain ATP World Tour Masters 1000,CLAY,2,Nicolas Almagro,Andrey Golubev,Nicolas Almagro,6-3; 6-7(9); 7-6(4),R64,151,7,1,56,120,49,56,37,64,2,3,17,86,120,8,2,86,124,60,86,22,38,7,9,16,82,124
2014-05-04 00:00:00.000,ATP World Tour Masters 1000 Madrid Spain ATP World Tour Masters 1000,CLAY,2,Andy Murray,N/A Bye,Andy Murray,,R64,0,0,0,0,0,0,0,0,0,0,0,0,0,0,0,0,0,0,0,0,0,0,0,0,0,0,0
2014-05-04 00:00:00.000,ATP World Tour Masters 1000 Madrid Spain ATP World Tour Masters 1000,CLAY,2,Milos Raonic,N/A Bye,Milos Raonic,,R64,0,0,0,0,0,0,0,0,0,0,0,0,0,0,0,0,0,0,0,0,0,0,0,0,0,0,0
2014-05-04 00:00:00.000,ATP World Tour Masters 1000 Madrid Spain ATP World Tour Masters 1000,CLAY,2,Jeremy Chardy,Lukas Rosol,Jeremy Chardy,4-6; 6-3; 6-4,R64,100,12,0,47,80,41,47,20,33,4,5,15,61,80,7,2,61,94,42,61,18,33,7,9,14,60,94
2014-05-04 00:00:00.000,ATP World Tour Masters 1000 Madrid Spain ATP World Tour Masters 1000,CLAY,2,Guillermo Garcia-Lopez,Pablo Andujar,Guillermo Garcia-Lopez,6-2; 2-6; 6-2,R64,106,4,1,48,69,35,48,12,21,2,4,12,47,69,4,2,52,77,30,52,14,25,4,8,12,44,77
2014-05-04 00:00:00.000,ATP World Tour Masters 1000 Madrid Spain ATP World Tour Masters 1000,CLAY,2,Kei Nishikori,Ivan Dodig,Kei Nishikori,6-4; 6-4,R64,90,2,1,43,61,29,43,12,18,3,4,10,41,61,5,2,39,68,24,39,14,29,1,4,10,38,68
2014-05-04 00:00:00.000,ATP World Tour Masters 1000 Madrid Spain ATP World Tour Masters 1000,CLAY,2,Mikhail Youzhny,Benjamin Becker,Mikhail Youzhny,6-3; 6-4,R64,87,5,1,41,58,29,41,12,17,4,5,10,41,58,5,2,40,72,26,40,14,32,7,10,9,40,72
2014-05-04 00:00:00.000,ATP World Tour Masters 1000 Madrid Spain ATP World Tour Masters 1000,CLAY,2,Feliciano Lopez,Federico Delbonis,Feliciano Lopez,7-6(4); 4-6; 6-2,R64,127,18,2,69,105,53,69,19,36,13,14,15,72,105,4,1,63,85,50,63,11,22,2,4,15,61,85
2014-05-04 00:00:00.000,ATP World Tour Masters 1000 Madrid Spain ATP World Tour Masters 1000,CLAY,2,Dominic Thiem,Dmitry Tursunov,Dominic Thiem,6-4; 6-2,R64,66,6,1,27,54,22,27,17,27,1,1,9,39,54,4,2,35,55,26,35,6,20,2,5,9,32,55
2014-05-04 00:00:00.000,ATP World Tour Masters 1000 Madrid Spain ATP World Tour Masters 1000,CLAY,2,Stan Wawrinka,N/A Bye,Stan Wawrinka,,R64,0,0,0,0,0,0,0,0,0,0,0,0,0,0,0,0,0,0,0,0,0,0,0,0,0,0,0
2014-05-04 00:00:00.000,ATP World Tour Masters 1000 Madrid Spain ATP World Tour Masters 1000,CLAY,2,David Ferrer,N/A Bye,David Ferrer,,R64,0,0,0,0,0,0,0,0,0,0,0,0,0,0,0,0,0,0,0,0,0,0,0,0,0,0,0
2014-05-04 00:00:00.000,ATP World Tour Masters 1000 Madrid Spain ATP World Tour Masters 1000,CLAY,2,Albert Ramos-Vinolas,Nicolas Mahut,Albert Ramos-Vinolas,6-1; 7-6(7),R64,92,1,2,33,53,26,33,13,20,0,1,9,39,53,5,4,49,74,28,49,11,25,4,8,10,39,74
2014-05-04 00:00:00.000,ATP World Tour Masters 1000 Madrid Spain ATP World Tour Masters 1000,CLAY,2,Marinko Matosevic,Philipp Kohlschreiber,Marinko Matosevic,6-2; 6-2,R64,68,5,0,35,58,27,35,11,23,4,4,8,38,58,2,4,25,51,15,25,11,26,5,9,8,26,51
2014-05-04 00:00:00.000,ATP World Tour Masters 1000 Madrid Spain ATP World Tour Masters 1000,CLAY,2,John Isner,Teymuraz Gabashvili,John Isner,7-6(8); 6-4,R64,106,14,1,52,66,42,52,10,14,2,2,11,52,66,1,3,63,92,44,63,13,29,6,7,11,57,92
2014-05-04 00:00:00.000,ATP World Tour Masters 1000 Madrid Spain ATP World Tour Masters 1000,CLAY,2,Alexandr Dolgopolov,Fabio Fognini,Alexandr Dolgopolov,7-5; 4-6; 6-3,R64,125,7,0,45,88,36,45,24,43,4,7,16,60,88,2,3,66,100,46,66,17,34,3,7,15,63,100
2014-05-04 00:00:00.000,ATP World Tour Masters 1000 Madrid Spain ATP World Tour Masters 1000,CLAY,2,Ernests Gulbis,Jerzy Janowicz,Ernests Gulbis,7-6(5); 3-6; 6-2,R64,136,18,4,57,99,43,57,22,42,5,7,14,65,99,11,6,70,103,52,70,13,33,4,7,15,65,103
2014-05-04 00:00:00.000,ATP World Tour Masters 1000 Madrid Spain ATP World Tour Masters 1000,CLAY,2,Marin Cilic,Joao Sousa,Marin Cilic,6-1; 6-1,R64,54,7,4,20,38,18,20,12,18,1,1,7,30,38,1,0,22,42,9,22,8,20,2,7,7,17,42
2014-05-04 00:00:00.000,ATP World Tour Masters 1000 Madrid Spain ATP World Tour Masters 1000,CLAY,2,Paul-Henri Mathieu,N/A Bye,Paul-Henri Mathieu,,R64,0,0,0,0,0,0,0,0,0,0,0,0,0,0,0,0,0,0,0,0,0,0,0,0,0,0,0
2014-05-04 00:00:00.000,ATP World Tour Masters 1000 Madrid Spain ATP World Tour Masters 1000,CLAY,2,Rafael Nadal,Juan Monaco,Rafael Nadal,6-1; 6-0,R32,69,3,0,35,44,24,35,5,9,1,2,7,29,44,0,1,22,38,8,22,3,16,4,10,6,11,38
2014-05-04 00:00:00.000,ATP World Tour Masters 1000 Madrid Spain ATP World Tour Masters 1000,CLAY,2,Jarkko Nieminen,Igor Sijsling,Jarkko Nieminen,6-3; 6-2,R32,52,0,1,33,47,30,33,7,14,0,0,9,37,47,8,0,32,44,24,32,3,12,4,7,8,27,44
2014-05-04 00:00:00.000,ATP World Tour Masters 1000 Madrid Spain ATP World Tour Masters 1000,CLAY,2,Grigor Dimitrov,Marius Copil,Grigor Dimitrov,4-6; 6-3; 7-6(7),R32,131,6,4,61,101,49,61,24,40,3,4,16,73,101,10,1,56,97,40,56,25,41,3,4,15,65,97
2014-05-04 00:00:00.000,ATP World Tour Masters 1000 Madrid Spain ATP World Tour Masters 1000,CLAY,2,Tomas Berdych,Kevin Anderson,Tomas Berdych,6-1; 6-4,R32,70,5,1,28,45,24,28,12,17,0,0,9,36,45,5,0,44,58,27,44,4,14,7,10,8,31,58
2014-05-04 00:00:00.000,ATP World Tour Masters 1000 Madrid Spain ATP World Tour Masters 1000,CLAY,2,Lukasz Kubot,Gilles Simon,Lukasz Kubot,7-5; 2-6; 6-4,R32,147,6,4,66,107,44,66,21,41,11,14,15,65,107,12,2,69,102,46,69,17,33,10,13,15,63,102
2014-05-04 00:00:00.000,ATP World Tour Masters 1000 Madrid Spain ATP World Tour Masters 1000,CLAY,2,Roberto Bautista Agut,Fernando Verdasco,Roberto Bautista Agut,2-6; 7-6(4); 6-1,R32,121,5,0,62,86,43,62,13,24,4,7,14,56,86,1,1,60,78,38,60,12,18,0,3,13,50,78
2014-05-04 00:00:00.000,ATP World Tour Masters 1000 Madrid Spain ATP World Tour Masters 1000,CLAY,2,Santiago Giraldo,Jo-Wilfried Tsonga,Santiago Giraldo,6-4; 6-3,R32,69,2,1,35,49,27,35,10,14,1,1,9,37,49,4,0,40,55,27,40,8,15,0,3,10,35,55
2014-05-04 00:00:00.000,ATP World Tour Masters 1000 Madrid Spain ATP World Tour Masters 1000,CLAY,2,Andy Murray,Nicolas Almagro,Andy Murray,6-1; 1-6; 6-4,R32,107,5,0,38,72,28,38,18,34,4,7,12,46,72,8,4,31,72,23,31,22,41,2,6,12,45,72
2014-05-04 00:00:00.000,ATP World Tour Masters 1000 Madrid Spain ATP World Tour Masters 1000,CLAY,2,Milos Raonic,Jeremy Chardy,Milos Raonic,6-3; 6-3,R32,62,11,0,28,45,24,28,12,17,0,0,9,36,45,5,4,27,50,21,27,9,23,2,5,9,30,50
2014-05-04 00:00:00.000,ATP World Tour Masters 1000 Madrid Spain ATP World Tour Masters 1000,CLAY,2,Kei Nishikori,Guillermo Garcia-Lopez,Kei Nishikori,6-3; 6-1,R32,65,1,0,32,50,23,32,10,18,3,4,8,33,50,2,1,30,43,15,30,5,13,2,7,8,20,43
2014-05-04 00:00:00.000,ATP World Tour Masters 1000 Madrid Spain ATP World Tour Masters 1000,CLAY,2,Feliciano Lopez,Mikhail Youzhny,Feliciano Lopez,3-6; 6-3; 6-4,R32,139,11,2,51,88,39,51,21,37,9,10,14,60,88,3,1,69,104,45,69,21,35,8,10,14,66,104
2014-05-04 00:00:00.000,ATP World Tour Masters 1000 Madrid Spain ATP World Tour Masters 1000,CLAY,2,Dominic Thiem,Stan Wawrinka,Dominic Thiem,1-6; 6-2; 6-4,R32,105,1,1,51,85,40,51,14,34,9,11,12,54,85,7,0,47,71,32,47,14,24,3,6,13,46,71
2014-05-04 00:00:00.000,ATP World Tour Masters 1000 Madrid Spain ATP World Tour Masters 1000,CLAY,2,David Ferrer,Albert Ramos-Vinolas,David Ferrer,7-6(6); 5-7; 6-3,R32,170,1,3,70,106,47,70,17,36,2,7,17,64,106,2,3,72,108,46,72,15,36,7,12,16,61,108
2014-05-04 00:00:00.000,ATP World Tour Masters 1000 Madrid Spain ATP World Tour Masters 1000,CLAY,2,John Isner,Marinko Matosevic,John Isner,7-6(9); 6-7(5); 7-5,R32,158,23,3,88,125,70,88,21,37,1,1,18,91,125,4,3,86,115,66,86,17,29,5,6,18,83,115
2014-05-04 00:00:00.000,ATP World Tour Masters 1000 Madrid Spain ATP World Tour Masters 1000,CLAY,2,Ernests Gulbis,Alexandr Dolgopolov,Ernests Gulbis,6-3; 6-4,R32,77,4,2,40,60,31,40,11,20,6,7,10,42,60,2,1,33,56,22,33,12,23,6,9,9,34,56
2014-05-04 00:00:00.000,ATP World Tour Masters 1000 Madrid Spain ATP World Tour Masters 1000,CLAY,2,Marin Cilic,Paul-Henri Mathieu,Marin Cilic,6-4; 1-6; 6-2,R32,108,14,2,36,69,26,36,21,33,1,3,12,47,69,1,1,41,73,27,41,21,32,3,6,13,48,73
2014-05-04 00:00:00.000,ATP World Tour Masters 1000 Madrid Spain ATP World Tour Masters 1000,CLAY,2,Rafael Nadal,Jarkko Nieminen,Rafael Nadal,6-1; 6-4,R16,80,2,0,38,51,25,38,8,13,3,4,8,33,51,2,0,41,52,23,41,2,11,6,11,9,25,52
2014-05-04 00:00:00.000,ATP World Tour Masters 1000 Madrid Spain ATP World Tour Masters 1000,CLAY,2,Tomas Berdych,Grigor Dimitrov,Tomas Berdych,3-6; 6-3; 6-2,R16,110,7,1,46,78,34,46,19,32,3,4,13,53,78,12,2,46,74,33,46,16,28,4,7,13,49,74
2014-05-04 00:00:00.000,ATP World Tour Masters 1000 Madrid Spain ATP World Tour Masters 1000,CLAY,2,Roberto Bautista Agut,Lukasz Kubot,Roberto Bautista Agut,6-4; 6-2,R16,75,3,0,49,61,34,49,8,12,7,8,9,42,61,3,1,31,46,21,31,5,15,2,6,9,26,46
2014-05-04 00:00:00.000,ATP World Tour Masters 1000 Madrid Spain ATP World Tour Masters 1000,CLAY,2,Santiago Giraldo,Andy Murray,Santiago Giraldo,6-3; 6-2,R16,70,3,0,35,54,31,35,9,19,1,1,9,40,54,6,1,27,48,19,27,9,21,4,7,8,28,48
2014-05-04 00:00:00.000,ATP World Tour Masters 1000 Madrid Spain ATP World Tour Masters 1000,CLAY,2,Kei Nishikori,Milos Raonic,Kei Nishikori,7-6(5); 7-6(5),R16,126,9,1,60,91,44,60,20,31,6,7,12,64,91,12,3,52,84,40,52,18,32,5,6,12,58,84
2014-05-04 00:00:00.000,ATP World Tour Masters 1000 Madrid Spain ATP World Tour Masters 1000,CLAY,2,Feliciano Lopez,Dominic Thiem,Feliciano Lopez,W/O,R16,0,0,0,0,0,0,0,0,0,0,0,0,0,0,0,0,0,0,0,0,0,0,0,0,0,0,0
2014-05-04 00:00:00.000,ATP World Tour Masters 1000 Madrid Spain ATP World Tour Masters 1000,CLAY,2,David Ferrer,John Isner,David Ferrer,6-4; 6-4,R16,78,2,1,37,52,33,37,9,15,2,2,10,42,52,6,0,50,64,30,50,9,14,5,7,10,39,64
2014-05-04 00:00:00.000,ATP World Tour Masters 1000 Madrid Spain ATP World Tour Masters 1000,CLAY,2,Ernests Gulbis,Marin Cilic,Ernests Gulbis,6-3; 6-4,R16,87,11,3,45,64,38,45,7,19,1,1,10,45,64,9,3,22,59,19,22,17,37,3,5,9,36,59
2014-05-04 00:00:00.000,ATP World Tour Masters 1000 Madrid Spain ATP World Tour Masters 1000,CLAY,2,Rafael Nadal,Tomas Berdych,Rafael Nadal,6-4; 6-2,Q,88,4,0,41,54,32,41,7,13,1,1,9,39,54,0,1,39,55,23,39,9,16,2,5,9,32,55
2014-05-04 00:00:00.000,ATP World Tour Masters 1000 Madrid Spain ATP World Tour Masters 1000,CLAY,2,Roberto Bautista Agut,Santiago Giraldo,Roberto Bautista Agut,6-3; 6-4,Q,87,5,1,40,65,31,40,14,25,6,6,10,45,65,5,0,32,54,22,32,13,22,3,5,9,35,54
2014-05-04 00:00:00.000,ATP World Tour Masters 1000 Madrid Spain ATP World Tour Masters 1000,CLAY,2,Kei Nishikori,Feliciano Lopez,Kei Nishikori,6-4; 6-4,Q,91,1,0,35,62,25,35,20,27,3,3,10,45,62,9,1,51,68,36,51,4,17,7,9,10,40,68
2014-05-04 00:00:00.000,ATP World Tour Masters 1000 Madrid Spain ATP World Tour Masters 1000,CLAY,2,David Ferrer,Ernests Gulbis,David Ferrer,7-6(3); 6-3,Q,101,1,1,48,73,35,48,16,25,0,1,11,51,73,5,2,41,65,30,41,11,24,3,5,10,41,65
2014-05-04 00:00:00.000,ATP World Tour Masters 1000 Madrid Spain ATP World Tour Masters 1000,CLAY,2,Rafael Nadal,Roberto Bautista Agut,Rafael Nadal,6-4; 6-3,S,103,2,3,35,51,25,35,9,16,2,4,9,34,51,0,1,55,77,33,55,6,22,8,13,10,39,77
2014-05-04 00:00:00.000,ATP World Tour Masters 1000 Madrid Spain ATP World Tour Masters 1000,CLAY,2,Kei Nishikori,David Ferrer,Kei Nishikori,7-6(5); 5-7; 6-3,S,176,5,3,88,137,62,88,24,49,12,15,17,86,137,9,2,62,96,42,62,23,34,4,7,16,65,96
2014-05-04 00:00:00.000,ATP World Tour Masters 1000 Madrid Spain ATP World Tour Masters 1000,CLAY,2,Rafael Nadal,Kei Nishikori,Rafael Nadal,2-6; 6-4; 3-0 RET,F,103,4,2,43,55,31,43,7,12,3,6,11,38,55,2,3,38,65,25,38,13,27,6,9,10,38,65
2014-05-11 00:00:00.000,ATP World Tour Masters 1000 Rome Italy ATP World Tour Masters 1000,CLAY,2,Rafael Nadal,N/A Bye,Rafael Nadal,,R64,0,0,0,0,0,0,0,0,0,0,0,0,0,0,0,0,0,0,0,0,0,0,0,0,0,0,0
2014-05-11 00:00:00.000,ATP World Tour Masters 1000 Rome Italy ATP World Tour Masters 1000,CLAY,2,Gilles Simon,Filippo Volandri,Gilles Simon,6-2; 6-3,R64,71,3,1,29,57,22,29,12,28,2,4,9,34,57,0,0,30,46,14,30,6,16,2,7,8,20,46
2014-05-11 00:00:00.000,ATP World Tour Masters 1000 Rome Italy ATP World Tour Masters 1000,CLAY,2,Andrey Golubev,Fernando Verdasco,Andrey Golubev,6-4; 7-5,R64,94,2,2,46,68,30,46,10,22,1,5,11,40,68,0,2,44,63,24,44,7,19,2,8,11,31,63
2014-05-11 00:00:00.000,ATP World Tour Masters 1000 Rome Italy ATP World Tour Masters 1000,CLAY,2,Mikhail Youzhny,Nicolas Mahut,Mikhail Youzhny,6-4; 6-4,R64,90,1,1,30,48,26,30,14,18,0,0,10,40,48,1,0,51,73,31,51,14,22,6,8,10,45,73
2014-05-11 00:00:00.000,ATP World Tour Masters 1000 Rome Italy ATP World Tour Masters 1000,CLAY,2,Jurgen Melzer,John Isner,Jurgen Melzer,7-6(7); 6-3,R64,87,4,0,59,75,42,59,12,16,7,8,11,54,75,13,0,49,70,34,49,10,21,1,3,10,44,70
2014-05-11 00:00:00.000,ATP World Tour Masters 1000 Rome Italy ATP World Tour Masters 1000,CLAY,2,Marin Cilic,Santiago Giraldo,Marin Cilic,6-4; 2-0 RET,R64,68,3,0,20,30,16,20,6,10,0,1,6,22,30,1,0,38,48,19,38,5,10,2,5,6,24,48
2014-05-11 00:00:00.000,ATP World Tour Masters 1000 Rome Italy ATP World Tour Masters 1000,CLAY,2,Marcel Granollers,Feliciano Lopez,Marcel Granollers,7-5; 6-1,R64,82,2,2,31,54,26,31,12,23,0,1,10,38,54,1,0,38,55,24,38,6,17,5,9,9,30,55
2014-05-11 00:00:00.000,ATP World Tour Masters 1000 Rome Italy ATP World Tour Masters 1000,CLAY,2,Andy Murray,N/A Bye,Andy Murray,,R64,0,0,0,0,0,0,0,0,0,0,0,0,0,0,0,0,0,0,0,0,0,0,0,0,0,0,0
2014-05-11 00:00:00.000,ATP World Tour Masters 1000 Rome Italy ATP World Tour Masters 1000,CLAY,2,Stan Wawrinka,N/A Bye,Stan Wawrinka,,R64,0,0,0,0,0,0,0,0,0,0,0,0,0,0,0,0,0,0,0,0,0,0,0,0,0,0,0
2014-05-11 00:00:00.000,ATP World Tour Masters 1000 Rome Italy ATP World Tour Masters 1000,CLAY,2,Pere Riba,Paolo Lorenzi,Pere Riba,7-6(3); 6-3,R64,97,2,2,38,61,25,38,16,23,5,7,10,41,61,3,2,41,74,25,41,18,33,3,7,11,43,74
2014-05-11 00:00:00.000,ATP World Tour Masters 1000 Rome Italy ATP World Tour Masters 1000,CLAY,2,Igor Sijsling,Marco Cecchinato,Igor Sijsling,7-6(4); 7-5,R64,94,1,3,51,80,39,51,14,29,5,7,12,53,80,1,2,47,74,31,47,13,27,0,3,12,44,74
2014-05-11 00:00:00.000,ATP World Tour Masters 1000 Rome Italy ATP World Tour Masters 1000,CLAY,2,Tommy Haas,Andreas Seppi,Tommy Haas,6-1; 4-6; 6-3,R64,108,6,3,46,75,31,46,17,29,2,4,13,48,75,5,1,35,73,21,35,20,38,1,6,13,41,73
2014-05-11 00:00:00.000,ATP World Tour Masters 1000 Rome Italy ATP World Tour Masters 1000,CLAY,2,Grigor Dimitrov,Edouard Roger-Vasselin,Grigor Dimitrov,4-6; 6-3; 6-4,R64,127,9,7,53,96,39,53,24,43,5,7,15,63,96,2,3,61,89,43,61,12,28,6,9,14,55,89
2014-05-11 00:00:00.000,ATP World Tour Masters 1000 Rome Italy ATP World Tour Masters 1000,CLAY,2,Ivo Karlovic,Pablo Carreno Busta,Ivo Karlovic,3-6; 6-3; 7-6(4),R64,120,12,1,66,94,55,66,13,28,3,4,15,68,94,1,0,75,90,58,75,9,15,0,1,15,67,90
2014-05-11 00:00:00.000,ATP World Tour Masters 1000 Rome Italy ATP World Tour Masters 1000,CLAY,2,Dmitry Tursunov,Roberto Bautista Agut,Dmitry Tursunov,6-0; 7-6(4),R64,83,3,2,45,62,32,45,8,17,4,5,9,40,62,1,1,46,58,27,46,3,12,0,4,9,30,58
2014-05-11 00:00:00.000,ATP World Tour Masters 1000 Rome Italy ATP World Tour Masters 1000,CLAY,2,Tomas Berdych,N/A Bye,Tomas Berdych,,R64,0,0,0,0,0,0,0,0,0,0,0,0,0,0,0,0,0,0,0,0,0,0,0,0,0,0,0
2014-05-11 00:00:00.000,ATP World Tour Masters 1000 Rome Italy ATP World Tour Masters 1000,CLAY,2,Milos Raonic,N/A Bye,Milos Raonic,,R64,0,0,0,0,0,0,0,0,0,0,0,0,0,0,0,0,0,0,0,0,0,0,0,0,0,0,0
2014-05-11 00:00:00.000,ATP World Tour Masters 1000 Rome Italy ATP World Tour Masters 1000,CLAY,2,Simone Bolelli,Stefano Travaglia,Simone Bolelli,3-6; 7-5; 7-6(5),R64,142,2,0,64,86,44,64,16,22,0,4,16,60,86,9,4,78,136,48,78,32,58,10,14,17,80,136
2014-05-11 00:00:00.000,ATP World Tour Masters 1000 Rome Italy ATP World Tour Masters 1000,CLAY,2,Kevin Anderson,Vasek Pospisil,Kevin Anderson,7-5; 7-6(4),R64,94,7,2,45,69,39,45,15,24,0,0,12,54,69,3,3,41,70,28,41,23,29,0,1,12,51,70
2014-05-11 00:00:00.000,ATP World Tour Masters 1000 Rome Italy ATP World Tour Masters 1000,CLAY,2,Jo-Wilfried Tsonga,Alexandr Dolgopolov,Jo-Wilfried Tsonga,6-3; 7-6(5),R64,87,8,0,46,70,32,46,16,24,3,4,11,48,70,7,1,35,64,29,35,13,29,2,4,10,42,64
2014-05-11 00:00:00.000,ATP World Tour Masters 1000 Rome Italy ATP World Tour Masters 1000,CLAY,2,Lukas Rosol,Fabio Fognini,Lukas Rosol,6-3; 6-2,R64,67,2,0,29,50,24,29,13,21,0,0,9,37,50,2,1,33,55,19,33,12,22,2,5,8,31,55
2014-05-11 00:00:00.000,ATP World Tour Masters 1000 Rome Italy ATP World Tour Masters 1000,CLAY,2,Ivan Dodig,Federico Delbonis,Ivan Dodig,6-3; 6-4,R64,92,9,1,38,61,30,38,11,23,2,4,10,41,61,1,1,36,59,21,36,9,23,2,6,9,30,59
2014-05-11 00:00:00.000,ATP World Tour Masters 1000 Rome Italy ATP World Tour Masters 1000,CLAY,2,Jeremy Chardy,Robin Haase,Jeremy Chardy,6-4; 6-4,R64,85,9,0,34,55,29,34,12,21,2,2,10,41,55,1,0,36,69,24,36,16,33,4,6,10,40,69
2014-05-11 00:00:00.000,ATP World Tour Masters 1000 Rome Italy ATP World Tour Masters 1000,CLAY,2,Roger Federer,N/A Bye,Roger Federer,,R64,0,0,0,0,0,0,0,0,0,0,0,0,0,0,0,0,0,0,0,0,0,0,0,0,0,0,0
2014-05-11 00:00:00.000,ATP World Tour Masters 1000 Rome Italy ATP World Tour Masters 1000,CLAY,2,David Ferrer,N/A Bye,David Ferrer,,R64,0,0,0,0,0,0,0,0,0,0,0,0,0,0,0,0,0,0,0,0,0,0,0,0,0,0,0
2014-05-11 00:00:00.000,ATP World Tour Masters 1000 Rome Italy ATP World Tour Masters 1000,CLAY,2,Mikhail Kukushkin,Joao Sousa,Mikhail Kukushkin,6-3; 6-7(1); 6-3,R64,151,1,0,86,122,56,86,24,36,7,7,16,80,122,4,0,63,91,48,63,13,28,6,8,14,61,91
2014-05-11 00:00:00.000,ATP World Tour Masters 1000 Rome Italy ATP World Tour Masters 1000,CLAY,2,Stephane Robert,Alejandro Gonzalez,Stephane Robert,1-6; 6-4; 6-1,R64,96,7,2,47,72,35,47,13,25,1,3,12,48,72,5,1,53,77,34,53,13,24,2,5,12,47,77
2014-05-11 00:00:00.000,ATP World Tour Masters 1000 Rome Italy ATP World Tour Masters 1000,CLAY,2,Ernests Gulbis,Alejandro Falla,Ernests Gulbis,6-1 RET,R64,25,4,1,9,19,9,9,7,10,0,0,4,16,19,0,0,11,15,6,11,0,4,1,3,3,6,15
2014-05-11 00:00:00.000,ATP World Tour Masters 1000 Rome Italy ATP World Tour Masters 1000,CLAY,2,Tommy Robredo,Juan Monaco,Tommy Robredo,7-6(3); 6-4,R64,93,1,1,40,63,24,40,15,23,1,4,11,39,63,1,0,49,65,28,49,7,16,0,4,11,35,65
2014-05-11 00:00:00.000,ATP World Tour Masters 1000 Rome Italy ATP World Tour Masters 1000,CLAY,2,Philipp Kohlschreiber,Jerzy Janowicz,Philipp Kohlschreiber,4-6; 7-6(6); 6-2,R64,139,5,2,73,113,49,73,20,40,12,15,15,69,113,8,6,73,119,48,73,21,46,8,12,15,69,119
2014-05-11 00:00:00.000,ATP World Tour Masters 1000 Rome Italy ATP World Tour Masters 1000,CLAY,2,Radek Stepanek,Pablo Andujar,Radek Stepanek,5-7; 6-3; 6-4,R64,156,7,5,69,110,52,69,15,41,10,13,15,67,110,0,0,75,104,42,75,19,29,4,9,16,61,104
2014-05-11 00:00:00.000,ATP World Tour Masters 1000 Rome Italy ATP World Tour Masters 1000,CLAY,2,Novak Djokovic,N/A Bye,Novak Djokovic,,R64,0,0,0,0,0,0,0,0,0,0,0,0,0,0,0,0,0,0,0,0,0,0,0,0,0,0,0
2014-05-11 00:00:00.000,ATP World Tour Masters 1000 Rome Italy ATP World Tour Masters 1000,CLAY,2,Rafael Nadal,Gilles Simon,Rafael Nadal,7-6(1); 6-7(4); 6-2,R32,199,4,2,86,109,53,86,13,23,6,10,16,66,109,7,1,78,132,49,78,24,54,7,13,16,73,132
2014-05-11 00:00:00.000,ATP World Tour Masters 1000 Rome Italy ATP World Tour Masters 1000,CLAY,2,Mikhail Youzhny,Andrey Golubev,Mikhail Youzhny,7-5; 4-1 RET,R32,105,0,1,47,72,26,47,18,25,5,7,9,44,72,2,3,25,64,11,25,22,39,10,14,8,33,64
2014-05-11 00:00:00.000,ATP World Tour Masters 1000 Rome Italy ATP World Tour Masters 1000,CLAY,2,Jurgen Melzer,Marin Cilic,Jurgen Melzer,6-2; 6-7(5); 6-3,R32,142,4,0,67,94,50,67,14,27,1,2,15,64,94,7,3,55,94,35,55,21,39,6,10,14,56,94
2014-05-11 00:00:00.000,ATP World Tour Masters 1000 Rome Italy ATP World Tour Masters 1000,CLAY,2,Andy Murray,Marcel Granollers,Andy Murray,6-2; 7-5,R32,86,0,0,40,49,29,40,8,9,0,1,10,37,49,0,2,40,60,26,40,8,20,4,8,10,34,60
2014-05-11 00:00:00.000,ATP World Tour Masters 1000 Rome Italy ATP World Tour Masters 1000,CLAY,2,Stan Wawrinka,Pere Riba,Stan Wawrinka,6-0; 6-3,R32,51,3,0,25,41,24,25,9,16,1,1,8,33,41,2,0,34,45,18,34,4,11,5,9,7,22,45
2014-05-11 00:00:00.000,ATP World Tour Masters 1000 Rome Italy ATP World Tour Masters 1000,CLAY,2,Tommy Haas,Igor Sijsling,Tommy Haas,7-6(6); 6-1,R32,80,2,3,37,57,31,37,13,20,0,0,9,44,57,4,2,51,76,32,51,12,25,4,7,10,44,76
2014-05-11 00:00:00.000,ATP World Tour Masters 1000 Rome Italy ATP World Tour Masters 1000,CLAY,2,Grigor Dimitrov,Ivo Karlovic,Grigor Dimitrov,7-6(3); 6-4,R32,73,8,0,37,60,33,37,15,23,0,0,11,48,60,15,0,44,55,37,44,6,11,0,1,11,43,55
2014-05-11 00:00:00.000,ATP World Tour Masters 1000 Rome Italy ATP World Tour Masters 1000,CLAY,2,Tomas Berdych,Dmitry Tursunov,Tomas Berdych,6-4; 6-3,R32,83,4,2,31,54,25,31,9,23,0,2,9,34,54,2,1,43,60,23,43,9,17,4,9,10,32,60
2014-05-11 00:00:00.000,ATP World Tour Masters 1000 Rome Italy ATP World Tour Masters 1000,CLAY,2,Milos Raonic,Simone Bolelli,Milos Raonic,6-3; 7-6(5),R32,100,18,0,47,81,37,47,20,34,3,3,11,57,81,3,1,41,59,28,41,14,18,0,1,10,42,59
2014-05-11 00:00:00.000,ATP World Tour Masters 1000 Rome Italy ATP World Tour Masters 1000,CLAY,2,Jo-Wilfried Tsonga,Kevin Anderson,Jo-Wilfried Tsonga,7-6(14); 7-6(5),R32,135,11,2,64,95,52,64,17,31,5,5,12,69,95,9,3,51,87,42,51,22,36,3,3,12,64,87
2014-05-11 00:00:00.000,ATP World Tour Masters 1000 Rome Italy ATP World Tour Masters 1000,CLAY,2,Ivan Dodig,Lukas Rosol,Ivan Dodig,6-1; 6-2,R32,75,3,1,21,42,13,21,17,21,2,2,7,30,42,2,1,29,55,16,29,9,26,3,8,8,25,55
2014-05-11 00:00:00.000,ATP World Tour Masters 1000 Rome Italy ATP World Tour Masters 1000,CLAY,2,Jeremy Chardy,Roger Federer,Jeremy Chardy,1-6; 6-3; 7-6(6),R32,127,2,5,52,92,42,52,18,40,4,7,14,60,92,9,1,69,101,47,69,16,32,9,11,14,63,101
2014-05-11 00:00:00.000,ATP World Tour Masters 1000 Rome Italy ATP World Tour Masters 1000,CLAY,2,David Ferrer,Mikhail Kukushkin,David Ferrer,6-1; 6-2,R32,67,2,0,30,55,22,30,12,25,5,7,8,34,55,1,0,27,41,11,27,3,14,3,9,7,14,41
2014-05-11 00:00:00.000,ATP World Tour Masters 1000 Rome Italy ATP World Tour Masters 1000,CLAY,2,Ernests Gulbis,Stephane Robert,Ernests Gulbis,6-7(1); 6-4; 6-3,R32,118,14,1,65,88,46,65,11,23,0,2,15,57,88,5,3,56,95,38,56,19,39,4,9,16,57,95
2014-05-11 00:00:00.000,ATP World Tour Masters 1000 Rome Italy ATP World Tour Masters 1000,CLAY,2,Philipp Kohlschreiber,Tommy Robredo,Philipp Kohlschreiber,6-2; 6-4,R32,79,0,1,40,58,26,40,12,18,2,3,9,38,58,2,1,46,60,27,46,5,14,6,10,9,32,60
2014-05-11 00:00:00.000,ATP World Tour Masters 1000 Rome Italy ATP World Tour Masters 1000,CLAY,2,Novak Djokovic,Radek Stepanek,Novak Djokovic,6-3; 7-5,R32,97,2,0,39,58,26,39,12,19,2,5,11,38,58,4,7,49,79,32,49,8,30,6,11,10,40,79
2014-05-11 00:00:00.000,ATP World Tour Masters 1000 Rome Italy ATP World Tour Masters 1000,CLAY,2,Rafael Nadal,Mikhail Youzhny,Rafael Nadal,6-7(4); 6-2; 6-1,R16,164,1,4,75,99,55,75,7,24,7,9,14,62,99,0,2,73,102,38,73,15,29,9,15,13,53,102
2014-05-11 00:00:00.000,ATP World Tour Masters 1000 Rome Italy ATP World Tour Masters 1000,CLAY,2,Andy Murray,Jurgen Melzer,Andy Murray,7-6(1); 6-4,R16,102,6,1,49,80,33,49,18,31,8,10,11,51,80,4,1,47,64,28,47,8,17,2,5,11,36,64
2014-05-11 00:00:00.000,ATP World Tour Masters 1000 Rome Italy ATP World Tour Masters 1000,CLAY,2,Tommy Haas,Stan Wawrinka,Tommy Haas,5-7; 6-2; 6-3,R16,120,7,0,54,81,41,54,16,27,0,3,15,57,81,8,4,47,93,29,47,22,46,9,14,14,51,93
2014-05-11 00:00:00.000,ATP World Tour Masters 1000 Rome Italy ATP World Tour Masters 1000,CLAY,2,Grigor Dimitrov,Tomas Berdych,Grigor Dimitrov,6-7(3); 6-2; 6-2,R16,145,8,2,58,89,48,58,15,31,2,3,14,63,89,7,3,62,99,42,62,17,37,8,13,14,59,99
2014-05-11 00:00:00.000,ATP World Tour Masters 1000 Rome Italy ATP World Tour Masters 1000,CLAY,2,Milos Raonic,Jo-Wilfried Tsonga,Milos Raonic,7-6(5); 6-4,R16,108,7,3,50,80,38,50,19,30,5,5,11,57,80,6,1,40,64,30,40,17,24,3,4,11,47,64
2014-05-11 00:00:00.000,ATP World Tour Masters 1000 Rome Italy ATP World Tour Masters 1000,CLAY,2,Jeremy Chardy,Ivan Dodig,Jeremy Chardy,6-3; 6-2,R16,72,3,3,30,46,25,30,9,16,0,0,8,34,46,2,2,35,50,21,35,5,15,2,6,9,26,50
2014-05-11 00:00:00.000,ATP World Tour Masters 1000 Rome Italy ATP World Tour Masters 1000,CLAY,2,David Ferrer,Ernests Gulbis,David Ferrer,6-2; 6-3,R16,71,3,1,36,51,27,36,8,15,5,6,8,35,51,7,4,34,54,22,34,3,20,1,6,9,25,54
2014-05-11 00:00:00.000,ATP World Tour Masters 1000 Rome Italy ATP World Tour Masters 1000,CLAY,2,Novak Djokovic,Philipp Kohlschreiber,Novak Djokovic,4-6; 6-2; 6-1,R16,96,2,1,54,72,38,54,9,18,1,4,13,47,72,2,0,42,70,27,42,8,28,4,10,12,35,70
2014-05-11 00:00:00.000,ATP World Tour Masters 1000 Rome Italy ATP World Tour Masters 1000,CLAY,2,Rafael Nadal,Andy Murray,Rafael Nadal,1-6; 6-3; 7-5,Q,161,6,1,61,86,41,61,13,25,6,10,14,54,86,5,4,63,98,44,63,11,35,8,12,14,55,98
2014-05-11 00:00:00.000,ATP World Tour Masters 1000 Rome Italy ATP World Tour Masters 1000,CLAY,2,Grigor Dimitrov,Tommy Haas,Grigor Dimitrov,6-2 RET,Q,36,2,0,15,24,11,15,8,9,2,2,4,19,24,0,0,23,32,11,23,5,9,6,8,4,16,32
2014-05-11 00:00:00.000,ATP World Tour Masters 1000 Rome Italy ATP World Tour Masters 1000,CLAY,2,Milos Raonic,Jeremy Chardy,Milos Raonic,6-3; 5-7; 6-2,Q,122,14,2,54,85,47,54,12,31,5,7,15,59,85,8,3,54,88,40,54,14,34,5,9,14,54,88
2014-05-11 00:00:00.000,ATP World Tour Masters 1000 Rome Italy ATP World Tour Masters 1000,CLAY,2,Novak Djokovic,David Ferrer,Novak Djokovic,7-5; 4-6; 6-3,Q,152,3,2,60,97,41,60,20,37,3,6,16,61,97,2,0,59,92,38,59,17,33,8,12,15,55,92
2014-05-11 00:00:00.000,ATP World Tour Masters 1000 Rome Italy ATP World Tour Masters 1000,CLAY,2,Rafael Nadal,Grigor Dimitrov,Rafael Nadal,6-2; 6-2,S,83,1,0,44,55,29,44,8,11,3,3,8,37,55,2,3,29,46,17,29,4,17,3,7,8,21,46
2014-05-11 00:00:00.000,ATP World Tour Masters 1000 Rome Italy ATP World Tour Masters 1000,CLAY,2,Novak Djokovic,Milos Raonic,Novak Djokovic,6-7(5); 7-6(4); 6-3,S,181,3,1,82,114,58,82,21,32,7,8,16,79,114,17,3,81,121,61,81,18,40,7,10,17,79,121
2014-05-11 00:00:00.000,ATP World Tour Masters 1000 Rome Italy ATP World Tour Masters 1000,CLAY,2,Novak Djokovic,Rafael Nadal,Novak Djokovic,4-6; 6-3; 6-3,F,139,7,0,45,72,32,45,15,27,2,6,14,47,72,0,2,70,93,38,70,10,23,8,14,14,48,93
2014-05-18 00:00:00.000,Dusseldorf Germany ATP World Tour 250,CLAY,2,Philipp Kohlschreiber,N/A Bye,Philipp Kohlschreiber,,R32,0,0,0,0,0,0,0,0,0,0,0,0,0,0,0,0,0,0,0,0,0,0,0,0,0,0,0
2014-05-18 00:00:00.000,Dusseldorf Germany ATP World Tour 250,CLAY,2,Teymuraz Gabashvili,Dusan Lajovic,Teymuraz Gabashvili,3-6; 6-3; 6-4,R32,121,2,3,55,78,39,55,17,23,5,7,14,56,78,14,1,72,109,47,72,17,37,13,16,14,64,109
2014-05-18 00:00:00.000,Dusseldorf Germany ATP World Tour 250,CLAY,2,Mate Delic,Michal Przysiezny,Mate Delic,7-5; 7-5,R32,80,10,2,41,62,34,41,12,21,2,3,12,46,62,5,3,36,74,30,36,13,38,0,3,12,43,74
2014-05-18 00:00:00.000,Dusseldorf Germany ATP World Tour 250,CLAY,2,Dustin Brown,Yen-Hsun Lu,Dustin Brown,7-6(3); 6-2,R32,84,8,2,49,72,34,49,12,23,4,6,10,46,72,2,6,58,85,34,58,11,27,10,14,10,45,85
2014-05-18 00:00:00.000,Dusseldorf Germany ATP World Tour 250,CLAY,2,Andreas Seppi,N/A Bye,Andreas Seppi,,R32,0,0,0,0,0,0,0,0,0,0,0,0,0,0,0,0,0,0,0,0,0,0,0,0,0,0,0
2014-05-18 00:00:00.000,Dusseldorf Germany ATP World Tour 250,CLAY,2,Adrian Mannarino,Marinko Matosevic,Adrian Mannarino,3-6; 6-3; 6-4,R32,118,4,3,63,99,37,63,19,36,7,11,14,56,99,4,1,54,88,36,54,14,34,4,9,14,50,88
2014-05-18 00:00:00.000,Dusseldorf Germany ATP World Tour 250,CLAY,2,Jason Kubler,Alessandro Giannessi,Jason Kubler,7-5; 3-6; 6-1,R32,120,2,10,62,91,43,62,11,29,4,8,14,54,91,4,2,52,88,34,52,13,36,6,12,14,47,88
2014-05-18 00:00:00.000,Dusseldorf Germany ATP World Tour 250,CLAY,2,Denis Istomin,Jarkko Nieminen,Denis Istomin,6-7(5); 6-3; 6-2,R32,116,9,3,52,81,42,52,16,29,5,6,14,58,81,3,3,59,101,40,59,17,42,5,10,15,57,101
2014-05-18 00:00:00.000,Dusseldorf Germany ATP World Tour 250,CLAY,2,Jiri Vesely,Igor Sijsling,Jiri Vesely,7-6(2); 6-3,R32,94,7,3,43,73,35,43,14,30,4,5,10,49,73,7,1,40,74,30,40,15,34,4,7,11,45,74
2014-05-18 00:00:00.000,Dusseldorf Germany ATP World Tour 250,CLAY,2,Nikolay Davydenko,Dudi Sela,Nikolay Davydenko,6-3; 6-1,R32,60,2,1,30,52,21,30,13,22,3,4,8,34,52,1,3,26,50,10,26,12,24,2,7,8,22,50
2014-05-18 00:00:00.000,Dusseldorf Germany ATP World Tour 250,CLAY,2,Jurgen Melzer,Pablo Carreno Busta,Jurgen Melzer,6-4; 6-1,R32,61,3,1,35,53,24,35,11,18,1,3,9,35,53,2,4,25,43,14,25,6,18,3,8,8,20,43
2014-05-18 00:00:00.000,Dusseldorf Germany ATP World Tour 250,CLAY,2,Joao Sousa,N/A Bye,Joao Sousa,,R32,0,0,0,0,0,0,0,0,0,0,0,0,0,0,0,0,0,0,0,0,0,0,0,0,0,0,0
2014-05-18 00:00:00.000,Dusseldorf Germany ATP World Tour 250,CLAY,2,Ivo Karlovic,Tobias Kamke,Ivo Karlovic,3-6; 7-5; 7-6(5),R32,132,23,4,59,96,51,59,20,37,4,6,16,71,96,2,7,67,110,54,67,21,43,9,11,17,75,110
2014-05-18 00:00:00.000,Dusseldorf Germany ATP World Tour 250,CLAY,2,Nikola Milojevic,Mirza Basic,Nikola Milojevic,6-2; 5-7; 6-4,R32,124,7,6,50,93,36,50,15,43,5,11,15,51,93,3,3,64,103,38,64,13,39,6,14,15,51,103
2014-05-18 00:00:00.000,Dusseldorf Germany ATP World Tour 250,CLAY,2,Juan Monaco,Benjamin Becker,Juan Monaco,6-2; 6-1,R32,57,4,1,26,37,23,26,7,11,2,2,7,30,37,2,3,23,51,15,23,10,28,3,8,8,25,51
2014-05-18 00:00:00.000,Dusseldorf Germany ATP World Tour 250,CLAY,2,Marcel Granollers,N/A Bye,Marcel Granollers,,R32,0,0,0,0,0,0,0,0,0,0,0,0,0,0,0,0,0,0,0,0,0,0,0,0,0,0,0
2014-05-18 00:00:00.000,Dusseldorf Germany ATP World Tour 250,CLAY,2,Philipp Kohlschreiber,Teymuraz Gabashvili,Philipp Kohlschreiber,6-3; 6-1,R16,67,3,1,29,41,27,29,6,12,1,1,8,33,41,0,4,32,61,21,32,9,29,2,6,8,30,61
2014-05-18 00:00:00.000,Dusseldorf Germany ATP World Tour 250,CLAY,2,Mate Delic,Dustin Brown,Mate Delic,6-3; 6-0,R16,46,2,0,37,49,26,37,8,12,1,1,8,34,49,0,4,24,43,18,24,3,19,2,6,7,21,43
2014-05-18 00:00:00.000,Dusseldorf Germany ATP World Tour 250,CLAY,2,Andreas Seppi,Adrian Mannarino,Andreas Seppi,6-2; 6-1,R16,57,3,1,25,40,20,25,10,15,0,0,7,30,40,1,1,25,52,13,25,11,27,3,8,8,24,52
2014-05-18 00:00:00.000,Dusseldorf Germany ATP World Tour 250,CLAY,2,Denis Istomin,Jason Kubler,Denis Istomin,3-6; 6-4; 6-2,R16,98,4,1,57,83,38,57,14,26,4,7,14,52,83,0,5,46,77,29,46,15,31,5,9,13,44,77
2014-05-18 00:00:00.000,Dusseldorf Germany ATP World Tour 250,CLAY,2,Jiri Vesely,Nikolay Davydenko,Jiri Vesely,6-1; 7-6(5),R16,82,8,1,35,54,29,35,14,19,2,2,9,43,54,2,1,46,73,26,46,17,27,9,12,10,43,73
2014-05-18 00:00:00.000,Dusseldorf Germany ATP World Tour 250,CLAY,2,Jurgen Melzer,Joao Sousa,Jurgen Melzer,7-6(6); 4-6; 6-4,R16,142,5,4,61,109,46,61,28,48,8,10,16,74,109,3,2,66,109,44,66,28,43,9,11,16,72,109
2014-05-18 00:00:00.000,Dusseldorf Germany ATP World Tour 250,CLAY,2,Ivo Karlovic,Nikola Milojevic,Ivo Karlovic,6-4; 7-5,R16,72,11,0,38,49,36,38,8,11,0,0,11,44,49,0,3,37,65,28,37,14,28,3,5,11,42,65
2014-05-18 00:00:00.000,Dusseldorf Germany ATP World Tour 250,CLAY,2,Juan Monaco,Marcel Granollers,Juan Monaco,6-1; 6-2,R16,73,0,0,31,40,22,31,4,9,1,2,7,26,40,0,1,31,49,12,31,8,18,5,11,8,20,49
2014-05-18 00:00:00.000,Dusseldorf Germany ATP World Tour 250,CLAY,2,Philipp Kohlschreiber,Mate Delic,Philipp Kohlschreiber,7-5; 4-6; 6-1,Q,104,9,3,57,82,42,57,13,25,3,5,14,55,82,2,1,68,98,41,68,18,30,5,10,15,59,98
2014-05-18 00:00:00.000,Dusseldorf Germany ATP World Tour 250,CLAY,2,Denis Istomin,Andreas Seppi,Denis Istomin,6-3; 6-4,Q,75,6,2,45,66,32,45,12,21,3,4,10,44,66,1,3,33,56,21,33,10,23,3,6,9,31,56
2014-05-18 00:00:00.000,Dusseldorf Germany ATP World Tour 250,CLAY,2,Jiri Vesely,Jurgen Melzer,Jiri Vesely,6-1; 6-1,Q,63,5,1,30,47,23,30,9,17,2,2,7,32,47,2,2,25,49,10,25,11,24,7,12,7,21,49
2014-05-18 00:00:00.000,Dusseldorf Germany ATP World Tour 250,CLAY,2,Ivo Karlovic,Juan Monaco,Ivo Karlovic,6-4; 3-6; 6-3,Q,114,19,6,60,101,53,60,12,41,7,8,14,65,101,1,1,55,72,41,55,10,17,1,3,14,51,72
2014-05-18 00:00:00.000,Dusseldorf Germany ATP World Tour 250,CLAY,2,Philipp Kohlschreiber,Denis Istomin,Philipp Kohlschreiber,6-2; 4-6; 6-4,S,115,3,2,51,77,40,51,16,26,2,3,14,56,77,3,2,77,103,53,77,9,26,9,12,14,62,103
2014-05-18 00:00:00.000,Dusseldorf Germany ATP World Tour 250,CLAY,2,Ivo Karlovic,Jiri Vesely,Ivo Karlovic,7-6(6); 7-6(7),S,116,16,1,71,102,53,71,15,31,9,9,12,68,102,6,4,53,81,42,53,17,28,1,1,12,59,81
2014-05-18 00:00:00.000,Dusseldorf Germany ATP World Tour 250,CLAY,2,Philipp Kohlschreiber,Ivo Karlovic,Philipp Kohlschreiber,6-2; 7-6(4),F,73,1,1,44,58,34,44,10,14,3,4,10,44,58,4,1,36,59,23,36,12,23,0,3,10,35,59
2014-05-18 00:00:00.000,Nice France ATP World Tour 250,CLAY,2,John Isner,N/A Bye,John Isner,,R32,0,0,0,0,0,0,0,0,0,0,0,0,0,0,0,0,0,0,0,0,0,0,0,0,0,0,0
2014-05-18 00:00:00.000,Nice France ATP World Tour 250,CLAY,2,Jack Sock,Kenny De Schepper,Jack Sock,6-4; 6-2,R32,68,5,4,32,53,25,32,14,21,5,5,9,39,53,3,5,38,58,26,38,7,20,2,5,9,33,58
2014-05-18 00:00:00.000,Nice France ATP World Tour 250,CLAY,2,Paul-Henri Mathieu,Lucas Pouille,Paul-Henri Mathieu,2-6; 6-4; 6-0,R32,98,1,3,48,72,25,48,14,24,3,8,12,39,72,6,2,43,77,25,43,12,34,6,13,12,37,77
2014-05-18 00:00:00.000,Nice France ATP World Tour 250,CLAY,2,Federico Delbonis,Mikhail Kukushkin,Federico Delbonis,7-5; 6-3,R32,92,3,1,50,76,36,50,13,26,3,5,11,49,76,2,2,35,53,21,35,9,18,0,4,10,30,53
2014-05-18 00:00:00.000,Nice France ATP World Tour 250,CLAY,2,Gilles Simon,N/A Bye,Gilles Simon,,R32,0,0,0,0,0,0,0,0,0,0,0,0,0,0,0,0,0,0,0,0,0,0,0,0,0,0,0
2014-05-18 00:00:00.000,Nice France ATP World Tour 250,CLAY,2,Dominic Thiem,Steve Johnson,Dominic Thiem,3-6; 7-6(5); 7-5,R32,137,5,3,71,104,46,71,20,33,5,9,16,66,104,7,6,68,113,45,68,22,45,8,12,17,67,113
2014-05-18 00:00:00.000,Nice France ATP World Tour 250,CLAY,2,Carlos Berlocq,Julien Benneteau,Carlos Berlocq,6-1; 4-6; 6-3,R32,142,3,3,53,76,39,53,13,23,7,9,13,52,76,8,4,60,101,39,60,15,41,11,16,13,54,101
2014-05-18 00:00:00.000,Nice France ATP World Tour 250,CLAY,2,Nicolas Mahut,Martin Vaisse,Nicolas Mahut,6-7(4); 6-3; 6-2,R32,114,9,2,54,94,43,54,24,40,6,7,15,67,94,2,0,49,82,31,49,22,33,2,6,14,53,82
2014-05-18 00:00:00.000,Nice France ATP World Tour 250,CLAY,2,Edouard Roger-Vasselin,Alejandro Gonzalez,Edouard Roger-Vasselin,6-3; 6-1,R32,66,2,0,37,50,29,37,7,13,2,2,8,36,50,6,1,29,50,18,29,8,21,1,5,8,26,50
2014-05-18 00:00:00.000,Nice France ATP World Tour 250,CLAY,2,Leonardo Mayer,Borna Coric,Leonardo Mayer,4-6; 6-3; 6-4,R32,110,7,3,55,80,43,55,14,25,0,2,15,57,80,5,0,51,74,33,51,15,23,1,4,14,48,74
2014-05-18 00:00:00.000,Nice France ATP World Tour 250,CLAY,2,Albert Montanes,Matthew Ebden,Albert Montanes,6-1; 6-3,R32,73,4,2,32,57,24,32,14,25,2,2,8,38,57,1,7,35,59,21,35,8,24,5,9,8,29,59
2014-05-18 00:00:00.000,Nice France ATP World Tour 250,CLAY,2,Sam Querrey,N/A Bye,Sam Querrey,,R32,0,0,0,0,0,0,0,0,0,0,0,0,0,0,0,0,0,0,0,0,0,0,0,0,0,0,0
2014-05-18 00:00:00.000,Nice France ATP World Tour 250,CLAY,2,Dmitry Tursunov,Aleksandr Nedovyesov,Dmitry Tursunov,6-1; 6-4,R32,56,4,0,34,48,28,34,9,14,0,0,9,37,48,1,0,24,39,17,24,5,15,0,3,8,22,39
2014-05-18 00:00:00.000,Nice France ATP World Tour 250,CLAY,2,Robin Haase,Filippo Volandri,Robin Haase,6-3; 6-2,R32,62,3,1,38,55,32,38,7,17,0,0,9,39,55,0,0,38,48,20,38,7,10,5,8,8,27,48
2014-05-18 00:00:00.000,Nice France ATP World Tour 250,CLAY,2,Martin Klizan,Bernard Tomic,Martin Klizan,4-6; 6-3; 6-4,R32,108,6,2,42,83,35,42,20,41,4,6,14,55,83,11,1,56,88,37,56,17,32,2,6,15,54,88
2014-05-18 00:00:00.000,Nice France ATP World Tour 250,CLAY,2,Ernests Gulbis,N/A Bye,Ernests Gulbis,,R32,0,0,0,0,0,0,0,0,0,0,0,0,0,0,0,0,0,0,0,0,0,0,0,0,0,0,0
2014-05-18 00:00:00.000,Nice France ATP World Tour 250,CLAY,2,John Isner,Jack Sock,John Isner,6-4; 6-3,R16,78,8,0,35,53,29,35,12,18,2,2,10,41,53,2,2,45,65,29,45,10,20,4,6,9,39,65
2014-05-18 00:00:00.000,Nice France ATP World Tour 250,CLAY,2,Federico Delbonis,Paul-Henri Mathieu,Federico Delbonis,6-2; 6-4,R16,81,1,1,42,60,30,42,8,18,2,3,9,38,60,3,2,29,53,17,29,10,24,1,5,9,27,53
2014-05-18 00:00:00.000,Nice France ATP World Tour 250,CLAY,2,Gilles Simon,Dominic Thiem,Gilles Simon,6-3; 4-6; 6-2,R16,122,5,2,47,90,37,47,18,43,4,7,14,55,90,0,4,51,96,34,51,21,45,14,19,13,55,96
2014-05-18 00:00:00.000,Nice France ATP World Tour 250,CLAY,2,Carlos Berlocq,Nicolas Mahut,Carlos Berlocq,6-2; 6-3,R16,82,0,1,41,53,25,41,7,12,2,4,8,32,53,2,4,35,58,18,35,7,23,3,9,9,25,58
2014-05-18 00:00:00.000,Nice France ATP World Tour 250,CLAY,2,Leonardo Mayer,Edouard Roger-Vasselin,Leonardo Mayer,6-4; 3-6; 7-5,R16,140,10,5,54,87,40,54,19,33,4,6,15,59,87,0,3,84,113,54,84,15,29,10,13,16,69,113
2014-05-18 00:00:00.000,Nice France ATP World Tour 250,CLAY,2,Albert Montanes,Sam Querrey,Albert Montanes,4-6; 6-3; 6-2,R16,105,5,2,61,85,48,61,12,24,2,3,14,60,85,8,4,49,88,36,49,19,39,5,8,13,55,88
2014-05-18 00:00:00.000,Nice France ATP World Tour 250,CLAY,2,Dmitry Tursunov,Robin Haase,Dmitry Tursunov,6-3; 6-4,R16,80,3,1,43,60,35,43,8,17,2,2,10,43,60,5,3,48,74,31,48,12,26,6,8,9,43,74
2014-05-18 00:00:00.000,Nice France ATP World Tour 250,CLAY,2,Ernests Gulbis,Martin Klizan,Ernests Gulbis,6-7(4); 6-4; 6-1,R16,129,11,3,49,82,39,49,17,33,2,4,14,56,82,4,1,54,93,36,54,16,39,2,8,15,52,93
2014-05-18 00:00:00.000,Nice France ATP World Tour 250,CLAY,2,Federico Delbonis,John Isner,Federico Delbonis,6-4; 5-7; 7-6(6),Q,133,5,2,56,100,44,56,27,44,2,4,17,71,100,16,1,69,99,53,69,18,30,2,4,17,71,99
2014-05-18 00:00:00.000,Nice France ATP World Tour 250,CLAY,2,Gilles Simon,Carlos Berlocq,Gilles Simon,6-4; 6-1,Q,86,5,2,35,66,27,35,16,31,5,6,9,43,66,2,0,44,57,21,44,7,13,5,9,8,28,57
2014-05-18 00:00:00.000,Nice France ATP World Tour 250,CLAY,2,Albert Montanes,Leonardo Mayer,Albert Montanes,6-7(6); 6-4; 6-4,Q,130,2,2,66,104,50,66,17,38,1,3,16,67,104,5,4,60,92,41,60,19,32,4,8,16,60,92
2014-05-18 00:00:00.000,Nice France ATP World Tour 250,CLAY,2,Ernests Gulbis,Dmitry Tursunov,Ernests Gulbis,6-3; 3-6; 7-6(5),Q,123,18,5,58,94,47,58,19,36,8,10,15,66,94,4,0,61,84,48,61,13,23,1,3,15,61,84
2014-05-18 00:00:00.000,Nice France ATP World Tour 250,CLAY,2,Federico Delbonis,Gilles Simon,Federico Delbonis,6-2; 6-4,S,71,2,5,33,52,27,33,7,19,2,3,9,34,52,1,1,28,55,14,28,17,27,7,11,9,31,55
2014-05-18 00:00:00.000,Nice France ATP World Tour 250,CLAY,2,Ernests Gulbis,Albert Montanes,Ernests Gulbis,6-0; 6-3,S,70,4,6,27,56,26,27,11,29,6,7,8,37,56,0,5,26,43,12,26,6,17,1,6,7,18,43
2014-05-18 00:00:00.000,Nice France ATP World Tour 250,CLAY,2,Ernests Gulbis,Federico Delbonis,Ernests Gulbis,6-1; 7-6(5),F,99,9,6,35,65,32,35,16,30,3,3,10,48,65,1,3,44,68,27,44,14,24,4,6,9,41,68
2014-05-26 00:00:00.000,Roland Garros France Grand Slams,CLAY,3,Rafael Nadal,Robby Ginepri,Rafael Nadal,6-0; 6-3; 6-0,R128,102,1,0,30,52,26,30,15,22,1,1,10,41,52,2,4,59,86,25,59,11,27,11,19,11,36,86
2014-05-26 00:00:00.000,Roland Garros France Grand Slams,CLAY,3,Dominic Thiem,Paul-Henri Mathieu,Dominic Thiem,6-4; 7-6(3); 6-2,R128,128,4,5,42,90,33,42,28,48,3,5,15,61,90,2,4,53,85,31,53,19,32,4,9,15,50,85
2014-05-26 00:00:00.000,Roland Garros France Grand Slams,CLAY,3,Leonardo Mayer,James Duckworth,Leonardo Mayer,5-7; 6-2; 6-4; 7-6(2),R128,158,14,7,67,107,62,67,21,40,1,3,21,83,107,5,0,83,128,57,83,27,45,2,6,21,84,128
2014-05-26 00:00:00.000,Roland Garros France Grand Slams,CLAY,3,Teymuraz Gabashvili,Vasek Pospisil,Teymuraz Gabashvili,6-4; 6-2; 6-3,R128,100,1,1,42,69,32,42,18,27,1,2,13,50,69,6,3,57,91,34,57,14,34,9,15,14,48,91
2014-05-26 00:00:00.000,Roland Garros France Grand Slams,CLAY,3,Jack Sock,Nicolas Almagro,Jack Sock,5-0 RET,R128,21,1,0,4,10,3,4,5,6,0,0,2,8,10,0,2,8,17,2,8,3,9,1,4,3,5,17
2014-05-26 00:00:00.000,Roland Garros France Grand Slams,CLAY,3,Steve Johnson,Laurent Lokoli,Steve Johnson,4-6; 6-7(7); 7-6(3); 6-3; 6-3,R128,237,5,3,88,180,56,88,58,92,11,16,26,114,180,18,10,80,164,58,80,43,84,7,14,26,101,164
2014-05-26 00:00:00.000,Roland Garros France Grand Slams,CLAY,3,Dusan Lajovic,Federico Delbonis,Dusan Lajovic,6-3; 6-2; 6-3,R128,111,2,1,45,77,39,45,19,32,2,2,13,58,77,2,1,52,85,34,52,13,33,3,8,13,47,85
2014-05-26 00:00:00.000,Roland Garros France Grand Slams,CLAY,3,Jurgen Zopp,Tommy Haas,Jurgen Zopp,2-5 RET,R128,27,2,0,11,21,8,11,5,10,0,1,3,13,21,4,0,12,18,11,12,5,6,0,0,4,16,18
2014-05-26 00:00:00.000,Roland Garros France Grand Slams,CLAY,3,Ivo Karlovic,Grigor Dimitrov,Ivo Karlovic,6-4; 7-5; 7-6(4),R128,118,22,2,60,95,53,60,23,35,1,1,17,76,95,11,6,59,100,45,59,24,41,2,4,17,69,100
2014-05-26 00:00:00.000,Roland Garros France Grand Slams,CLAY,3,Andreas Haider-Maurer,Daniel Brands,Andreas Haider-Maurer,4-6; 4-6; 6-2; 6-3; 6-4,R128,168,14,9,77,137,61,77,30,60,2,6,24,91,137,12,6,98,144,65,98,23,46,12,18,23,88,144
2014-05-26 00:00:00.000,Roland Garros France Grand Slams,CLAY,3,Axel Michon,Bradley Klahn,Axel Michon,6-1; 6-7(4); 5-7; 6-1; 6-4,R128,226,3,1,105,141,57,105,20,36,11,20,23,77,141,3,8,119,187,63,119,22,68,16,31,25,85,187
2014-05-26 00:00:00.000,Roland Garros France Grand Slams,CLAY,3,Kevin Anderson,Stephane Robert,Kevin Anderson,7-5; 6-3; 6-4,R128,110,11,5,51,83,45,51,19,32,1,2,16,64,83,3,3,50,104,33,50,30,54,14,18,15,63,104
2014-05-26 00:00:00.000,Roland Garros France Grand Slams,CLAY,3,Andreas Seppi,Santiago Giraldo,Andreas Seppi,6-3; 7-5; 6-3,R128,111,8,1,46,85,33,46,26,39,1,3,15,59,85,3,1,69,101,41,69,14,32,11,17,15,55,101
2014-05-26 00:00:00.000,Roland Garros France Grand Slams,CLAY,3,Juan Monaco,Lucas Pouille,Juan Monaco,6-3; 6-1; 6-4,R128,100,0,3,60,79,39,60,9,19,8,12,13,48,79,2,0,54,78,27,54,8,24,4,13,13,35,78
2014-05-26 00:00:00.000,Roland Garros France Grand Slams,CLAY,3,Simone Bolelli,Andrea Arnaboldi,Simone Bolelli,6-4; 6-4; 6-2,R128,124,3,2,68,99,47,68,18,31,5,6,14,65,99,7,1,57,83,35,57,13,26,5,10,14,48,83
2014-05-26 00:00:00.000,Roland Garros France Grand Slams,CLAY,3,David Ferrer,Igor Sijsling,David Ferrer,6-4; 6-3; 6-1,R128,100,1,1,48,77,33,48,22,29,1,2,13,55,77,3,3,56,88,32,56,15,32,4,10,13,47,88
2014-05-26 00:00:00.000,Roland Garros France Grand Slams,CLAY,3,Guillermo Garcia-Lopez,Stan Wawrinka,Guillermo Garcia-Lopez,6-4; 5-7; 6-2; 6-0,R128,143,2,5,56,113,42,56,29,57,4,7,18,71,113,5,1,56,98,30,56,23,42,4,12,18,53,98
2014-05-26 00:00:00.000,Roland Garros France Grand Slams,CLAY,3,Adrian Mannarino,Yen-Hsun Lu,Adrian Mannarino,6-2; 6-1; 6-1,R128,74,6,1,38,62,29,38,18,24,0,0,11,47,62,1,5,37,61,23,37,5,24,3,10,11,28,61
2014-05-26 00:00:00.000,Roland Garros France Grand Slams,CLAY,3,Donald Young,Dudi Sela,Donald Young,6-1; 2-6; 6-1; 6-0,R128,134,3,4,69,103,46,69,19,34,4,6,14,65,103,0,8,76,112,41,76,15,36,10,18,14,56,112
2014-05-26 00:00:00.000,Roland Garros France Grand Slams,CLAY,3,Feliciano Lopez,Damir Dzumhur,Feliciano Lopez,6-3; 7-6(8); 6-3,R128,153,8,1,71,115,52,71,26,44,6,7,16,78,115,1,0,61,96,41,61,20,35,6,9,14,61,96
2014-05-26 00:00:00.000,Roland Garros France Grand Slams,CLAY,3,Gael Monfils,Victor Hanescu,Gael Monfils,6-2; 4-6; 6-4; 6-2,R128,151,10,4,69,114,47,69,24,45,8,12,18,71,114,1,2,85,114,50,85,10,29,9,17,18,60,114
2014-05-26 00:00:00.000,Roland Garros France Grand Slams,CLAY,3,Jan-Lennard Struff,Albano Olivetti,Jan-Lennard Struff,6-1; 6-4; 6-4,R128,101,8,1,47,81,38,47,22,34,4,4,14,60,81,14,6,43,80,34,43,13,37,3,7,13,47,80
2014-05-26 00:00:00.000,Roland Garros France Grand Slams,CLAY,3,Thomaz Bellucci,Benjamin Becker,Thomaz Bellucci,6-2; 6-4; 3-6; 4-6; 6-2,R128,175,15,3,65,121,47,65,33,56,3,7,22,80,121,8,5,75,148,54,75,33,73,5,12,23,87,148
2014-05-26 00:00:00.000,Roland Garros France Grand Slams,CLAY,3,Fabio Fognini,Andreas Beck,Fabio Fognini,6-4; 6-4; 6-1,R128,101,7,4,46,81,36,46,16,35,0,2,13,52,81,1,4,56,87,29,56,15,31,7,14,14,44,87
2014-05-26 00:00:00.000,Roland Garros France Grand Slams,CLAY,3,Richard Gasquet,Bernard Tomic,Richard Gasquet,6-2; 6-1; 7-5,R128,97,6,0,45,78,38,45,18,33,0,1,14,56,78,4,1,55,82,31,55,12,27,7,13,13,43,82
2014-05-26 00:00:00.000,Roland Garros France Grand Slams,CLAY,3,Carlos Berlocq,Lleyton Hewitt,Carlos Berlocq,3-6; 6-2; 6-1; 6-4,R128,188,1,1,104,131,72,104,8,27,11,13,17,80,131,3,7,58,112,38,58,25,54,10,16,17,63,112
2014-05-26 00:00:00.000,Roland Garros France Grand Slams,CLAY,3,Pablo Cuevas,Matthew Ebden,Pablo Cuevas,6-1; 6-2; 6-3,R128,80,5,1,44,63,37,44,9,19,0,1,12,46,63,5,2,38,72,24,38,9,34,6,13,12,33,72
2014-05-26 00:00:00.000,Roland Garros France Grand Slams,CLAY,3,Fernando Verdasco,Michael Llodra,Fernando Verdasco,6-2; 7-6(4); 7-6(3),R128,152,3,3,83,109,61,83,19,26,5,6,16,80,109,6,3,83,122,55,83,20,39,10,13,16,75,122
2014-05-26 00:00:00.000,Roland Garros France Grand Slams,CLAY,3,Philipp Kohlschreiber,Pere Riba,Philipp Kohlschreiber,7-5; 6-4; 6-1,R128,107,5,1,61,85,44,61,15,24,1,2,14,59,85,3,5,48,94,32,48,20,46,7,13,15,52,94
2014-05-26 00:00:00.000,Roland Garros France Grand Slams,CLAY,3,Denis Istomin,Sergiy Stakhovsky,Denis Istomin,6-3; 6-4; 2-6; 6-3,R128,139,9,2,71,105,55,71,19,34,3,5,18,74,105,0,6,73,114,49,73,20,41,4,8,18,69,114
2014-05-26 00:00:00.000,Roland Garros France Grand Slams,CLAY,3,Marinko Matosevic,Dustin Brown,Marinko Matosevic,7-6(5); 6-4; 6-7(1); 7-5,R128,181,5,0,87,153,61,87,34,66,6,10,23,95,153,18,8,101,157,68,101,27,56,3,9,23,95,157
2014-05-26 00:00:00.000,Roland Garros France Grand Slams,CLAY,3,Andy Murray,Andrey Golubev,Andy Murray,6-1; 6-4; 3-6; 6-3,R128,155,5,3,65,127,40,65,33,62,5,10,18,73,127,2,5,58,104,33,58,23,46,5,13,17,56,104
2014-05-26 00:00:00.000,Roland Garros France Grand Slams,CLAY,3,Tomas Berdych,Peter Polansky,Tomas Berdych,6-3; 6-4; 6-4,R128,118,15,4,56,93,45,56,20,37,5,6,15,65,93,2,4,53,86,31,53,20,33,2,6,14,51,86
2014-05-26 00:00:00.000,Roland Garros France Grand Slams,CLAY,3,Aleksandr Nedovyesov,Somdev Devvarman,Aleksandr Nedovyesov,5-7; 6-3; 7-6(4); 6-3,R128,193,7,3,94,145,63,94,32,51,2,6,22,95,145,2,1,89,140,61,89,21,51,4,9,20,82,140
2014-05-26 00:00:00.000,Roland Garros France Grand Slams,CLAY,3,Benoit Paire,Alejandro Falla,Benoit Paire,6-3; 6-4; 7-6(4),R128,98,9,4,45,98,37,45,27,53,3,6,16,64,98,0,1,54,94,35,54,18,40,3,8,15,53,94
2014-05-26 00:00:00.000,Roland Garros France Grand Slams,CLAY,3,Roberto Bautista Agut,Paolo Lorenzi,Roberto Bautista Agut,6-3; 7-5; 6-2,R128,139,1,0,72,99,48,72,20,27,6,7,15,68,99,2,1,57,90,40,57,10,33,10,15,14,50,90
2014-05-26 00:00:00.000,Roland Garros France Grand Slams,CLAY,3,Tommy Robredo,James Ward,Tommy Robredo,4-6; 6-4; 6-2; 6-4,R128,173,3,3,72,115,51,72,24,43,7,10,19,75,115,1,4,92,137,57,92,22,45,10,16,19,79,137
2014-05-26 00:00:00.000,Roland Garros France Grand Slams,CLAY,3,Kenny De Schepper,Albert Montanes,Kenny De Schepper,3-1 RET,R128,20,2,0,9,13,7,9,3,4,0,0,2,10,13,1,1,8,11,5,8,1,3,0,1,2,6,11
2014-05-26 00:00:00.000,Roland Garros France Grand Slams,CLAY,3,Mikhail Kukushkin,Nicolas Mahut,Mikhail Kukushkin,6-3; 6-7(4); 6-3; 6-4,R128,196,6,3,100,156,65,100,24,56,13,19,21,89,156,7,8,64,121,42,64,20,57,10,19,19,62,121
2014-05-26 00:00:00.000,Roland Garros France Grand Slams,CLAY,3,John Isner,Pierre-Hugues Herbert,John Isner,7-6(5); 7-6(4); 7-5,R128,153,23,3,67,110,56,67,28,43,2,2,18,84,110,11,3,54,110,44,54,35,56,0,1,18,79,110
2014-05-26 00:00:00.000,Roland Garros France Grand Slams,CLAY,3,Mikhail Youzhny,Pablo Carreno Busta,Mikhail Youzhny,3-6; 1-6; 6-3; 6-4; 6-0,R128,179,8,5,91,146,59,91,23,55,8,15,21,82,146,5,2,79,121,53,79,13,42,6,14,20,66,121
2014-05-26 00:00:00.000,Roland Garros France Grand Slams,CLAY,3,Radek Stepanek,Facundo Arguello,Radek Stepanek,6-7(8); 3-6; 6-4; 6-3; 6-2,R128,208,4,7,106,159,69,106,29,53,8,13,24,98,159,7,11,87,154,63,87,26,67,8,16,24,89,154
2014-05-26 00:00:00.000,Roland Garros France Grand Slams,CLAY,3,Facundo Bagnis,Julien Benneteau,Facundo Bagnis,6-1; 6-2; 1-6; 3-6; 18-16,R128,267,5,1,127,197,89,127,38,70,13,19,33,127,197,16,7,112,185,80,112,37,73,9,16,32,117,185
2014-05-26 00:00:00.000,Roland Garros France Grand Slams,CLAY,3,Ernests Gulbis,Lukasz Kubot,Ernests Gulbis,4-6; 6-4; 7-5; 6-1,R128,162,11,6,63,117,50,63,32,54,5,8,20,82,117,9,10,55,104,40,55,23,49,3,9,19,63,104
2014-05-26 00:00:00.000,Roland Garros France Grand Slams,CLAY,3,Dmitry Tursunov,Potito Starace,Dmitry Tursunov,6-1; 7-5; 6-2,R128,105,6,3,46,82,38,46,24,36,4,4,14,62,82,4,6,61,83,43,61,4,22,4,9,13,47,83
2014-05-26 00:00:00.000,Roland Garros France Grand Slams,CLAY,3,Sam Querrey,Filippo Volandri,Sam Querrey,7-6(3); 6-4; 6-3,R128,116,24,3,71,109,59,71,17,38,10,10,15,76,109,1,2,80,106,53,80,15,26,6,9,16,68,106
2014-05-26 00:00:00.000,Roland Garros France Grand Slams,CLAY,3,Diego Schwartzman,Gastao Elias,Diego Schwartzman,6-4; 6-2; 7-5,R128,144,0,3,67,97,38,67,16,30,4,10,15,54,97,6,4,67,112,29,67,22,45,15,25,15,51,112
2014-05-26 00:00:00.000,Roland Garros France Grand Slams,CLAY,3,Roger Federer,Lukas Lacko,Roger Federer,6-2; 6-4; 6-2,R128,84,7,1,44,61,39,44,13,17,0,0,13,52,61,3,5,57,91,32,57,18,34,6,11,13,50,91
2014-05-26 00:00:00.000,Roland Garros France Grand Slams,CLAY,3,Milos Raonic,Nick Kyrgios,Milos Raonic,6-3; 7-6(1); 6-3,R128,120,27,8,63,107,57,63,17,44,6,8,16,74,107,4,6,52,93,34,52,22,41,6,10,14,56,93
2014-05-26 00:00:00.000,Roland Garros France Grand Slams,CLAY,3,Jiri Vesely,Lukas Rosol,Jiri Vesely,6-2; 7-6(6); 7-5,R128,126,4,3,69,103,54,69,18,34,0,1,16,72,103,6,3,57,96,39,57,23,39,2,6,16,62,96
2014-05-26 00:00:00.000,Roland Garros France Grand Slams,CLAY,3,Alejandro Gonzalez,Michael Russell,Alejandro Gonzalez,6-2; 6-4; 6-7(6); 6-1,R128,157,10,2,78,117,55,78,24,39,1,3,19,79,117,0,2,74,114,45,74,18,40,4,11,18,63,114
2014-05-26 00:00:00.000,Roland Garros France Grand Slams,CLAY,3,Gilles Simon,Ante Pavic,Gilles Simon,6-1; 6-1; 6-3,R128,94,6,2,36,67,31,36,16,31,2,2,11,47,67,5,5,45,78,28,45,9,33,2,9,12,37,78
2014-05-26 00:00:00.000,Roland Garros France Grand Slams,CLAY,3,Alexandr Dolgopolov,Albert Ramos-Vinolas,Alexandr Dolgopolov,7-6(4); 6-4; 6-1,R128,130,10,2,57,97,48,57,20,40,6,7,15,68,97,3,3,61,107,37,61,22,46,5,9,14,59,107
2014-05-26 00:00:00.000,Roland Garros France Grand Slams,CLAY,3,Marcel Granollers,Ivan Dodig,Marcel Granollers,2-2 RET,R128,11,1,0,10,11,9,10,1,1,0,0,2,10,11,0,2,5,14,4,5,5,9,0,0,2,9,14
2014-05-26 00:00:00.000,Roland Garros France Grand Slams,CLAY,3,Robin Haase,Nikolay Davydenko,Robin Haase,7-5; 6-4; 6-2,R128,120,10,1,61,97,46,61,22,36,4,4,15,68,97,3,4,61,93,36,61,17,32,2,6,15,53,93
2014-05-26 00:00:00.000,Roland Garros France Grand Slams,CLAY,3,Martin Klizan,Kei Nishikori,Martin Klizan,7-6(4); 6-1; 6-2,R128,117,3,3,50,95,37,50,26,45,3,5,14,63,95,1,10,42,84,28,42,16,42,4,10,13,44,84
2014-05-26 00:00:00.000,Roland Garros France Grand Slams,CLAY,3,Jo-Wilfried Tsonga,Edouard Roger-Vasselin,Jo-Wilfried Tsonga,7-6(4); 7-5; 6-2,R128,141,9,3,59,91,49,59,18,32,0,2,16,67,91,7,1,72,118,46,72,22,46,10,15,16,68,118
2014-05-26 00:00:00.000,Roland Garros France Grand Slams,CLAY,3,Jurgen Melzer,David Goffin,Jurgen Melzer,6-4; 5-7; 7-5; 6-4,R128,207,3,7,86,145,55,86,27,59,11,19,22,82,145,10,15,106,172,60,106,32,66,9,19,22,92,172
2014-05-26 00:00:00.000,Roland Garros France Grand Slams,CLAY,3,Jarkko Nieminen,Michal Przysiezny,Jarkko Nieminen,6-7(7); 6-4; 6-7(3); 6-3; 6-4,R128,228,9,11,111,183,90,111,32,72,9,11,27,122,183,6,9,104,182,73,104,43,78,16,21,26,116,182
2014-05-26 00:00:00.000,Roland Garros France Grand Slams,CLAY,3,Jerzy Janowicz,Victor Estrella Burgos,Jerzy Janowicz,6-1; 6-4; 6-7(6); 6-4,R128,143,15,13,69,118,57,69,23,49,2,4,20,80,118,3,5,73,110,45,73,21,37,5,11,19,66,110
2014-05-26 00:00:00.000,Roland Garros France Grand Slams,CLAY,3,Marin Cilic,Pablo Andujar,Marin Cilic,6-0; 6-3; 7-6(6),R128,131,16,1,59,91,47,59,18,32,8,9,14,65,91,3,2,77,106,44,77,12,29,8,13,13,56,106
2014-05-26 00:00:00.000,Roland Garros France Grand Slams,CLAY,3,Tobias Kamke,Miloslav Mecir,Tobias Kamke,7-5; 7-6(2); 7-6(1),R128,151,7,2,84,122,62,84,24,38,3,4,18,86,122,6,0,75,123,53,75,23,48,4,6,18,76,123
2014-05-26 00:00:00.000,Roland Garros France Grand Slams,CLAY,3,Jeremy Chardy,Daniel Gimeno-Traver,Jeremy Chardy,7-5; 6-2; 6-2,R128,97,10,3,49,74,39,49,16,25,2,3,14,55,74,1,3,49,83,30,49,15,34,2,8,14,45,83
2014-05-26 00:00:00.000,Roland Garros France Grand Slams,CLAY,3,Novak Djokovic,Joao Sousa,Novak Djokovic,6-1; 6-2; 6-4,R128,110,9,3,58,83,38,58,14,25,7,10,13,52,83,0,2,52,87,32,52,8,35,7,15,12,40,87
2014-05-26 00:00:00.000,Roland Garros France Grand Slams,CLAY,3,Rafael Nadal,Dominic Thiem,Rafael Nadal,6-2; 6-2; 6-3,R64,125,0,0,54,79,36,54,17,25,2,4,13,53,79,2,3,45,70,18,45,14,25,3,10,12,32,70
2014-05-26 00:00:00.000,Roland Garros France Grand Slams,CLAY,3,Leonardo Mayer,Teymuraz Gabashvili,Leonardo Mayer,6-2; 4-6; 6-4; 6-4,R64,168,7,9,71,120,47,71,30,49,9,12,19,77,120,4,2,71,113,46,71,21,42,5,11,19,67,113
2014-05-26 00:00:00.000,Roland Garros France Grand Slams,CLAY,3,Jack Sock,Steve Johnson,Jack Sock,7-5; 6-4; 6-2,R64,107,8,0,46,78,36,46,23,32,3,4,15,59,78,8,1,58,97,38,58,17,39,5,10,15,55,97
2014-05-26 00:00:00.000,Roland Garros France Grand Slams,CLAY,3,Dusan Lajovic,Jurgen Zopp,Dusan Lajovic,6-2; 6-4; 6-4,R64,95,8,1,40,74,31,40,23,34,6,8,14,54,74,2,3,52,81,31,52,12,29,2,8,14,43,81
2014-05-26 00:00:00.000,Roland Garros France Grand Slams,CLAY,3,Ivo Karlovic,Andreas Haider-Maurer,Ivo Karlovic,7-5; 6-3; 6-4,R64,107,24,1,62,81,55,62,10,19,0,0,16,65,81,6,6,54,94,39,54,22,40,6,9,15,61,94
2014-05-26 00:00:00.000,Roland Garros France Grand Slams,CLAY,3,Kevin Anderson,Axel Michon,Kevin Anderson,6-2; 6-3; 6-2,R64,125,7,1,54,74,40,54,9,20,2,4,13,49,74,2,5,55,90,33,55,10,35,11,18,12,43,90
2014-05-26 00:00:00.000,Roland Garros France Grand Slams,CLAY,3,Andreas Seppi,Juan Monaco,Andreas Seppi,6-2; 6-4; 6-4,R64,143,5,4,44,86,34,44,23,42,4,6,14,57,86,1,1,101,131,55,101,13,30,15,21,14,68,131
2014-05-26 00:00:00.000,Roland Garros France Grand Slams,CLAY,3,David Ferrer,Simone Bolelli,David Ferrer,6-2; 6-3; 6-2,R64,108,2,3,57,87,44,57,17,30,4,4,13,61,87,0,3,46,74,27,46,12,28,3,8,12,39,74
2014-05-26 00:00:00.000,Roland Garros France Grand Slams,CLAY,3,Guillermo Garcia-Lopez,Adrian Mannarino,Guillermo Garcia-Lopez,6-4; 6-3; 4-6; 6-0,R64,157,6,2,78,126,54,78,22,48,11,15,18,76,126,2,2,64,105,36,64,20,41,6,14,17,56,105
2014-05-26 00:00:00.000,Roland Garros France Grand Slams,CLAY,3,Donald Young,Feliciano Lopez,Donald Young,6-3; 7-6(1); 6-3,R64,115,3,4,60,97,44,60,23,37,4,6,16,67,97,2,1,51,82,35,51,14,31,1,5,14,49,82
2014-05-26 00:00:00.000,Roland Garros France Grand Slams,CLAY,3,Gael Monfils,Jan-Lennard Struff,Gael Monfils,7-6(4); 6-4; 6-1,R64,133,8,10,65,110,45,65,21,45,12,16,15,66,110,3,2,57,91,32,57,15,34,0,7,14,47,91
2014-05-26 00:00:00.000,Roland Garros France Grand Slams,CLAY,3,Fabio Fognini,Thomaz Bellucci,Fabio Fognini,6-3; 6-4; 7-6(2),R64,126,4,2,66,101,50,66,19,35,4,5,16,69,101,9,4,54,93,37,54,21,39,5,8,15,58,93
2014-05-26 00:00:00.000,Roland Garros France Grand Slams,CLAY,3,Richard Gasquet,Carlos Berlocq,Richard Gasquet,7-6(5); 6-4; 6-4,R64,162,2,6,78,123,58,78,19,45,9,11,16,77,123,3,2,76,98,49,76,13,22,6,10,16,62,98
2014-05-26 00:00:00.000,Roland Garros France Grand Slams,CLAY,3,Fernando Verdasco,Pablo Cuevas,Fernando Verdasco,4-6; 6-7(6); 7-5; 6-4; 6-3,R64,233,15,4,92,142,69,92,29,50,5,10,26,98,142,16,7,126,207,87,126,36,81,15,23,27,123,207
2014-05-26 00:00:00.000,Roland Garros France Grand Slams,CLAY,3,Philipp Kohlschreiber,Denis Istomin,Philipp Kohlschreiber,6-3; 7-6(5); 6-2,R64,118,4,2,45,78,37,45,19,33,3,5,14,56,78,1,0,59,97,36,59,16,38,2,8,15,52,97
2014-05-26 00:00:00.000,Roland Garros France Grand Slams,CLAY,3,Andy Murray,Marinko Matosevic,Andy Murray,6-3; 6-1; 6-3,R64,116,9,1,43,75,31,43,21,32,5,6,12,52,75,2,4,67,104,42,67,10,37,13,20,13,52,104
2014-05-26 00:00:00.000,Roland Garros France Grand Slams,CLAY,3,Tomas Berdych,Aleksandr Nedovyesov,Tomas Berdych,6-7(4); 6-4; 7-5; 6-3,R64,174,5,3,72,122,60,72,31,50,2,3,21,91,122,7,2,107,149,72,107,22,42,8,13,22,94,149
2014-05-26 00:00:00.000,Roland Garros France Grand Slams,CLAY,3,Roberto Bautista Agut,Benoit Paire,Roberto Bautista Agut,6-4; 7-6(4); 6-2,R64,130,3,1,73,92,49,73,10,19,1,4,15,59,92,9,3,59,129,35,59,30,70,18,24,15,65,129
2014-05-26 00:00:00.000,Roland Garros France Grand Slams,CLAY,3,Tommy Robredo,Kenny De Schepper,Tommy Robredo,6-2; 6-3; 6-3,R64,101,2,0,49,70,40,49,15,21,1,1,13,55,70,6,8,59,90,37,59,12,31,7,12,13,49,90
2014-05-26 00:00:00.000,Roland Garros France Grand Slams,CLAY,3,John Isner,Mikhail Kukushkin,John Isner,6-7(6); 7-6(4); 6-3; 7-6(4),R64,198,35,2,118,165,95,118,22,47,10,11,23,117,165,5,4,120,153,87,120,21,33,6,8,22,108,153
2014-05-26 00:00:00.000,Roland Garros France Grand Slams,CLAY,3,Radek Stepanek,Mikhail Youzhny,Radek Stepanek,6-0; 6-3; 3-6; 6-4,R64,141,7,1,58,108,40,58,27,50,5,9,17,67,108,3,5,64,91,42,64,8,27,4,12,17,50,91
2014-05-26 00:00:00.000,Roland Garros France Grand Slams,CLAY,3,Ernests Gulbis,Facundo Bagnis,Ernests Gulbis,6-2; 7-5; 6-0,R64,117,9,3,33,65,28,33,25,32,1,1,13,53,65,4,8,71,110,48,71,9,39,13,19,13,57,110
2014-05-26 00:00:00.000,Roland Garros France Grand Slams,CLAY,3,Dmitry Tursunov,Sam Querrey,Dmitry Tursunov,6-4; 7-5; 6-1,R64,101,11,2,57,83,44,57,17,26,5,6,14,61,83,13,1,52,91,31,52,18,39,2,8,15,49,91
2014-05-26 00:00:00.000,Roland Garros France Grand Slams,CLAY,3,Roger Federer,Diego Schwartzman,Roger Federer,6-3; 6-4; 6-4,R64,103,9,2,51,81,42,51,17,30,1,2,15,59,81,1,4,51,95,30,51,24,44,6,10,14,54,95
2014-05-26 00:00:00.000,Roland Garros France Grand Slams,CLAY,3,Milos Raonic,Jiri Vesely,Milos Raonic,7-6(4); 6-4; 6-1,R64,128,20,2,49,86,40,49,22,37,5,7,14,62,86,5,1,64,98,37,64,18,34,3,9,15,55,98
2014-05-26 00:00:00.000,Roland Garros France Grand Slams,CLAY,3,Gilles Simon,Alejandro Gonzalez,Gilles Simon,6-4; 6-0; 6-2,R64,104,1,2,41,72,31,41,18,31,2,3,12,49,72,4,0,46,74,22,46,12,28,4,11,12,34,74
2014-05-26 00:00:00.000,Roland Garros France Grand Slams,CLAY,3,Marcel Granollers,Alexandr Dolgopolov,Marcel Granollers,1-6; 3-6; 6-3; 6-0; 6-2,R64,187,5,1,88,137,59,88,22,49,4,9,20,81,137,12,6,75,139,48,75,29,64,7,14,19,77,139
2014-05-26 00:00:00.000,Roland Garros France Grand Slams,CLAY,3,Martin Klizan,Robin Haase,Martin Klizan,6-1; 3-6; 6-1; 1-6; 7-5,R64,185,5,3,86,143,53,86,31,57,9,14,21,84,143,10,2,75,139,52,75,26,64,4,11,21,78,139
2014-05-26 00:00:00.000,Roland Garros France Grand Slams,CLAY,3,Jo-Wilfried Tsonga,Jurgen Melzer,Jo-Wilfried Tsonga,6-2; 6-3; 6-4,R64,107,13,2,58,81,48,58,8,23,3,4,14,56,81,5,4,49,85,31,49,15,36,7,12,13,46,85
2014-05-26 00:00:00.000,Roland Garros France Grand Slams,CLAY,3,Jerzy Janowicz,Jarkko Nieminen,Jerzy Janowicz,7-6(4); 7-6(4); 6-4,R64,134,6,9,62,99,49,62,17,37,8,13,17,66,99,9,4,91,135,62,91,14,44,12,18,17,76,135
2014-05-26 00:00:00.000,Roland Garros France Grand Slams,CLAY,3,Marin Cilic,Tobias Kamke,Marin Cilic,6-3; 3-6; 6-3; 6-0,R64,122,19,3,59,101,48,59,22,42,3,4,17,70,101,1,4,60,93,39,60,15,33,6,11,16,54,93
2014-05-26 00:00:00.000,Roland Garros France Grand Slams,CLAY,3,Novak Djokovic,Jeremy Chardy,Novak Djokovic,6-1; 6-4; 6-2,R64,92,2,1,42,69,32,42,17,27,2,4,13,49,69,3,3,45,76,26,45,10,31,2,9,12,36,76
2014-05-26 00:00:00.000,Roland Garros France Grand Slams,CLAY,3,Rafael Nadal,Leonardo Mayer,Rafael Nadal,6-2; 7-5; 6-2,R32,137,0,1,60,83,42,60,15,23,6,8,14,57,83,2,5,50,92,26,50,19,42,3,10,14,45,92
2014-05-26 00:00:00.000,Roland Garros France Grand Slams,CLAY,3,Dusan Lajovic,Jack Sock,Dusan Lajovic,6-4; 7-5; 6-3,R32,134,3,1,50,98,39,50,28,48,8,9,15,67,98,3,5,47,90,34,47,19,43,3,8,16,53,90
2014-05-26 00:00:00.000,Roland Garros France Grand Slams,CLAY,3,Kevin Anderson,Ivo Karlovic,Kevin Anderson,6-3 RET,R32,43,7,0,19,26,16,19,5,7,0,0,5,21,26,6,1,18,29,14,18,2,11,4,5,4,16,29
2014-05-26 00:00:00.000,Roland Garros France Grand Slams,CLAY,3,David Ferrer,Andreas Seppi,David Ferrer,6-2; 7-6(2); 6-3,R32,142,4,5,66,106,48,66,21,40,4,6,15,69,106,1,3,60,101,35,60,22,41,8,13,14,57,101
2014-05-26 00:00:00.000,Roland Garros France Grand Slams,CLAY,3,Guillermo Garcia-Lopez,Donald Young,Guillermo Garcia-Lopez,6-2; 6-4; 2-6; 6-7(4); 6-4,R32,227,10,9,85,146,66,85,28,61,7,11,24,94,146,11,8,109,178,74,109,33,69,12,18,24,107,178
2014-05-26 00:00:00.000,Roland Garros France Grand Slams,CLAY,3,Gael Monfils,Fabio Fognini,Gael Monfils,5-7; 6-2; 6-4; 0-6; 6-2,R32,204,5,5,116,149,63,116,17,33,15,24,22,80,149,3,4,73,129,35,73,29,56,8,18,22,64,129
2014-05-26 00:00:00.000,Roland Garros France Grand Slams,CLAY,3,Fernando Verdasco,Richard Gasquet,Fernando Verdasco,6-3; 6-2; 6-3,R32,118,2,0,65,79,44,65,9,14,7,9,13,53,79,0,1,51,77,28,51,9,26,2,9,13,37,77
2014-05-26 00:00:00.000,Roland Garros France Grand Slams,CLAY,3,Andy Murray,Philipp Kohlschreiber,Andy Murray,3-6; 6-3; 6-3; 4-6; 12-10,R32,247,10,8,84,174,61,84,43,90,4,12,29,104,174,4,4,125,201,77,125,39,76,11,21,30,116,201
2014-05-26 00:00:00.000,Roland Garros France Grand Slams,CLAY,3,Tomas Berdych,Roberto Bautista Agut,Tomas Berdych,6-1; 6-2; 6-7(4); 6-4,R32,163,12,2,60,112,47,60,27,52,2,6,19,74,112,1,3,75,116,42,75,18,41,6,15,18,60,116
2014-05-26 00:00:00.000,Roland Garros France Grand Slams,CLAY,3,John Isner,Tommy Robredo,John Isner,7-6(13); 7-6(3); 6-7(5); 7-5,R32,198,17,4,124,179,95,124,35,55,13,13,24,130,179,7,2,113,144,90,113,24,31,5,6,24,114,144
2014-05-26 00:00:00.000,Roland Garros France Grand Slams,CLAY,3,Ernests Gulbis,Radek Stepanek,Ernests Gulbis,6-3; 6-2; 7-5,R32,119,19,5,47,75,44,47,17,28,1,1,15,61,75,3,2,58,97,36,58,22,39,8,12,14,58,97
2014-05-26 00:00:00.000,Roland Garros France Grand Slams,CLAY,3,Roger Federer,Dmitry Tursunov,Roger Federer,7-5; 6-7(7); 6-2; 6-4,R32,187,15,1,81,120,65,81,27,39,2,2,21,92,120,6,5,98,159,67,98,31,61,17,21,21,98,159
2014-05-26 00:00:00.000,Roland Garros France Grand Slams,CLAY,3,Milos Raonic,Gilles Simon,Milos Raonic,4-6; 6-3; 2-6; 6-2; 7-5,R32,196,19,7,94,152,70,94,24,58,10,15,24,94,152,8,2,75,130,49,75,31,55,6,12,23,80,130
2014-05-26 00:00:00.000,Roland Garros France Grand Slams,CLAY,3,Marcel Granollers,Martin Klizan,Marcel Granollers,6-7(5); 6-2; 7-6(4); 7-5,R32,254,6,5,93,160,63,93,32,67,16,22,22,95,160,0,7,100,194,64,100,38,94,14,23,22,102,194
2014-05-26 00:00:00.000,Roland Garros France Grand Slams,CLAY,3,Jo-Wilfried Tsonga,Jerzy Janowicz,Jo-Wilfried Tsonga,6-4; 6-4; 6-3,R32,121,4,0,45,83,34,45,23,38,1,3,15,57,83,5,9,50,88,35,50,16,38,3,8,14,51,88
2014-05-26 00:00:00.000,Roland Garros France Grand Slams,CLAY,3,Novak Djokovic,Marin Cilic,Novak Djokovic,6-3; 6-2; 6-7(2); 6-4,R32,191,5,3,90,138,62,90,26,48,8,11,20,88,138,5,5,68,137,48,68,30,69,15,22,19,78,137
2014-05-26 00:00:00.000,Roland Garros France Grand Slams,CLAY,3,Rafael Nadal,Dusan Lajovic,Rafael Nadal,6-1; 6-2; 6-1,R16,93,0,1,37,59,30,37,14,22,3,4,11,44,59,3,3,28,57,14,28,4,29,2,10,11,18,57
2014-05-26 00:00:00.000,Roland Garros France Grand Slams,CLAY,3,David Ferrer,Kevin Anderson,David Ferrer,6-3; 6-3; 6-7(5); 6-1,R16,171,2,4,89,123,66,89,16,34,5,7,19,82,123,9,4,81,126,52,81,18,45,9,16,18,70,126
2014-05-26 00:00:00.000,Roland Garros France Grand Slams,CLAY,3,Gael Monfils,Guillermo Garcia-Lopez,Gael Monfils,6-0; 6-2; 7-5,R16,118,4,6,45,77,34,45,18,32,2,4,13,52,77,0,0,42,82,21,42,16,40,9,17,13,37,82
2014-05-26 00:00:00.000,Roland Garros France Grand Slams,CLAY,3,Andy Murray,Fernando Verdasco,Andy Murray,6-4; 7-5; 7-6(3),R16,174,4,3,69,112,52,69,24,43,4,6,17,76,112,1,2,104,138,61,104,18,34,15,19,17,79,138
2014-05-26 00:00:00.000,Roland Garros France Grand Slams,CLAY,3,Tomas Berdych,John Isner,Tomas Berdych,6-4; 6-4; 6-4,R16,111,11,1,53,83,44,53,19,30,2,2,15,63,83,7,1,54,86,38,54,16,32,5,8,15,54,86
2014-05-26 00:00:00.000,Roland Garros France Grand Slams,CLAY,3,Ernests Gulbis,Roger Federer,Ernests Gulbis,6-7(5); 7-6(3); 6-2; 4-6; 6-3,R16,222,13,4,93,154,65,93,37,61,2,7,26,102,154,7,3,102,161,70,102,30,59,5,12,25,100,161
2014-05-26 00:00:00.000,Roland Garros France Grand Slams,CLAY,3,Milos Raonic,Marcel Granollers,Milos Raonic,6-3; 6-3; 6-3,R16,114,6,2,62,98,49,62,17,36,2,2,14,66,98,3,0,53,75,36,53,9,22,1,5,13,45,75
2014-05-26 00:00:00.000,Roland Garros France Grand Slams,CLAY,3,Novak Djokovic,Jo-Wilfried Tsonga,Novak Djokovic,6-1; 6-4; 6-1,R16,89,1,1,44,66,31,44,17,22,1,2,12,48,66,5,2,40,71,22,40,11,31,2,9,12,33,71
2014-05-26 00:00:00.000,Roland Garros France Grand Slams,CLAY,3,Rafael Nadal,David Ferrer,Rafael Nadal,4-6; 6-4; 6-0; 6-1,Q,154,1,1,63,102,43,63,22,39,11,14,16,65,102,2,1,60,95,32,60,15,35,5,14,17,47,95
2014-05-26 00:00:00.000,Roland Garros France Grand Slams,CLAY,3,Andy Murray,Gael Monfils,Andy Murray,6-4; 6-1; 4-6; 1-6; 6-0,Q,195,1,2,84,135,55,84,31,51,9,13,20,86,135,4,5,105,139,63,105,14,34,11,18,20,77,139
2014-05-26 00:00:00.000,Roland Garros France Grand Slams,CLAY,3,Ernests Gulbis,Tomas Berdych,Ernests Gulbis,6-3; 6-2; 6-4,Q,119,10,1,47,79,38,47,19,32,2,3,14,57,79,3,2,39,78,27,39,17,39,3,8,13,44,78
2014-05-26 00:00:00.000,Roland Garros France Grand Slams,CLAY,3,Novak Djokovic,Milos Raonic,Novak Djokovic,7-5; 7-6(5); 6-4,Q,142,4,1,67,98,50,67,23,31,1,2,17,73,98,21,4,80,114,63,80,10,34,6,9,17,73,114
2014-05-26 00:00:00.000,Roland Garros France Grand Slams,CLAY,3,Rafael Nadal,Andy Murray,Rafael Nadal,6-3; 6-2; 6-1,S,100,2,2,45,59,41,45,8,14,0,0,12,49,59,2,3,35,67,22,35,11,32,0,6,12,33,67
2014-05-26 00:00:00.000,Roland Garros France Grand Slams,CLAY,3,Novak Djokovic,Ernests Gulbis,Novak Djokovic,6-3; 6-3; 3-6; 6-3,S,154,9,1,74,111,59,74,16,37,5,7,18,75,111,13,5,60,105,42,60,24,45,5,10,18,66,105
2014-05-26 00:00:00.000,Roland Garros France Grand Slams,CLAY,3,Rafael Nadal,Novak Djokovic,Rafael Nadal,3-6; 7-5; 6-2; 6-4,F,211,3,4,84,120,61,84,18,36,6,9,19,79,120,11,3,82,126,59,82,16,44,4,10,20,75,126
2014-06-09 00:00:00.000,Halle Germany ATP World Tour 250,GRASS,2,Rafael Nadal,N/A Bye,Rafael Nadal,,R32,0,0,0,0,0,0,0,0,0,0,0,0,0,0,0,0,0,0,0,0,0,0,0,0,0,0,0
2014-06-09 00:00:00.000,Halle Germany ATP World Tour 250,GRASS,2,Dustin Brown,Andrey Kuznetsov,Dustin Brown,6-3; 6-4,R32,58,15,6,33,52,29,33,8,19,1,3,10,37,52,4,3,36,62,23,36,10,26,6,10,9,33,62
2014-06-09 00:00:00.000,Halle Germany ATP World Tour 250,GRASS,2,Philipp Kohlschreiber,Andreas Seppi,Philipp Kohlschreiber,6-3; 6-4,R32,69,9,0,40,61,31,40,13,21,3,3,10,44,61,9,0,31,49,20,31,10,18,0,2,9,30,49
2014-06-09 00:00:00.000,Halle Germany ATP World Tour 250,GRASS,2,Pierre-Hugues Herbert,Jerzy Janowicz,Pierre-Hugues Herbert,7-6(5); 6-2,R32,91,11,3,37,59,28,37,13,22,3,5,10,41,59,6,13,48,81,33,48,12,33,10,14,10,45,81
2014-06-09 00:00:00.000,Halle Germany ATP World Tour 250,GRASS,2,Milos Raonic,N/A Bye,Milos Raonic,,R32,0,0,0,0,0,0,0,0,0,0,0,0,0,0,0,0,0,0,0,0,0,0,0,0,0,0,0
2014-06-09 00:00:00.000,Halle Germany ATP World Tour 250,GRASS,2,Peter Gojowczyk,Michal Przysiezny,Peter Gojowczyk,7-5; 6-4,R32,76,12,3,37,59,32,37,13,22,2,2,11,45,59,12,3,50,71,38,50,8,21,6,8,11,46,71
2014-06-09 00:00:00.000,Halle Germany ATP World Tour 250,GRASS,2,Alejandro Falla,Lukasz Kubot,Alejandro Falla,6-2; 3-6; 6-3,R32,109,8,3,49,79,35,49,19,30,5,6,13,54,79,5,7,42,82,35,42,15,40,3,6,13,50,82
2014-06-09 00:00:00.000,Halle Germany ATP World Tour 250,GRASS,2,Robin Haase,Richard Gasquet,Robin Haase,6-4; 6-4,R32,70,13,0,38,56,31,38,11,18,0,0,10,42,56,2,0,50,64,35,50,6,14,1,3,10,41,64
2014-06-09 00:00:00.000,Halle Germany ATP World Tour 250,GRASS,2,Steve Johnson,Albano Olivetti,Steve Johnson,6-4; 6-2,R32,62,12,1,24,43,23,24,13,19,0,0,9,36,43,10,7,24,53,18,24,13,29,3,6,9,31,53
2014-06-09 00:00:00.000,Halle Germany ATP World Tour 250,GRASS,2,Teymuraz Gabashvili,Illya Marchenko,Teymuraz Gabashvili,6-7(9); 6-4; 7-6(4),R32,159,9,3,67,115,51,67,28,48,3,5,17,79,115,13,4,73,121,55,73,24,48,6,9,17,79,121
2014-06-09 00:00:00.000,Halle Germany ATP World Tour 250,GRASS,2,Gael Monfils,Benjamin Becker,Gael Monfils,6-1; 7-5,R32,74,9,2,38,55,32,38,11,17,3,3,10,43,55,4,5,43,76,25,43,17,33,9,12,9,42,76
2014-06-09 00:00:00.000,Halle Germany ATP World Tour 250,GRASS,2,Kei Nishikori,N/A Bye,Kei Nishikori,,R32,0,0,0,0,0,0,0,0,0,0,0,0,0,0,0,0,0,0,0,0,0,0,0,0,0,0,0
2014-06-09 00:00:00.000,Halle Germany ATP World Tour 250,GRASS,2,Ivo Karlovic,Mikhail Youzhny,Ivo Karlovic,6-3; 6-4,R32,63,22,0,38,52,32,38,10,14,1,1,10,42,52,2,0,36,49,24,36,8,13,1,3,9,32,49
2014-06-09 00:00:00.000,Halle Germany ATP World Tour 250,GRASS,2,Yen-Hsun Lu,Mate Pavic,Yen-Hsun Lu,7-6(2); 6-7(11); 7-6(5),R32,164,3,7,80,127,61,80,30,47,4,6,18,91,127,21,6,99,154,71,99,28,55,10,12,18,99,154
2014-06-09 00:00:00.000,Halle Germany ATP World Tour 250,GRASS,2,Joao Sousa,Jan-Lennard Struff,Joao Sousa,6-4; 6-2,R32,70,2,0,38,51,30,38,9,13,2,2,9,39,51,6,5,43,71,30,43,10,28,7,10,9,40,71
2014-06-09 00:00:00.000,Halle Germany ATP World Tour 250,GRASS,2,Roger Federer,N/A Bye,Roger Federer,,R32,0,0,0,0,0,0,0,0,0,0,0,0,0,0,0,0,0,0,0,0,0,0,0,0,0,0,0
2014-06-09 00:00:00.000,Halle Germany ATP World Tour 250,GRASS,2,Dustin Brown,Rafael Nadal,Dustin Brown,6-4; 6-1,R16,60,11,5,31,51,26,31,12,20,1,1,9,38,51,2,0,32,47,22,32,6,15,6,9,8,28,47
2014-06-09 00:00:00.000,Halle Germany ATP World Tour 250,GRASS,2,Philipp Kohlschreiber,Pierre-Hugues Herbert,Philipp Kohlschreiber,6-2; 6-4,R16,61,2,0,35,47,25,35,12,12,0,0,9,37,47,4,2,27,50,15,27,15,23,2,5,9,30,50
2014-06-09 00:00:00.000,Halle Germany ATP World Tour 250,GRASS,2,Peter Gojowczyk,Milos Raonic,Peter Gojowczyk,6-4; 6-4,R16,72,4,2,38,56,31,38,10,18,2,2,10,41,56,8,2,39,60,28,39,11,21,1,3,10,39,60
2014-06-09 00:00:00.000,Halle Germany ATP World Tour 250,GRASS,2,Alejandro Falla,Robin Haase,Alejandro Falla,7-6(1); 6-4,R16,82,1,2,46,69,34,46,15,23,2,3,11,49,69,3,0,41,64,28,41,14,23,0,2,11,42,64
2014-06-09 00:00:00.000,Halle Germany ATP World Tour 250,GRASS,2,Steve Johnson,Teymuraz Gabashvili,Steve Johnson,W/O,R16,0,0,0,0,0,0,0,0,0,0,0,0,0,0,0,0,0,0,0,0,0,0,0,0,0,0,0
2014-06-09 00:00:00.000,Halle Germany ATP World Tour 250,GRASS,2,Kei Nishikori,Gael Monfils,Kei Nishikori,6-1; 3-6; 6-3,R16,89,2,1,48,71,36,48,12,23,4,6,13,48,71,8,5,49,74,34,49,11,25,3,7,12,45,74
2014-06-09 00:00:00.000,Halle Germany ATP World Tour 250,GRASS,2,Yen-Hsun Lu,Ivo Karlovic,Yen-Hsun Lu,7-6(2); 7-6(3),R16,89,6,4,54,78,46,54,15,24,2,2,12,61,78,21,1,51,72,44,51,10,21,0,0,12,54,72
2014-06-09 00:00:00.000,Halle Germany ATP World Tour 250,GRASS,2,Roger Federer,Joao Sousa,Roger Federer,6-7(8); 6-4; 6-2,R16,110,11,1,72,87,57,72,11,15,2,2,15,68,87,3,1,79,113,51,79,20,34,9,12,15,71,113
2014-06-09 00:00:00.000,Halle Germany ATP World Tour 250,GRASS,2,Philipp Kohlschreiber,Dustin Brown,Philipp Kohlschreiber,6-4; 5-7; 7-6(16),Q,131,8,3,84,118,63,84,14,34,2,6,17,77,118,19,13,72,120,58,72,20,48,3,7,17,78,120
2014-06-09 00:00:00.000,Halle Germany ATP World Tour 250,GRASS,2,Alejandro Falla,Peter Gojowczyk,Alejandro Falla,7-6(4); 7-6(2),Q,106,6,1,53,86,39,53,17,33,4,6,12,56,86,11,3,64,95,47,64,12,31,3,5,12,59,95
2014-06-09 00:00:00.000,Halle Germany ATP World Tour 250,GRASS,2,Kei Nishikori,Steve Johnson,Kei Nishikori,6-1; 7-6(4),Q,79,2,2,42,69,33,42,16,27,5,5,10,49,69,7,0,31,55,26,31,10,24,5,7,9,36,55
2014-06-09 00:00:00.000,Halle Germany ATP World Tour 250,GRASS,2,Roger Federer,Yen-Hsun Lu,Roger Federer,W/O,Q,0,0,0,0,0,0,0,0,0,0,0,0,0,0,0,0,0,0,0,0,0,0,0,0,0,0,0
2014-06-09 00:00:00.000,Halle Germany ATP World Tour 250,GRASS,2,Alejandro Falla,Philipp Kohlschreiber,Alejandro Falla,5-7; 7-6(5); 6-4,S,142,8,8,77,134,57,77,27,57,6,9,17,84,134,9,3,69,94,54,69,12,25,0,3,17,66,94
2014-06-09 00:00:00.000,Halle Germany ATP World Tour 250,GRASS,2,Roger Federer,Kei Nishikori,Roger Federer,6-3; 7-6(4),S,73,10,2,53,70,37,53,11,17,1,2,11,48,70,1,0,37,54,24,37,14,17,0,2,10,38,54
2014-06-09 00:00:00.000,Halle Germany ATP World Tour 250,GRASS,2,Roger Federer,Alejandro Falla,Roger Federer,7-6(2); 7-6(3),F,88,5,2,46,75,38,46,17,29,3,5,12,55,75,5,0,49,76,38,49,11,27,0,2,12,49,76
2014-06-09 00:00:00.000,London / Queen's Club Great Britain ATP World Tour 250,GRASS,2,Stan Wawrinka,N/A Bye,Stan Wawrinka,,R64,0,0,0,0,0,0,0,0,0,0,0,0,0,0,0,0,0,0,0,0,0,0,0,0,0,0,0
2014-06-09 00:00:00.000,London / Queen's Club Great Britain ATP World Tour 250,GRASS,2,Marcos Baghdatis,Bradley Klahn,Marcos Baghdatis,6-7(6); 6-2; 6-1,R64,102,9,3,47,87,37,47,22,40,3,4,14,59,87,6,7,65,95,38,65,12,30,7,12,13,50,95
2014-06-09 00:00:00.000,London / Queen's Club Great Britain ATP World Tour 250,GRASS,2,Denis Kudla,Michael Russell,Denis Kudla,4-6; 6-3; 6-1,R64,108,4,1,43,85,31,43,28,42,5,6,13,59,85,12,2,67,101,42,67,16,34,7,11,13,58,101
2014-06-09 00:00:00.000,London / Queen's Club Great Britain ATP World Tour 250,GRASS,2,Sam Querrey,Jeremy Chardy,Sam Querrey,6-7(4); 7-6(4); 7-6(5),R64,124,31,2,79,120,68,79,25,41,4,4,18,93,120,25,4,77,109,68,77,20,32,1,1,18,88,109
2014-06-09 00:00:00.000,London / Queen's Club Great Britain ATP World Tour 250,GRASS,2,Marinko Matosevic,Marin Cilic,Marinko Matosevic,6-4; 6-4,R64,77,4,1,39,57,32,39,10,18,2,2,10,42,57,8,1,30,60,22,30,16,30,3,5,10,38,60
2014-06-09 00:00:00.000,London / Queen's Club Great Britain ATP World Tour 250,GRASS,2,Lukas Lacko,Matthew Ebden,Lukas Lacko,7-6(10); 5-7; 6-4,R64,112,5,3,64,103,51,64,18,39,0,3,17,69,103,4,5,71,93,52,71,14,22,0,3,17,66,93
2014-06-09 00:00:00.000,London / Queen's Club Great Britain ATP World Tour 250,GRASS,2,David Goffin,Dominic Thiem,David Goffin,6-4; 6-2,R64,65,3,2,32,50,25,32,12,18,0,0,9,37,50,4,1,34,58,23,34,12,24,5,8,9,35,58
2014-06-09 00:00:00.000,London / Queen's Club Great Britain ATP World Tour 250,GRASS,2,Jo-Wilfried Tsonga,N/A Bye,Jo-Wilfried Tsonga,,R64,0,0,0,0,0,0,0,0,0,0,0,0,0,0,0,0,0,0,0,0,0,0,0,0,0,0,0
2014-06-09 00:00:00.000,London / Queen's Club Great Britain ATP World Tour 250,GRASS,2,Grigor Dimitrov,N/A Bye,Grigor Dimitrov,,R64,0,0,0,0,0,0,0,0,0,0,0,0,0,0,0,0,0,0,0,0,0,0,0,0,0,0,0
2014-06-09 00:00:00.000,London / Queen's Club Great Britain ATP World Tour 250,GRASS,2,James Ward,Blaz Rola,James Ward,7-5; 6-4,R64,88,2,3,52,73,35,52,13,21,2,3,11,48,73,5,2,41,64,31,41,7,23,1,4,11,38,64
2014-06-09 00:00:00.000,London / Queen's Club Great Britain ATP World Tour 250,GRASS,2,Edouard Roger-Vasselin,Evgeny Donskoy,Edouard Roger-Vasselin,6-3; 6-7(9); 6-1,R64,102,9,5,63,94,54,63,16,31,0,0,15,70,94,4,4,53,79,35,53,15,26,1,4,13,50,79
2014-06-09 00:00:00.000,London / Queen's Club Great Britain ATP World Tour 250,GRASS,2,Nicolas Mahut,Marsel Ilhan,Nicolas Mahut,6-3; 6-4,R64,67,15,3,44,56,37,44,6,12,0,0,10,43,56,6,1,38,59,23,38,15,21,5,7,9,38,59
2014-06-09 00:00:00.000,London / Queen's Club Great Britain ATP World Tour 250,GRASS,2,Dmitry Tursunov,Igor Sijsling,Dmitry Tursunov,6-3; 6-4,R64,54,6,1,33,54,26,33,16,21,2,2,10,42,54,4,4,31,51,23,31,9,20,1,3,9,32,51
2014-06-09 00:00:00.000,London / Queen's Club Great Britain ATP World Tour 250,GRASS,2,Jarkko Nieminen,Benoit Paire,Jarkko Nieminen,2-6; 6-3; 7-6(1),R64,101,5,5,53,94,34,53,22,41,1,6,15,56,94,14,5,61,101,45,61,13,40,5,9,14,58,101
2014-06-09 00:00:00.000,London / Queen's Club Great Britain ATP World Tour 250,GRASS,2,Denis Istomin,Farrukh Dustov,Denis Istomin,7-6(9); 6-3,R64,85,10,2,57,76,43,57,7,19,1,3,11,50,76,1,2,50,68,32,50,8,18,2,5,10,40,68
2014-06-09 00:00:00.000,London / Queen's Club Great Britain ATP World Tour 250,GRASS,2,Alexandr Dolgopolov,N/A Bye,Alexandr Dolgopolov,,R64,0,0,0,0,0,0,0,0,0,0,0,0,0,0,0,0,0,0,0,0,0,0,0,0,0,0,0
2014-06-09 00:00:00.000,London / Queen's Club Great Britain ATP World Tour 250,GRASS,2,Kevin Anderson,N/A Bye,Kevin Anderson,,R64,0,0,0,0,0,0,0,0,0,0,0,0,0,0,0,0,0,0,0,0,0,0,0,0,0,0,0
2014-06-09 00:00:00.000,London / Queen's Club Great Britain ATP World Tour 250,GRASS,2,Daniel Evans,Jurgen Melzer,Daniel Evans,6-3; 6-7(5); 7-6(2),R64,131,18,7,65,112,58,65,20,47,4,6,17,78,112,11,4,68,101,53,68,13,33,3,6,16,66,101
2014-06-09 00:00:00.000,London / Queen's Club Great Britain ATP World Tour 250,GRASS,2,Sergiy Stakhovsky,Daniel Brands,Sergiy Stakhovsky,7-5; 6-2,R64,60,8,2,41,55,33,41,8,14,2,2,10,41,55,6,0,36,53,24,36,10,17,1,4,10,34,53
2014-06-09 00:00:00.000,London / Queen's Club Great Britain ATP World Tour 250,GRASS,2,Vasek Pospisil,Paolo Lorenzi,Vasek Pospisil,6-3; 3-6; 6-3,R64,109,5,4,59,86,42,59,12,27,5,7,14,54,86,1,3,46,77,33,46,15,31,3,6,13,48,77
2014-06-09 00:00:00.000,London / Queen's Club Great Britain ATP World Tour 250,GRASS,2,Radek Stepanek,Mikhail Kukushkin,Radek Stepanek,6-4; 6-1,R64,78,9,1,41,62,31,41,10,21,4,5,9,41,62,1,0,40,60,21,40,8,20,4,8,8,29,60
2014-06-09 00:00:00.000,London / Queen's Club Great Britain ATP World Tour 250,GRASS,2,Bernard Tomic,Tim Smyczek,Bernard Tomic,6-4; 3-6; 7-5,R64,93,10,1,59,77,46,59,7,18,2,4,15,53,77,7,2,65,93,45,65,14,28,4,7,16,59,93
2014-06-09 00:00:00.000,London / Queen's Club Great Britain ATP World Tour 250,GRASS,2,Paul-Henri Mathieu,Aljaz Bedene,Paul-Henri Mathieu,7-6(2); 6-4,R64,83,9,2,36,59,31,36,18,23,0,0,11,49,59,18,2,41,69,36,41,13,28,2,3,11,49,69
2014-06-09 00:00:00.000,London / Queen's Club Great Britain ATP World Tour 250,GRASS,2,Andy Murray,N/A Bye,Andy Murray,,R64,0,0,0,0,0,0,0,0,0,0,0,0,0,0,0,0,0,0,0,0,0,0,0,0,0,0,0
2014-06-09 00:00:00.000,London / Queen's Club Great Britain ATP World Tour 250,GRASS,2,Ernests Gulbis,N/A Bye,Ernests Gulbis,,R64,0,0,0,0,0,0,0,0,0,0,0,0,0,0,0,0,0,0,0,0,0,0,0,0,0,0,0
2014-06-09 00:00:00.000,London / Queen's Club Great Britain ATP World Tour 250,GRASS,2,Kenny De Schepper,Somdev Devvarman,Kenny De Schepper,6-4; 7-5,R64,75,14,1,43,60,35,43,11,17,0,0,11,46,60,2,0,39,60,27,39,14,21,4,6,11,41,60
2014-06-09 00:00:00.000,London / Queen's Club Great Britain ATP World Tour 250,GRASS,2,Lleyton Hewitt,Daniel Gimeno-Traver,Lleyton Hewitt,6-3; 6-3,R64,69,3,2,29,51,24,29,14,22,3,3,9,38,51,3,1,44,60,25,44,8,16,1,4,9,33,60
2014-06-09 00:00:00.000,London / Queen's Club Great Britain ATP World Tour 250,GRASS,2,Feliciano Lopez,Dusan Lajovic,Feliciano Lopez,6-3; 6-7(3); 6-1,R64,116,16,6,53,101,40,53,24,48,6,8,15,64,101,3,4,53,94,37,53,14,41,5,10,13,51,94
2014-06-09 00:00:00.000,London / Queen's Club Great Britain ATP World Tour 250,GRASS,2,Victor Estrella Burgos,Julien Benneteau,Victor Estrella Burgos,6-7(3); 6-3; 7-6(3),R64,137,12,4,73,117,57,73,22,44,4,5,17,79,117,12,3,62,94,49,62,19,32,3,5,16,68,94
2014-06-09 00:00:00.000,London / Queen's Club Great Britain ATP World Tour 250,GRASS,2,Adrian Mannarino,Daniel Cox,Adrian Mannarino,7-5; 6-2,R64,64,5,4,39,58,31,39,8,19,1,3,10,39,58,4,3,32,53,18,32,10,21,3,8,10,28,53
2014-06-09 00:00:00.000,London / Queen's Club Great Britain ATP World Tour 250,GRASS,2,James Duckworth,Dudi Sela,James Duckworth,0-6; 7-6(5); 6-4,R64,106,11,3,67,104,43,67,20,37,7,10,14,63,104,6,3,52,79,40,52,19,27,1,2,14,59,79
2014-06-09 00:00:00.000,London / Queen's Club Great Britain ATP World Tour 250,GRASS,2,Tomas Berdych,N/A Bye,Tomas Berdych,,R64,0,0,0,0,0,0,0,0,0,0,0,0,0,0,0,0,0,0,0,0,0,0,0,0,0,0,0
2014-06-09 00:00:00.000,London / Queen's Club Great Britain ATP World Tour 250,GRASS,2,Stan Wawrinka,Marcos Baghdatis,Stan Wawrinka,3-2 RET,R32,18,4,1,8,15,7,8,5,7,0,0,3,12,15,0,0,9,11,7,9,1,2,0,0,2,8,11
2014-06-09 00:00:00.000,London / Queen's Club Great Britain ATP World Tour 250,GRASS,2,Sam Querrey,Denis Kudla,Sam Querrey,6-4; 6-3,R32,59,14,2,38,52,33,38,8,14,0,0,10,41,52,4,3,43,61,30,43,7,18,5,7,9,37,61
2014-06-09 00:00:00.000,London / Queen's Club Great Britain ATP World Tour 250,GRASS,2,Marinko Matosevic,Lukas Lacko,Marinko Matosevic,7-6(3); 6-3,R32,72,14,2,41,60,34,41,12,19,0,1,11,46,60,3,2,40,63,27,40,11,23,0,2,10,38,63
2014-06-09 00:00:00.000,London / Queen's Club Great Britain ATP World Tour 250,GRASS,2,Jo-Wilfried Tsonga,David Goffin,Jo-Wilfried Tsonga,7-6(5); 6-2,R32,82,9,2,39,64,32,39,17,25,3,3,10,49,64,4,2,46,65,33,46,11,19,4,6,10,44,65
2014-06-09 00:00:00.000,London / Queen's Club Great Britain ATP World Tour 250,GRASS,2,Grigor Dimitrov,James Ward,Grigor Dimitrov,7-5; 6-3,R32,68,8,5,39,57,32,39,11,18,1,2,11,43,57,1,2,50,60,33,50,4,10,3,6,10,37,60
2014-06-09 00:00:00.000,London / Queen's Club Great Britain ATP World Tour 250,GRASS,2,Edouard Roger-Vasselin,Nicolas Mahut,Edouard Roger-Vasselin,6-3; 1-6; 7-6(5),R32,119,7,1,69,102,47,69,18,33,6,8,14,65,102,18,3,61,87,47,61,14,26,2,3,14,61,87
2014-06-09 00:00:00.000,London / Queen's Club Great Britain ATP World Tour 250,GRASS,2,Jarkko Nieminen,Dmitry Tursunov,Jarkko Nieminen,7-6(3); 7-6(3),R32,100,1,1,58,70,45,58,7,12,2,4,12,52,70,9,5,62,97,50,62,7,35,3,5,12,57,97
2014-06-09 00:00:00.000,London / Queen's Club Great Britain ATP World Tour 250,GRASS,2,Alexandr Dolgopolov,Denis Istomin,Alexandr Dolgopolov,7-6(3); 7-6(7),R32,111,11,4,65,97,48,65,17,32,6,7,12,65,97,7,1,83,102,51,83,12,19,7,8,12,63,102
2014-06-09 00:00:00.000,London / Queen's Club Great Britain ATP World Tour 250,GRASS,2,Kevin Anderson,Daniel Evans,Kevin Anderson,6-2; 6-3,R32,65,10,5,34,57,32,34,8,23,1,1,9,40,57,2,2,30,49,18,30,11,19,4,7,8,29,49
2014-06-09 00:00:00.000,London / Queen's Club Great Britain ATP World Tour 250,GRASS,2,Sergiy Stakhovsky,Vasek Pospisil,Sergiy Stakhovsky,6-4; 6-4,R32,65,2,2,35,58,28,35,13,23,2,3,10,41,58,4,4,37,55,28,37,6,18,2,5,10,34,55
2014-06-09 00:00:00.000,London / Queen's Club Great Britain ATP World Tour 250,GRASS,2,Radek Stepanek,Bernard Tomic,Radek Stepanek,7-6(4); 7-6(5),R32,104,8,2,59,82,46,59,11,23,2,3,12,57,82,2,0,56,89,38,56,18,33,5,6,12,56,89
2014-06-09 00:00:00.000,London / Queen's Club Great Britain ATP World Tour 250,GRASS,2,Andy Murray,Paul-Henri Mathieu,Andy Murray,6-4; 6-4,R32,87,10,2,38,56,35,38,7,18,3,3,10,42,56,5,6,45,81,32,45,15,36,5,7,10,47,81
2014-06-09 00:00:00.000,London / Queen's Club Great Britain ATP World Tour 250,GRASS,2,Kenny De Schepper,Ernests Gulbis,Kenny De Schepper,7-6(3); 7-5,R32,78,10,4,58,72,50,58,7,14,6,6,12,57,72,9,2,46,67,39,46,10,21,1,2,12,49,67
2014-06-09 00:00:00.000,London / Queen's Club Great Britain ATP World Tour 250,GRASS,2,Feliciano Lopez,Lleyton Hewitt,Feliciano Lopez,6-3; 6-4,R32,67,10,4,28,52,24,28,16,24,0,0,10,40,52,6,4,25,47,19,25,11,22,1,3,9,30,47
2014-06-09 00:00:00.000,London / Queen's Club Great Britain ATP World Tour 250,GRASS,2,Adrian Mannarino,Victor Estrella Burgos,Adrian Mannarino,6-1; 6-2,R32,56,6,0,36,50,27,36,9,14,3,3,8,36,50,3,1,27,42,14,27,5,15,2,6,7,19,42
2014-06-09 00:00:00.000,London / Queen's Club Great Britain ATP World Tour 250,GRASS,2,Tomas Berdych,James Duckworth,Tomas Berdych,7-6(3); 5-7; 6-4,R32,127,19,8,56,97,48,56,20,41,0,2,17,68,97,8,4,75,117,55,75,20,42,5,7,17,75,117
2014-06-09 00:00:00.000,London / Queen's Club Great Britain ATP World Tour 250,GRASS,2,Stan Wawrinka,Sam Querrey,Stan Wawrinka,6-2; 6-2,R16,50,7,1,26,42,21,26,11,16,0,0,8,32,42,3,4,24,48,13,24,14,24,2,6,8,27,48
2014-06-09 00:00:00.000,London / Queen's Club Great Britain ATP World Tour 250,GRASS,2,Marinko Matosevic,Jo-Wilfried Tsonga,Marinko Matosevic,6-2; 6-4,R16,75,1,1,26,48,21,26,17,22,3,3,9,38,48,4,2,38,64,24,38,11,26,5,8,9,35,64
2014-06-09 00:00:00.000,London / Queen's Club Great Britain ATP World Tour 250,GRASS,2,Grigor Dimitrov,Edouard Roger-Vasselin,Grigor Dimitrov,7-6(3); 6-4,R16,82,15,3,41,63,36,41,10,22,1,2,11,46,63,5,4,57,83,38,57,12,26,4,6,11,50,83
2014-06-09 00:00:00.000,London / Queen's Club Great Britain ATP World Tour 250,GRASS,2,Alexandr Dolgopolov,Jarkko Nieminen,Alexandr Dolgopolov,6-4; 4-2 RET,R16,56,11,2,28,53,23,28,14,25,4,4,8,37,53,4,2,35,48,20,35,7,13,2,4,8,27,48
2014-06-09 00:00:00.000,London / Queen's Club Great Britain ATP World Tour 250,GRASS,2,Kevin Anderson,Sergiy Stakhovsky,Kevin Anderson,6-3; 3-6; 7-6(4),R16,117,12,2,47,81,38,47,21,34,0,2,15,59,81,10,4,75,114,56,75,15,39,9,11,15,71,114
2014-06-09 00:00:00.000,London / Queen's Club Great Britain ATP World Tour 250,GRASS,2,Radek Stepanek,Andy Murray,Radek Stepanek,7-6(10); 6-2,R16,115,11,4,42,67,38,42,8,25,1,2,10,46,67,6,5,60,94,38,60,15,34,4,7,10,53,94
2014-06-09 00:00:00.000,London / Queen's Club Great Britain ATP World Tour 250,GRASS,2,Feliciano Lopez,Kenny De Schepper,Feliciano Lopez,7-6(3); 6-7(4); 7-6(3),R16,128,15,2,76,107,67,76,18,31,0,0,18,85,107,24,3,89,116,74,89,12,27,4,4,18,86,116
2014-06-09 00:00:00.000,London / Queen's Club Great Britain ATP World Tour 250,GRASS,2,Tomas Berdych,Adrian Mannarino,Tomas Berdych,7-6(2); 6-4,R16,124,13,2,34,60,34,34,14,26,2,3,11,48,60,8,2,75,125,45,75,24,50,17,19,11,69,125
2014-06-09 00:00:00.000,London / Queen's Club Great Britain ATP World Tour 250,GRASS,2,Stan Wawrinka,Marinko Matosevic,Stan Wawrinka,7-5; 6-3,Q,70,10,3,33,59,27,33,18,26,0,0,11,45,59,2,1,31,57,26,31,11,26,3,5,10,37,57
2014-06-09 00:00:00.000,London / Queen's Club Great Britain ATP World Tour 250,GRASS,2,Grigor Dimitrov,Alexandr Dolgopolov,Grigor Dimitrov,W/O,Q,0,0,0,0,0,0,0,0,0,0,0,0,0,0,0,0,0,0,0,0,0,0,0,0,0,0,0
2014-06-09 00:00:00.000,London / Queen's Club Great Britain ATP World Tour 250,GRASS,2,Radek Stepanek,Kevin Anderson,Radek Stepanek,1-6; 6-3; 6-2,Q,97,5,1,49,71,36,49,12,22,3,5,12,48,71,15,1,48,74,36,48,9,26,2,5,12,45,74
2014-06-09 00:00:00.000,London / Queen's Club Great Britain ATP World Tour 250,GRASS,2,Feliciano Lopez,Tomas Berdych,Feliciano Lopez,6-4; 7-6(7),Q,97,13,2,48,65,43,48,8,17,1,1,11,51,65,7,4,46,74,36,46,13,28,3,4,11,49,74
2014-06-09 00:00:00.000,London / Queen's Club Great Britain ATP World Tour 250,GRASS,2,Grigor Dimitrov,Stan Wawrinka,Grigor Dimitrov,6-2; 6-4,S,62,9,2,33,53,28,33,11,20,4,4,9,39,53,6,2,33,50,24,33,7,17,4,7,9,31,50
2014-06-09 00:00:00.000,London / Queen's Club Great Britain ATP World Tour 250,GRASS,2,Feliciano Lopez,Radek Stepanek,Feliciano Lopez,7-6(7); 6-4,S,102,6,1,41,70,33,41,21,29,1,1,11,54,70,10,3,45,79,34,45,19,34,5,6,11,53,79
2014-06-09 00:00:00.000,London / Queen's Club Great Britain ATP World Tour 250,GRASS,2,Grigor Dimitrov,Feliciano Lopez,Grigor Dimitrov,6-7(8); 7-6(1); 7-6(6),F,151,27,6,86,117,74,86,13,31,1,2,18,87,117,13,5,91,127,72,91,15,36,2,3,18,87,127
2014-06-15 00:00:00.000,s-Hertogenbosch Netherlands ATP World Tour 250,GRASS,2,Joao Sousa,Paolo Lorenzi,Joao Sousa,6-3; 3-6; 6-3,R32,138,1,2,73,112,47,73,14,39,11,16,14,61,112,3,2,56,92,32,56,15,36,5,11,13,47,92
2014-06-15 00:00:00.000,s-Hertogenbosch Netherlands ATP World Tour 250,GRASS,2,Mate Pavic,Alejandro Gonzalez,Mate Pavic,7-6(4); 6-3,R32,81,11,0,55,78,42,55,8,23,2,3,11,50,78,1,1,42,57,29,42,6,15,1,3,10,35,57
2014-06-15 00:00:00.000,s-Hertogenbosch Netherlands ATP World Tour 250,GRASS,2,Thiemo de Bakker,Igor Sijsling,Thiemo de Bakker,6-4; 7-6(4),R32,77,8,1,49,76,36,49,15,27,2,4,11,51,76,4,5,49,74,35,49,10,25,1,4,11,45,74
2014-06-15 00:00:00.000,s-Hertogenbosch Netherlands ATP World Tour 250,GRASS,2,Dmitry Tursunov,Bradley Klahn,Dmitry Tursunov,6-3; 7-6(3),R32,77,8,2,46,68,32,46,16,22,2,3,11,48,68,6,5,44,69,30,44,12,25,5,7,10,42,69
2014-06-15 00:00:00.000,s-Hertogenbosch Netherlands ATP World Tour 250,GRASS,2,Benjamin Becker,Marcel Granollers,Benjamin Becker,4-6; 6-3; 6-4,R32,105,7,2,53,97,41,53,23,44,8,10,15,64,97,9,3,66,94,44,66,11,28,7,10,14,55,94
2014-06-15 00:00:00.000,s-Hertogenbosch Netherlands ATP World Tour 250,GRASS,2,Dudi Sela,Benoit Paire,Dudi Sela,6-4; 7-6(2),R32,77,3,3,54,73,40,54,12,19,3,4,11,52,73,7,0,42,67,29,42,14,25,2,4,11,43,67
2014-06-15 00:00:00.000,s-Hertogenbosch Netherlands ATP World Tour 250,GRASS,2,Jan-Lennard Struff,Lukas Rosol,Jan-Lennard Struff,6-4; 6-2,R32,59,5,2,33,54,26,33,10,21,2,3,9,36,54,4,3,31,49,17,31,8,18,0,4,9,25,49
2014-06-15 00:00:00.000,s-Hertogenbosch Netherlands ATP World Tour 250,GRASS,2,Vasek Pospisil,Dusan Lajovic,Vasek Pospisil,6-4; 7-5,R32,86,7,2,41,66,34,41,14,25,2,2,11,48,66,3,1,46,63,31,46,9,17,4,6,11,40,63
2014-06-15 00:00:00.000,s-Hertogenbosch Netherlands ATP World Tour 250,GRASS,2,Nicolas Mahut,Kimmer Coppejans,Nicolas Mahut,6-3; 3-6; 6-3,R32,99,9,4,48,76,38,48,16,28,2,4,14,54,76,4,3,51,81,33,51,18,30,6,9,13,51,81
2014-06-15 00:00:00.000,s-Hertogenbosch Netherlands ATP World Tour 250,GRASS,2,Steve Johnson,Kenny De Schepper,Steve Johnson,7-6(3); 7-5,R32,95,5,2,48,77,41,48,16,29,1,1,12,57,77,15,1,54,79,39,54,15,25,3,4,12,54,79
2014-06-15 00:00:00.000,s-Hertogenbosch Netherlands ATP World Tour 250,GRASS,2,Matthew Ebden,Adrian Mannarino,Matthew Ebden,6-3; 4-6; 6-3,R32,97,4,6,53,88,39,53,15,35,4,7,14,54,88,9,3,51,72,35,51,9,21,5,10,14,44,72
2014-06-15 00:00:00.000,s-Hertogenbosch Netherlands ATP World Tour 250,GRASS,2,Roberto Bautista Agut,Daniel Gimeno-Traver,Roberto Bautista Agut,6-1; 6-3,R32,60,0,1,29,50,23,29,11,21,2,3,8,34,50,1,4,24,46,11,24,8,22,4,9,8,19,46
2014-06-15 00:00:00.000,s-Hertogenbosch Netherlands ATP World Tour 250,GRASS,2,Jurgen Melzer,Alejandro Falla,Jurgen Melzer,6-4; 6-3,R32,79,3,2,33,55,25,33,8,22,4,7,9,33,55,2,2,40,69,18,40,12,29,11,17,10,30,69
2014-06-15 00:00:00.000,s-Hertogenbosch Netherlands ATP World Tour 250,GRASS,2,Lukas Lacko,Victor Hanescu,Lukas Lacko,6-3; 6-4,R32,84,4,2,32,50,27,32,8,18,2,4,10,35,50,3,0,50,64,28,50,5,14,5,9,9,33,64
2014-06-15 00:00:00.000,s-Hertogenbosch Netherlands ATP World Tour 250,GRASS,2,Jesse Huta Galung,Aleksandr Nedovyesov,Jesse Huta Galung,6-2; 1-0 RET,R32,37,1,0,19,23,15,19,2,4,0,0,4,17,23,0,0,31,39,17,31,2,8,2,5,5,19,39
2014-06-15 00:00:00.000,s-Hertogenbosch Netherlands ATP World Tour 250,GRASS,2,Fernando Verdasco,Paul-Henri Mathieu,Fernando Verdasco,2-6; 6-4; 6-4,R32,113,13,15,47,100,38,47,24,53,11,13,14,62,100,5,3,51,78,39,51,15,27,4,6,14,54,78
2014-06-15 00:00:00.000,s-Hertogenbosch Netherlands ATP World Tour 250,GRASS,2,Joao Sousa,Mate Pavic,Joao Sousa,6-2; 6-4,R16,60,5,0,25,41,22,25,14,16,0,0,9,36,41,5,3,43,66,27,43,9,23,2,5,9,36,66
2014-06-15 00:00:00.000,s-Hertogenbosch Netherlands ATP World Tour 250,GRASS,2,Thiemo de Bakker,Dmitry Tursunov,Thiemo de Bakker,W/O,R16,0,0,0,0,0,0,0,0,0,0,0,0,0,0,0,0,0,0,0,0,0,0,0,0,0,0,0
2014-06-15 00:00:00.000,s-Hertogenbosch Netherlands ATP World Tour 250,GRASS,2,Benjamin Becker,Dudi Sela,Benjamin Becker,6-2; 7-5,R16,76,8,4,41,61,30,41,6,20,2,6,10,36,61,1,2,45,76,19,45,12,31,6,13,10,31,76
2014-06-15 00:00:00.000,s-Hertogenbosch Netherlands ATP World Tour 250,GRASS,2,Vasek Pospisil,Jan-Lennard Struff,Vasek Pospisil,6-4; 6-2,R16,65,11,2,35,54,29,35,9,19,2,3,9,38,54,2,1,35,53,21,35,9,18,2,6,9,30,53
2014-06-15 00:00:00.000,s-Hertogenbosch Netherlands ATP World Tour 250,GRASS,2,Nicolas Mahut,Steve Johnson,Nicolas Mahut,6-2; 7-6(4),R16,72,14,2,36,54,33,36,11,18,0,0,10,44,54,6,2,41,63,30,41,11,22,3,5,10,41,63
2014-06-15 00:00:00.000,s-Hertogenbosch Netherlands ATP World Tour 250,GRASS,2,Roberto Bautista Agut,Matthew Ebden,Roberto Bautista Agut,7-5; 7-6(1),R16,106,1,0,56,76,39,56,12,20,2,5,12,51,76,6,8,54,83,36,54,11,29,3,7,12,47,83
2014-06-15 00:00:00.000,s-Hertogenbosch Netherlands ATP World Tour 250,GRASS,2,Jurgen Melzer,Lukas Lacko,Jurgen Melzer,5-7; 6-3; 6-3,R16,116,4,0,68,92,48,68,14,24,4,6,15,62,92,8,4,54,85,35,54,17,31,3,7,15,52,85
2014-06-15 00:00:00.000,s-Hertogenbosch Netherlands ATP World Tour 250,GRASS,2,Fernando Verdasco,Jesse Huta Galung,Fernando Verdasco,7-5; 6-3,R16,72,7,3,40,62,34,40,12,22,1,1,11,46,62,3,1,37,55,25,37,11,18,4,6,10,36,55
2014-06-15 00:00:00.000,s-Hertogenbosch Netherlands ATP World Tour 250,GRASS,2,Joao Sousa,Thiemo de Bakker,Joao Sousa,6-4; 6-2,Q,58,3,1,35,50,26,35,12,15,1,1,9,38,50,5,1,32,50,23,32,5,18,3,6,9,28,50
2014-06-15 00:00:00.000,s-Hertogenbosch Netherlands ATP World Tour 250,GRASS,2,Benjamin Becker,Vasek Pospisil,Benjamin Becker,6-7(3); 7-6(5); 6-4,Q,164,8,5,78,124,61,78,21,46,3,4,17,82,124,13,6,72,123,49,72,33,51,7,9,17,82,123
2014-06-15 00:00:00.000,s-Hertogenbosch Netherlands ATP World Tour 250,GRASS,2,Roberto Bautista Agut,Nicolas Mahut,Roberto Bautista Agut,6-3; 4-6; 6-3,Q,122,0,3,64,89,38,64,17,25,5,9,14,55,89,6,5,48,83,28,48,17,35,5,11,14,45,83
2014-06-15 00:00:00.000,s-Hertogenbosch Netherlands ATP World Tour 250,GRASS,2,Jurgen Melzer,Fernando Verdasco,Jurgen Melzer,7-6(3); 6-7(6); 7-6(9),Q,185,5,3,101,143,68,101,28,42,6,8,18,96,143,11,9,89,144,68,89,24,55,7,9,18,92,144
2014-06-15 00:00:00.000,s-Hertogenbosch Netherlands ATP World Tour 250,GRASS,2,Benjamin Becker,Joao Sousa,Benjamin Becker,6-3; 7-6(3),S,88,13,2,45,75,36,45,17,30,4,5,11,53,75,6,1,42,60,29,42,9,18,2,4,10,38,60
2014-06-15 00:00:00.000,s-Hertogenbosch Netherlands ATP World Tour 250,GRASS,2,Roberto Bautista Agut,Jurgen Melzer,Roberto Bautista Agut,4-6; 6-2; 7-6(4),S,160,3,3,78,111,54,78,16,33,9,11,15,70,111,6,6,67,95,44,67,15,28,5,8,15,59,95
2014-06-15 00:00:00.000,s-Hertogenbosch Netherlands ATP World Tour 250,GRASS,2,Roberto Bautista Agut,Benjamin Becker,Roberto Bautista Agut,2-6; 7-6(2); 6-4,F,120,2,1,61,86,47,61,14,25,0,2,15,61,86,13,1,62,92,47,62,17,30,3,4,15,64,92
2014-06-16 00:00:00.000,Eastbourne Great Britain ATP World Tour 250,GRASS,2,Richard Gasquet,N/A Bye,Richard Gasquet,,R32,0,0,0,0,0,0,0,0,0,0,0,0,0,0,0,0,0,0,0,0,0,0,0,0,0,0,0
2014-06-16 00:00:00.000,Eastbourne Great Britain ATP World Tour 250,GRASS,2,Bernard Tomic,Andrey Golubev,Bernard Tomic,6-4; 6-4,R32,68,12,3,37,57,33,37,12,20,4,4,10,45,57,7,2,54,74,38,54,6,20,8,10,10,44,74
2014-06-16 00:00:00.000,Eastbourne Great Britain ATP World Tour 250,GRASS,2,Donald Young,James Ward,Donald Young,6-3; 6-2,R32,63,1,1,27,48,23,27,14,21,0,0,9,37,48,1,1,41,56,20,41,8,15,7,10,8,28,56
2014-06-16 00:00:00.000,Eastbourne Great Britain ATP World Tour 250,GRASS,2,Martin Klizan,Federico Delbonis,Martin Klizan,6-4; 6-4,R32,70,4,2,34,62,28,34,15,28,0,0,10,43,62,2,2,35,52,26,35,11,17,2,4,10,37,52
2014-06-16 00:00:00.000,Eastbourne Great Britain ATP World Tour 250,GRASS,2,Guillermo Garcia-Lopez,N/A Bye,Guillermo Garcia-Lopez,,R32,0,0,0,0,0,0,0,0,0,0,0,0,0,0,0,0,0,0,0,0,0,0,0,0,0,0,0
2014-06-16 00:00:00.000,Eastbourne Great Britain ATP World Tour 250,GRASS,2,Denis Istomin,Mikhail Kukushkin,Denis Istomin,7-6(6); 6-7(7); 6-3,R32,158,12,0,85,121,64,85,23,36,6,7,17,87,121,7,1,75,126,55,75,30,51,7,9,16,85,126
2014-06-16 00:00:00.000,Eastbourne Great Britain ATP World Tour 250,GRASS,2,Edouard Roger-Vasselin,Andrey Kuznetsov,Edouard Roger-Vasselin,6-3; 6-4,R32,73,4,3,40,60,32,40,10,20,2,3,10,42,60,5,1,47,71,29,47,10,24,7,10,9,39,71
2014-06-16 00:00:00.000,Eastbourne Great Britain ATP World Tour 250,GRASS,2,Jarkko Nieminen,Santiago Giraldo,Jarkko Nieminen,6-3; 6-7(5); 6-3,R32,101,8,0,66,93,47,66,20,27,4,5,16,67,93,10,4,57,93,47,57,12,36,1,4,14,59,93
2014-06-16 00:00:00.000,Eastbourne Great Britain ATP World Tour 250,GRASS,2,Jeremy Chardy,Ivo Karlovic,Jeremy Chardy,6-4; 6-4,R32,65,9,1,35,51,29,35,13,16,1,1,10,42,51,14,8,40,59,34,40,4,19,3,5,10,38,59
2014-06-16 00:00:00.000,Eastbourne Great Britain ATP World Tour 250,GRASS,2,Carlos Berlocq,Blaz Rola,Carlos Berlocq,6-2; 3-1 RET,R32,47,6,0,23,33,18,23,7,10,2,2,6,25,33,2,1,25,40,14,25,7,15,1,4,6,21,40
2014-06-16 00:00:00.000,Eastbourne Great Britain ATP World Tour 250,GRASS,2,Tobias Kamke,Daniel Evans,Tobias Kamke,6-2; 6-3,R32,66,6,2,35,53,28,35,11,18,2,2,9,39,53,2,3,31,56,20,31,11,25,3,6,8,31,56
2014-06-16 00:00:00.000,Eastbourne Great Britain ATP World Tour 250,GRASS,2,Feliciano Lopez,N/A Bye,Feliciano Lopez,,R32,0,0,0,0,0,0,0,0,0,0,0,0,0,0,0,0,0,0,0,0,0,0,0,0,0,0,0
2014-06-16 00:00:00.000,Eastbourne Great Britain ATP World Tour 250,GRASS,2,Gilles Simon,Chris Guccione,Gilles Simon,7-6(2); 6-4,R32,66,15,4,33,61,31,33,19,28,1,1,11,50,61,13,1,44,68,36,44,10,24,2,3,11,46,68
2014-06-16 00:00:00.000,Eastbourne Great Britain ATP World Tour 250,GRASS,2,Julien Benneteau,Yen-Hsun Lu,Julien Benneteau,6-2; 6-4,R32,73,8,1,41,59,29,41,11,18,1,1,9,40,59,4,3,31,48,20,31,10,17,6,9,9,30,48
2014-06-16 00:00:00.000,Eastbourne Great Britain ATP World Tour 250,GRASS,2,Sam Querrey,Kyle Edmund,Sam Querrey,7-6(5); 6-3,R32,83,12,1,44,58,38,44,8,14,2,2,10,46,58,5,1,54,92,35,54,21,38,6,8,11,56,92
2014-06-16 00:00:00.000,Eastbourne Great Britain ATP World Tour 250,GRASS,2,Victor Estrella Burgos,N/A Bye,Victor Estrella Burgos,,R32,0,0,0,0,0,0,0,0,0,0,0,0,0,0,0,0,0,0,0,0,0,0,0,0,0,0,0
2014-06-16 00:00:00.000,Eastbourne Great Britain ATP World Tour 250,GRASS,2,Richard Gasquet,Bernard Tomic,Richard Gasquet,6-4; 3-6; 6-3,R16,103,8,1,73,99,54,73,11,26,9,10,14,65,99,16,0,52,73,44,52,10,21,3,5,14,54,73
2014-06-16 00:00:00.000,Eastbourne Great Britain ATP World Tour 250,GRASS,2,Martin Klizan,Donald Young,Martin Klizan,7-6(4); 6-4,R16,93,3,2,38,71,27,38,19,33,4,6,11,46,71,4,2,46,68,32,46,11,22,3,6,11,43,68
2014-06-16 00:00:00.000,Eastbourne Great Britain ATP World Tour 250,GRASS,2,Denis Istomin,Guillermo Garcia-Lopez,Denis Istomin,6-2; 7-5,R16,89,7,1,46,68,35,46,10,22,6,7,10,45,68,5,5,41,67,30,41,7,26,6,10,10,37,67
2014-06-16 00:00:00.000,Eastbourne Great Britain ATP World Tour 250,GRASS,2,Edouard Roger-Vasselin,Jarkko Nieminen,Edouard Roger-Vasselin,6-2; 7-6(4),R16,77,7,4,48,72,38,48,11,24,4,5,10,49,72,11,1,46,69,33,46,8,23,0,3,10,41,69
2014-06-16 00:00:00.000,Eastbourne Great Britain ATP World Tour 250,GRASS,2,Jeremy Chardy,Carlos Berlocq,Jeremy Chardy,6-4; 7-5,R16,94,7,2,35,64,30,35,17,29,5,6,11,47,64,1,3,42,65,28,42,13,23,3,6,11,41,65
2014-06-16 00:00:00.000,Eastbourne Great Britain ATP World Tour 250,GRASS,2,Feliciano Lopez,Tobias Kamke,Feliciano Lopez,7-6(10); 7-5,R16,121,10,1,47,72,39,47,12,25,2,4,12,51,72,3,4,76,113,47,76,19,37,11,14,12,66,113
2014-06-16 00:00:00.000,Eastbourne Great Britain ATP World Tour 250,GRASS,2,Julien Benneteau,Gilles Simon,Julien Benneteau,6-3; 6-4,R16,60,7,2,36,51,31,36,10,15,2,2,10,41,51,8,5,33,55,23,33,10,22,5,7,9,33,55
2014-06-16 00:00:00.000,Eastbourne Great Britain ATP World Tour 250,GRASS,2,Sam Querrey,Victor Estrella Burgos,Sam Querrey,7-5 RET,R16,40,6,1,21,32,19,21,7,11,0,0,6,26,32,2,0,25,36,17,25,8,11,0,1,6,25,36
2014-06-16 00:00:00.000,Eastbourne Great Britain ATP World Tour 250,GRASS,2,Richard Gasquet,Martin Klizan,Richard Gasquet,6-3; 6-4,Q,69,7,1,45,57,35,45,8,12,2,2,10,43,57,5,1,27,50,23,27,10,23,2,4,9,33,50
2014-06-16 00:00:00.000,Eastbourne Great Britain ATP World Tour 250,GRASS,2,Denis Istomin,Edouard Roger-Vasselin,Denis Istomin,7-6(5); 6-2,Q,77,4,2,40,59,34,40,11,19,1,2,10,45,59,2,1,43,64,28,43,11,21,2,5,10,39,64
2014-06-16 00:00:00.000,Eastbourne Great Britain ATP World Tour 250,GRASS,2,Feliciano Lopez,Jeremy Chardy,Feliciano Lopez,6-3; 6-4,Q,63,7,0,39,53,33,39,8,14,0,0,10,41,53,10,2,38,55,29,38,5,17,5,7,9,34,55
2014-06-16 00:00:00.000,Eastbourne Great Britain ATP World Tour 250,GRASS,2,Sam Querrey,Julien Benneteau,Sam Querrey,7-6(5); 6-4,Q,83,16,3,41,67,37,41,14,26,3,3,11,51,67,5,5,51,76,38,51,13,25,3,4,11,51,76
2014-06-16 00:00:00.000,Eastbourne Great Britain ATP World Tour 250,GRASS,2,Richard Gasquet,Denis Istomin,Richard Gasquet,6-4; 6-2,S,71,3,2,38,60,30,38,12,22,3,3,9,42,60,6,0,41,53,26,41,6,12,3,6,9,32,53
2014-06-16 00:00:00.000,Eastbourne Great Britain ATP World Tour 250,GRASS,2,Feliciano Lopez,Sam Querrey,Feliciano Lopez,6-4; 7-6(4),S,78,12,3,45,67,41,45,11,22,1,1,11,52,67,15,4,44,66,36,44,10,22,3,4,11,46,66
2014-06-16 00:00:00.000,Eastbourne Great Britain ATP World Tour 250,GRASS,2,Feliciano Lopez,Richard Gasquet,Feliciano Lopez,6-3; 6-7(5); 7-5,F,133,14,3,65,107,47,65,26,42,5,6,16,73,107,9,2,63,92,47,63,19,29,2,6,17,66,92
2014-06-23 00:00:00.000,Wimbledon Great Britain Grand Slams,GRASS,3,Novak Djokovic,Andrey Golubev,Novak Djokovic,6-0; 6-1; 6-4,R128,88,7,0,41,62,33,41,15,21,0,0,12,48,62,1,3,50,87,25,50,18,37,9,15,11,43,87
2014-06-23 00:00:00.000,Wimbledon Great Britain Grand Slams,GRASS,3,Radek Stepanek,Pablo Cuevas,Radek Stepanek,6-2; 6-4; 6-4,R128,108,10,2,49,68,44,49,12,19,0,0,14,56,68,3,4,64,105,41,64,21,41,12,16,14,62,105
2014-06-23 00:00:00.000,Wimbledon Great Britain Grand Slams,GRASS,3,Gilles Simon,Konstantin Kravchuk,Gilles Simon,6-2; 7-6(4); 7-5,R128,128,8,1,54,98,44,54,30,44,1,1,16,74,98,3,0,68,99,49,68,15,31,2,5,16,64,99
2014-06-23 00:00:00.000,Wimbledon Great Britain Grand Slams,GRASS,3,Robin Haase,Vasek Pospisil,Robin Haase,7-6(6); 4-6; 7-5; 6-3,R128,158,12,2,84,134,70,84,28,50,4,5,22,98,134,21,6,77,126,64,77,25,49,2,4,21,89,126
2014-06-23 00:00:00.000,Wimbledon Great Britain Grand Slams,GRASS,3,Mikhail Youzhny,James Ward,Mikhail Youzhny,6-2; 6-2; 6-1,R128,105,2,1,46,73,34,46,18,27,3,3,12,52,73,4,1,51,79,25,51,12,28,8,14,11,37,79
2014-06-23 00:00:00.000,Wimbledon Great Britain Grand Slams,GRASS,3,Jimmy Wang,Alejandro Gonzalez,Jimmy Wang,6-3; 6-3; 6-2,R128,94,7,3,44,72,38,44,16,28,0,0,13,54,72,10,2,55,84,37,55,11,29,5,10,13,48,84
2014-06-23 00:00:00.000,Wimbledon Great Britain Grand Slams,GRASS,3,Sam Querrey,Bradley Klahn,Sam Querrey,6-7(5); 6-4; 6-1; 7-5,R128,143,25,6,81,130,70,81,26,49,8,9,21,96,130,10,8,92,138,61,92,23,46,5,10,20,84,138
2014-06-23 00:00:00.000,Wimbledon Great Britain Grand Slams,GRASS,3,Jo-Wilfried Tsonga,Jurgen Melzer,Jo-Wilfried Tsonga,6-1; 3-6; 3-6; 6-2; 6-4,R128,179,20,6,79,127,59,79,28,48,4,7,22,87,127,7,4,120,160,75,120,19,40,11,16,21,94,160
2014-06-23 00:00:00.000,Wimbledon Great Britain Grand Slams,GRASS,3,Ernests Gulbis,Jurgen Zopp,Ernests Gulbis,7-6(7); 7-5; 7-6(10),R128,151,22,8,70,113,64,70,19,43,0,1,18,83,113,7,5,78,127,56,78,29,49,0,2,18,85,127
2014-06-23 00:00:00.000,Wimbledon Great Britain Grand Slams,GRASS,3,Sergiy Stakhovsky,Carlos Berlocq,Sergiy Stakhovsky,6-3; 6-3; 6-3,R128,92,11,1,49,66,40,49,11,17,1,2,13,51,66,2,1,61,90,38,61,12,29,11,17,14,50,90
2014-06-23 00:00:00.000,Wimbledon Great Britain Grand Slams,GRASS,3,Jeremy Chardy,Daniel Cox,Jeremy Chardy,6-2; 7-6(3); 6-7(6); 6-3,R128,157,23,5,72,117,55,72,28,45,6,9,20,83,117,12,6,96,144,64,96,21,48,10,17,21,85,144
2014-06-23 00:00:00.000,Wimbledon Great Britain Grand Slams,GRASS,3,Marinko Matosevic,Fernando Verdasco,Marinko Matosevic,6-4; 4-6; 6-4; 6-2,R128,136,11,2,74,113,56,74,22,39,6,8,19,78,113,14,8,64,112,47,64,20,48,7,12,19,67,112
2014-06-23 00:00:00.000,Wimbledon Great Britain Grand Slams,GRASS,3,Marin Cilic,Paul-Henri Mathieu,Marin Cilic,6-4; 6-7(2); 6-2; 6-1,R128,151,27,3,66,107,57,66,23,41,3,4,19,80,107,5,4,80,130,55,80,23,50,16,22,18,78,130
2014-06-23 00:00:00.000,Wimbledon Great Britain Grand Slams,GRASS,3,Andreas Haider-Maurer,Kyle Edmund,Andreas Haider-Maurer,6-3; 7-6(4); 6-2,R128,110,7,4,54,88,45,54,17,34,5,6,14,62,88,12,5,55,100,39,55,20,45,6,11,15,59,100
2014-06-23 00:00:00.000,Wimbledon Great Britain Grand Slams,GRASS,3,Bernard Tomic,Evgeny Donskoy,Bernard Tomic,6-4; 6-3; 6-2,R128,87,11,1,49,68,40,49,13,19,1,2,14,53,68,7,3,49,89,31,49,17,40,5,10,13,48,89
2014-06-23 00:00:00.000,Wimbledon Great Britain Grand Slams,GRASS,3,Tomas Berdych,Victor Hanescu,Tomas Berdych,6-7(5); 6-1; 6-4; 6-3,R128,176,22,3,72,112,54,72,30,40,3,3,19,84,112,10,2,131,166,83,131,14,35,20,25,19,97,166
2014-06-23 00:00:00.000,Wimbledon Great Britain Grand Slams,GRASS,3,Andy Murray,David Goffin,Andy Murray,6-1; 6-4; 7-5,R128,122,8,1,55,78,47,55,14,23,2,2,15,61,78,2,4,55,95,35,55,19,40,4,8,14,54,95
2014-06-23 00:00:00.000,Wimbledon Great Britain Grand Slams,GRASS,3,Blaz Rola,Pablo Andujar,Blaz Rola,6-3; 6-1; 6-4,R128,101,4,4,51,80,41,51,15,29,6,7,13,56,80,1,3,49,83,28,49,15,34,6,12,13,43,83
2014-06-23 00:00:00.000,Wimbledon Great Britain Grand Slams,GRASS,3,Jan Hernych,Tobias Kamke,Jan Hernych,6-3; 6-7(5); 6-3; 5-7; 6-4,R128,199,18,0,135,182,99,135,23,47,11,14,27,122,182,7,7,105,151,76,105,21,46,5,10,25,97,151
2014-06-23 00:00:00.000,Wimbledon Great Britain Grand Slams,GRASS,3,Roberto Bautista Agut,Steve Johnson,Roberto Bautista Agut,6-3; 6-7(3); 6-4; 7-5,R128,170,3,1,100,135,73,100,23,35,8,9,22,96,135,10,7,77,132,56,77,28,55,3,7,21,84,132
2014-06-23 00:00:00.000,Wimbledon Great Britain Grand Slams,GRASS,3,Kevin Anderson,Aljaz Bedene,Kevin Anderson,6-3; 7-5; 6-2,R128,108,23,3,69,98,59,69,12,29,8,8,15,71,98,9,2,43,78,34,43,14,35,1,5,14,48,78
2014-06-23 00:00:00.000,Wimbledon Great Britain Grand Slams,GRASS,3,Edouard Roger-Vasselin,Filippo Volandri,Edouard Roger-Vasselin,7-6(1); 6-2; 6-4,R128,98,12,2,53,84,39,53,21,31,3,6,15,60,84,2,3,66,94,39,66,10,28,1,7,15,49,94
2014-06-23 00:00:00.000,Wimbledon Great Britain Grand Slams,GRASS,3,Tim Puetz,Teymuraz Gabashvili,Tim Puetz,2-6; 6-4; 6-2; 6-2,R128,137,19,5,56,92,44,56,19,36,3,6,17,63,92,6,4,70,115,42,70,21,45,7,13,17,63,115
2014-06-23 00:00:00.000,Wimbledon Great Britain Grand Slams,GRASS,3,Fabio Fognini,Alex Kuznetsov,Fabio Fognini,2-6; 1-6; 6-4; 6-1; 9-7,R128,189,9,7,94,157,66,94,27,63,11,17,24,93,157,20,3,90,143,66,90,24,53,8,14,24,90,143
2014-06-23 00:00:00.000,Wimbledon Great Britain Grand Slams,GRASS,3,Grigor Dimitrov,Ryan Harrison,Grigor Dimitrov,7-6(1); 6-3; 6-2,R128,101,4,3,51,83,42,51,21,32,4,4,14,63,83,9,4,53,87,36,53,13,34,3,7,15,49,87
2014-06-23 00:00:00.000,Wimbledon Great Britain Grand Slams,GRASS,3,Luke Saville,Dominic Thiem,Luke Saville,7-5; 6-4; 3-6; 6-4,R128,174,14,4,90,146,62,90,31,56,9,12,20,93,146,7,2,85,128,52,85,26,43,6,11,21,78,128
2014-06-23 00:00:00.000,Wimbledon Great Britain Grand Slams,GRASS,3,Benjamin Becker,Donald Young,Benjamin Becker,6-4; 6-3; 6-4,R128,99,13,4,66,92,52,66,13,26,5,5,14,65,92,7,0,60,90,41,60,12,30,10,14,15,53,90
2014-06-23 00:00:00.000,Wimbledon Great Britain Grand Slams,GRASS,3,Alexandr Dolgopolov,Sam Groth,Alexandr Dolgopolov,7-5; 7-6(2); 7-6(5),R128,115,14,1,78,105,63,78,19,27,0,0,18,82,105,24,3,76,113,64,76,18,37,3,4,18,82,113
2014-06-23 00:00:00.000,Wimbledon Great Britain Grand Slams,GRASS,3,Leonardo Mayer,Andreas Seppi,Leonardo Mayer,6-3; 2-6; 4-6; 7-6(5); 6-4,R128,195,22,5,97,162,70,97,36,65,6,9,24,106,162,6,5,89,142,74,89,27,53,5,8,25,101,142
2014-06-23 00:00:00.000,Wimbledon Great Britain Grand Slams,GRASS,3,Marcos Baghdatis,Dustin Brown,Marcos Baghdatis,6-4; 7-5; 2-6; 7-6(4),R128,137,13,5,77,127,59,77,27,50,2,5,21,86,127,14,3,102,142,73,102,19,40,9,12,21,92,142
2014-06-23 00:00:00.000,Wimbledon Great Britain Grand Slams,GRASS,3,Andrey Kuznetsov,Daniel Evans,Andrey Kuznetsov,6-1; 7-5; 3-6; 7-6(5),R128,145,19,0,83,132,65,83,23,49,3,5,20,88,132,15,7,73,121,56,73,18,48,5,9,20,74,121
2014-06-23 00:00:00.000,Wimbledon Great Britain Grand Slams,GRASS,3,David Ferrer,Pablo Carreno Busta,David Ferrer,6-0; 6-7(3); 6-1; 6-1,R128,143,10,3,88,116,62,88,13,28,9,11,16,75,116,11,1,71,100,41,71,8,29,5,15,16,49,100
2014-06-23 00:00:00.000,Wimbledon Great Britain Grand Slams,GRASS,3,Stan Wawrinka,Joao Sousa,Stan Wawrinka,6-3; 6-4; 6-3,R128,95,18,2,51,80,44,51,16,29,0,0,14,60,80,0,0,66,90,45,66,12,24,8,12,14,57,90
2014-06-23 00:00:00.000,Wimbledon Great Britain Grand Slams,GRASS,3,Yen-Hsun Lu,Aleksandr Nedovyesov,Yen-Hsun Lu,6-4; 4-6; 6-4; 1-6; 6-1,R128,159,9,5,94,134,70,94,21,40,12,15,22,91,134,22,2,85,125,67,85,15,40,2,6,22,82,125
2014-06-23 00:00:00.000,Wimbledon Great Britain Grand Slams,GRASS,3,Julian Reister,Michael Russell,Julian Reister,6-4; 6-4; 6-7(5); 4-6; 7-5,R128,230,16,7,145,195,106,145,18,50,24,28,27,124,195,8,8,116,180,79,116,33,64,16,22,27,112,180
2014-06-23 00:00:00.000,Wimbledon Great Britain Grand Slams,GRASS,3,Denis Istomin,Dmitry Tursunov,Denis Istomin,7-5; 6-4; 3-6; 6-2,R128,143,16,1,65,95,57,65,16,30,1,3,19,73,95,11,6,103,159,61,103,32,56,15,20,20,93,159
2014-06-23 00:00:00.000,Wimbledon Great Britain Grand Slams,GRASS,3,Feliciano Lopez,Yuichi Sugita,Feliciano Lopez,7-6(6); 7-6(6); 7-6(7),R128,165,20,5,69,116,59,69,27,47,6,7,18,86,116,18,5,95,147,71,95,23,52,3,4,18,94,147
2014-06-23 00:00:00.000,Wimbledon Great Britain Grand Slams,GRASS,3,Ante Pavic,Alejandro Falla,Ante Pavic,6-4; 6-3; 7-5,R128,104,18,6,65,106,47,65,22,41,8,10,16,69,106,5,6,52,86,35,52,17,34,5,10,15,52,86
2014-06-23 00:00:00.000,Wimbledon Great Britain Grand Slams,GRASS,3,Jarkko Nieminen,Federico Delbonis,Jarkko Nieminen,6-3; 7-6(3); 7-5,R128,107,4,0,67,92,58,67,16,25,1,1,17,74,92,7,3,55,93,45,55,19,38,4,6,16,64,93
2014-06-23 00:00:00.000,Wimbledon Great Britain Grand Slams,GRASS,3,John Isner,Daniel Smethurst,John Isner,7-5; 6-3; 6-4,R128,110,26,1,66,90,54,66,14,24,7,7,16,68,90,4,6,58,97,43,58,20,39,5,8,15,63,97
2014-06-23 00:00:00.000,Wimbledon Great Britain Grand Slams,GRASS,3,Jerzy Janowicz,Somdev Devvarman,Jerzy Janowicz,4-6; 6-3; 6-3; 3-6; 6-3,R128,184,8,19,71,133,58,71,30,62,7,11,23,88,133,14,4,78,152,60,78,33,74,6,12,23,93,152
2014-06-23 00:00:00.000,Wimbledon Great Britain Grand Slams,GRASS,3,Lleyton Hewitt,Michal Przysiezny,Lleyton Hewitt,6-2; 6-7(14); 6-1; 6-4,R128,182,8,4,67,121,50,67,29,54,2,5,19,79,121,15,5,86,146,55,86,22,60,11,19,18,77,146
2014-06-23 00:00:00.000,Wimbledon Great Britain Grand Slams,GRASS,3,Adrian Mannarino,Pere Riba,Adrian Mannarino,6-2; 6-3; 6-4,R128,102,10,2,57,80,43,57,14,23,3,3,13,57,80,14,3,63,97,39,63,16,34,13,18,14,55,97
2014-06-23 00:00:00.000,Wimbledon Great Britain Grand Slams,GRASS,3,Tommy Robredo,Lukas Lacko,Tommy Robredo,7-6(5); 1-6; 6-2; 6-4,R128,132,12,1,73,107,57,73,18,34,2,6,19,75,107,6,3,100,142,63,100,23,42,15,19,18,86,142
2014-06-23 00:00:00.000,Wimbledon Great Britain Grand Slams,GRASS,3,Marcel Granollers,Nicolas Mahut,Marcel Granollers,6-4; 7-6(6); 6-7(7); 6-4,R128,194,19,1,103,158,71,103,34,55,9,11,22,105,158,10,6,88,145,64,88,31,57,7,11,22,95,145
2014-06-23 00:00:00.000,Wimbledon Great Britain Grand Slams,GRASS,3,Santiago Giraldo,Daniel Gimeno-Traver,Santiago Giraldo,6-1; 7-5; 6-0,R128,89,3,1,48,71,40,48,10,23,3,4,12,50,71,4,3,50,81,29,50,10,31,5,12,12,39,81
2014-06-23 00:00:00.000,Wimbledon Great Britain Grand Slams,GRASS,3,Gilles Muller,Julien Benneteau,Gilles Muller,6-4; 7-6(6); 7-6(5),R128,136,28,5,64,97,62,64,18,33,1,1,17,80,97,17,7,76,114,61,76,20,38,5,6,17,81,114
2014-06-23 00:00:00.000,Wimbledon Great Britain Grand Slams,GRASS,3,Roger Federer,Paolo Lorenzi,Roger Federer,6-1; 6-1; 6-3,R128,93,9,1,48,69,37,48,15,21,5,5,12,52,69,4,3,49,98,30,49,17,49,17,23,11,47,98
2014-06-23 00:00:00.000,Wimbledon Great Britain Grand Slams,GRASS,3,Milos Raonic,Matthew Ebden,Milos Raonic,6-2; 6-4; 6-4,R128,95,30,1,54,76,46,54,11,22,1,1,14,57,76,2,2,57,83,35,57,14,26,3,7,14,49,83
2014-06-23 00:00:00.000,Wimbledon Great Britain Grand Slams,GRASS,3,Jack Sock,Pierre-Hugues Herbert,Jack Sock,6-7(5); 6-2; 7-6(5); 6-4,R128,171,13,2,82,126,64,82,32,44,1,1,21,96,126,18,6,102,161,78,102,28,59,8,11,21,106,161
2014-06-23 00:00:00.000,Wimbledon Great Britain Grand Slams,GRASS,3,Lukasz Kubot,Jan-Lennard Struff,Lukasz Kubot,7-6(6); 6-4; 6-4,R128,148,25,6,72,118,55,72,27,46,7,7,16,82,118,14,2,63,99,49,63,18,36,5,7,16,67,99
2014-06-23 00:00:00.000,Wimbledon Great Britain Grand Slams,GRASS,3,Dusan Lajovic,Guillermo Garcia-Lopez,Dusan Lajovic,7-6(5); 6-2; 3-6; 3-6; 6-3,R128,184,12,3,123,170,85,123,23,47,13,16,23,108,170,9,5,88,146,68,88,29,58,9,13,24,97,146
2014-06-23 00:00:00.000,Wimbledon Great Britain Grand Slams,GRASS,3,Philipp Kohlschreiber,Igor Sijsling,Philipp Kohlschreiber,6-4; 6-4; 6-2,R128,76,9,0,60,79,45,60,14,19,2,2,14,59,79,5,3,48,79,35,48,13,31,5,9,14,48,79
2014-06-23 00:00:00.000,Wimbledon Great Britain Grand Slams,GRASS,3,Simone Bolelli,Tatsuma Ito,Simone Bolelli,7-5; 7-6(3); 3-6; 7-6(5),R128,179,20,2,77,127,63,77,30,50,5,7,22,93,127,11,2,100,155,64,100,38,55,10,12,23,102,155
2014-06-23 00:00:00.000,Wimbledon Great Britain Grand Slams,GRASS,3,Denis Kudla,Marsel Ilhan,Denis Kudla,7-6(3); 6-4; 4-6; 7-5,R128,168,11,5,80,140,56,80,32,60,9,14,22,88,140,10,1,86,150,57,86,31,64,5,11,22,88,150
2014-06-23 00:00:00.000,Wimbledon Great Britain Grand Slams,GRASS,3,Kei Nishikori,Kenny De Schepper,Kei Nishikori,6-4; 7-6(5); 7-5,R128,109,8,1,62,93,51,62,22,31,0,0,17,73,93,20,8,61,91,50,61,16,30,2,4,17,66,91
2014-06-23 00:00:00.000,Wimbledon Great Britain Grand Slams,GRASS,3,Richard Gasquet,James Duckworth,Richard Gasquet,6-7(3); 6-3; 3-6; 6-0; 6-1,R128,164,22,5,86,123,73,86,19,37,6,7,22,92,123,12,2,93,145,55,93,29,52,11,17,21,84,145
2014-06-23 00:00:00.000,Wimbledon Great Britain Grand Slams,GRASS,3,Nick Kyrgios,Stephane Robert,Nick Kyrgios,7-6(2); 7-6(1); 6-7(6); 6-2,R128,144,29,4,107,150,83,107,20,43,9,12,22,103,150,9,20,94,174,63,94,39,80,12,17,22,102,174
2014-06-23 00:00:00.000,Wimbledon Great Britain Grand Slams,GRASS,3,Jiri Vesely,Victor Estrella Burgos,Jiri Vesely,5-1 RET,R128,22,3,0,7,14,7,7,5,7,0,0,3,12,14,0,1,19,26,10,19,2,7,4,6,3,12,26
2014-06-23 00:00:00.000,Wimbledon Great Britain Grand Slams,GRASS,3,Gael Monfils,Malek Jaziri,Gael Monfils,7-6(5); 7-5; 6-4,R128,110,17,2,74,101,55,74,15,27,3,5,17,70,101,3,6,62,115,46,62,26,53,13,17,17,72,115
2014-06-23 00:00:00.000,Wimbledon Great Britain Grand Slams,GRASS,3,Frank Dancevic,Ivo Karlovic,Frank Dancevic,6-4; 7-6(5); 7-6(4),R128,113,6,0,66,98,56,66,23,32,0,0,17,79,98,32,3,86,105,68,86,8,19,5,6,17,76,105
2014-06-23 00:00:00.000,Wimbledon Great Britain Grand Slams,GRASS,3,Mikhail Kukushkin,Dudi Sela,Mikhail Kukushkin,6-4; 6-4; 6-4,R128,108,6,2,61,102,46,61,21,41,10,11,15,67,102,1,4,54,88,34,54,19,34,4,8,15,53,88
2014-06-23 00:00:00.000,Wimbledon Great Britain Grand Slams,GRASS,3,Lukas Rosol,Benoit Paire,Lukas Rosol,6-3; 3-6; 7-6(5); 6-4,R128,119,7,4,87,132,65,87,27,45,3,4,20,92,132,19,2,65,115,55,65,25,50,3,5,20,80,115
2014-06-23 00:00:00.000,Wimbledon Great Britain Grand Slams,GRASS,3,Rafael Nadal,Martin Klizan,Rafael Nadal,4-6; 6-3; 6-3; 6-3,R128,175,6,3,87,121,63,87,14,34,10,13,19,77,121,11,4,69,113,43,69,22,44,9,15,18,65,113
2014-06-23 00:00:00.000,Wimbledon Great Britain Grand Slams,GRASS,3,Novak Djokovic,Radek Stepanek,Novak Djokovic,6-4; 6-3; 6-7(5); 7-6(5),R64,197,18,2,102,148,81,102,24,46,5,5,22,105,148,9,2,91,142,68,91,25,51,5,7,21,93,142
2014-06-23 00:00:00.000,Wimbledon Great Britain Grand Slams,GRASS,3,Gilles Simon,Robin Haase,Gilles Simon,7-6(1); 6-4; 6-4,R64,122,7,1,55,85,47,55,21,30,0,0,16,68,85,18,1,74,121,52,74,23,47,9,11,16,75,121
2014-06-23 00:00:00.000,Wimbledon Great Britain Grand Slams,GRASS,3,Jimmy Wang,Mikhail Youzhny,Jimmy Wang,7-6(1); 6-2; 6-7(5); 6-3,R64,183,10,4,98,150,65,98,29,52,9,13,21,94,150,10,3,87,131,51,87,24,44,5,12,20,75,131
2014-06-23 00:00:00.000,Wimbledon Great Britain Grand Slams,GRASS,3,Jo-Wilfried Tsonga,Sam Querrey,Jo-Wilfried Tsonga,4-6; 7-6(2); 6-7(4); 6-3; 14-12,R64,229,37,4,144,205,118,144,36,61,5,6,35,154,205,33,3,142,206,107,142,40,64,7,9,34,147,206
2014-06-23 00:00:00.000,Wimbledon Great Britain Grand Slams,GRASS,3,Sergiy Stakhovsky,Ernests Gulbis,Sergiy Stakhovsky,6-4; 6-3; 7-6(5),R64,115,11,0,52,83,43,52,25,31,1,1,15,68,83,14,9,66,109,52,66,17,43,7,10,16,69,109
2014-06-23 00:00:00.000,Wimbledon Great Britain Grand Slams,GRASS,3,Jeremy Chardy,Marinko Matosevic,Jeremy Chardy,6-7(5); 7-6(7); 7-6(9); 4-6; 7-5,R64,255,23,5,97,174,80,97,39,77,4,10,29,119,174,20,9,127,215,92,127,41,88,15,21,29,133,215
2014-06-23 00:00:00.000,Wimbledon Great Britain Grand Slams,GRASS,3,Marin Cilic,Andreas Haider-Maurer,Marin Cilic,3-6; 6-1; 6-4; 6-4,R64,132,18,2,68,102,60,68,15,34,3,4,18,75,102,6,4,73,122,48,73,23,49,10,14,18,71,122
2014-06-23 00:00:00.000,Wimbledon Great Britain Grand Slams,GRASS,3,Tomas Berdych,Bernard Tomic,Tomas Berdych,4-6; 7-6(5); 7-6(3); 6-1,R64,150,25,1,74,119,61,74,31,45,2,3,21,92,119,11,0,101,124,75,101,12,23,7,9,20,87,124
2014-06-23 00:00:00.000,Wimbledon Great Britain Grand Slams,GRASS,3,Andy Murray,Blaz Rola,Andy Murray,6-1; 6-1; 6-0,R64,84,7,2,38,63,30,38,15,25,3,3,10,45,63,0,4,32,63,15,32,9,31,5,13,10,24,63
2014-06-23 00:00:00.000,Wimbledon Great Britain Grand Slams,GRASS,3,Roberto Bautista Agut,Jan Hernych,Roberto Bautista Agut,7-5; 4-6; 6-2; 6-2,R64,144,7,2,96,116,69,96,8,20,8,10,19,77,116,6,3,72,112,50,72,17,40,7,13,19,67,112
2014-06-23 00:00:00.000,Wimbledon Great Britain Grand Slams,GRASS,3,Kevin Anderson,Edouard Roger-Vasselin,Kevin Anderson,7-6(0); 1-6; 6-3; 6-4,R64,143,24,2,78,114,61,78,17,36,6,8,19,78,114,4,5,94,122,66,94,12,28,5,7,19,78,122
2014-06-23 00:00:00.000,Wimbledon Great Britain Grand Slams,GRASS,3,Fabio Fognini,Tim Puetz,Fabio Fognini,2-6; 6-4; 7-6(6); 6-3,R64,160,5,3,70,122,50,70,32,52,6,9,20,82,122,19,7,81,131,64,81,20,50,8,11,19,84,131
2014-06-23 00:00:00.000,Wimbledon Great Britain Grand Slams,GRASS,3,Grigor Dimitrov,Luke Saville,Grigor Dimitrov,6-3; 6-2; 6-4,R64,93,11,3,48,71,43,48,14,23,1,1,14,57,71,3,3,48,83,31,48,18,35,7,11,13,49,83
2014-06-23 00:00:00.000,Wimbledon Great Britain Grand Slams,GRASS,3,Alexandr Dolgopolov,Benjamin Becker,Alexandr Dolgopolov,6-7(4); 7-6(0); 6-3; 6-4,R64,150,42,1,86,134,70,86,30,48,4,5,22,100,134,9,7,89,137,64,89,27,48,4,7,21,91,137
2014-06-23 00:00:00.000,Wimbledon Great Britain Grand Slams,GRASS,3,Leonardo Mayer,Marcos Baghdatis,Leonardo Mayer,7-6(4); 4-6; 6-1; 6-4,R64,164,16,2,77,112,67,77,19,35,6,7,20,86,112,8,3,70,125,50,70,31,55,4,7,19,81,125
2014-06-23 00:00:00.000,Wimbledon Great Britain Grand Slams,GRASS,3,Andrey Kuznetsov,David Ferrer,Andrey Kuznetsov,6-7(5); 6-0; 3-6; 6-3; 6-2,R64,192,9,3,87,136,62,87,27,49,7,11,22,89,136,9,2,113,167,65,113,26,54,12,21,22,91,167
2014-06-23 00:00:00.000,Wimbledon Great Britain Grand Slams,GRASS,3,Stan Wawrinka,Yen-Hsun Lu,Stan Wawrinka,7-6(6); 6-3; 3-6; 7-5,R64,162,13,2,67,136,53,67,36,69,4,8,21,89,136,3,3,78,131,50,78,29,53,5,10,21,79,131
2014-06-23 00:00:00.000,Wimbledon Great Britain Grand Slams,GRASS,3,Denis Istomin,Julian Reister,Denis Istomin,7-6(7); 6-4; 6-4,R64,129,11,1,75,104,53,75,17,29,2,4,16,70,104,4,5,78,105,56,78,11,27,5,9,16,67,105
2014-06-23 00:00:00.000,Wimbledon Great Britain Grand Slams,GRASS,3,Feliciano Lopez,Ante Pavic,Feliciano Lopez,6-4; 7-6(4); 7-5,R64,114,11,2,49,87,43,49,30,38,2,2,17,73,87,15,9,55,101,44,55,24,46,6,8,17,68,101
2014-06-23 00:00:00.000,Wimbledon Great Britain Grand Slams,GRASS,3,John Isner,Jarkko Nieminen,John Isner,7-6(17); 7-6(3); 7-5,R64,130,32,1,81,114,70,81,25,33,0,0,18,95,114,13,5,97,131,78,97,18,34,6,7,18,96,131
2014-06-23 00:00:00.000,Wimbledon Great Britain Grand Slams,GRASS,3,Jerzy Janowicz,Lleyton Hewitt,Jerzy Janowicz,7-5; 6-4; 6-7(7); 4-6; 6-3,R64,227,21,12,114,180,83,114,34,66,7,10,27,117,180,13,3,104,168,70,104,35,64,5,10,26,105,168
2014-06-23 00:00:00.000,Wimbledon Great Britain Grand Slams,GRASS,3,Tommy Robredo,Adrian Mannarino,Tommy Robredo,6-4; 6-1; 7-6(5),R64,118,8,2,66,96,51,66,13,30,2,5,15,64,96,4,5,64,95,40,64,12,31,8,14,14,52,95
2014-06-23 00:00:00.000,Wimbledon Great Britain Grand Slams,GRASS,3,Santiago Giraldo,Marcel Granollers,Santiago Giraldo,4-6; 7-6(2); 1-6; 6-1; 7-5,R64,205,3,0,106,165,73,106,33,59,11,15,24,106,165,15,2,102,148,69,102,27,46,3,7,24,96,148
2014-06-23 00:00:00.000,Wimbledon Great Britain Grand Slams,GRASS,3,Roger Federer,Gilles Muller,Roger Federer,6-3; 7-5; 6-3,R64,94,25,1,53,69,48,53,12,16,0,0,15,60,69,12,5,62,92,46,62,11,30,2,6,15,57,92
2014-06-23 00:00:00.000,Wimbledon Great Britain Grand Slams,GRASS,3,Milos Raonic,Jack Sock,Milos Raonic,6-3; 6-4; 6-4,R64,103,13,1,50,75,43,50,19,25,0,0,15,62,75,5,8,56,97,44,56,17,41,7,10,14,61,97
2014-06-23 00:00:00.000,Wimbledon Great Britain Grand Slams,GRASS,3,Lukasz Kubot,Dusan Lajovic,Lukasz Kubot,6-7(4); 7-6(4); 6-3; 7-6(3),R64,180,22,12,70,142,58,70,46,72,6,7,23,104,142,15,6,80,134,61,80,32,54,1,3,22,93,134
2014-06-23 00:00:00.000,Wimbledon Great Britain Grand Slams,GRASS,3,Simone Bolelli,Philipp Kohlschreiber,Simone Bolelli,4-6; 6-4; 6-3; 2-6; 7-5,R64,182,9,7,100,157,71,100,31,57,4,9,25,102,157,12,1,81,132,56,81,31,51,5,10,24,87,132
2014-06-23 00:00:00.000,Wimbledon Great Britain Grand Slams,GRASS,3,Kei Nishikori,Denis Kudla,Kei Nishikori,6-3; 6-2; 6-1,R64,88,8,3,48,72,31,48,18,24,1,2,12,49,72,4,4,49,84,24,49,14,35,8,15,12,38,84
2014-06-23 00:00:00.000,Wimbledon Great Britain Grand Slams,GRASS,3,Nick Kyrgios,Richard Gasquet,Nick Kyrgios,3-6; 6-7(4); 6-4; 7-5; 10-8,R64,233,21,5,142,211,100,142,39,69,14,16,30,139,211,27,4,123,185,93,123,35,62,2,6,31,128,185
2014-06-23 00:00:00.000,Wimbledon Great Britain Grand Slams,GRASS,3,Jiri Vesely,Gael Monfils,Jiri Vesely,7-6(3); 6-3; 6-7(1); 6-7(3); 6-4,R64,201,12,8,116,169,92,116,30,53,6,7,28,122,169,23,4,118,164,96,118,20,46,6,9,27,116,164
2014-06-23 00:00:00.000,Wimbledon Great Britain Grand Slams,GRASS,3,Mikhail Kukushkin,Frank Dancevic,Mikhail Kukushkin,6-3; 6-3; 6-2,R64,89,8,0,44,72,37,44,18,28,5,5,13,55,72,7,4,55,89,33,55,16,34,9,14,13,49,89
2014-06-23 00:00:00.000,Wimbledon Great Britain Grand Slams,GRASS,3,Rafael Nadal,Lukas Rosol,Rafael Nadal,4-6; 7-6(6); 6-4; 6-4,R64,164,11,3,97,123,73,97,16,26,3,5,21,89,123,17,2,71,123,55,71,28,52,4,7,21,83,123
2014-06-23 00:00:00.000,Wimbledon Great Britain Grand Slams,GRASS,3,Novak Djokovic,Gilles Simon,Novak Djokovic,6-4; 6-2; 6-4,R32,132,7,2,47,80,36,47,15,33,4,7,14,51,80,3,4,54,103,35,54,19,49,7,14,14,54,103
2014-06-23 00:00:00.000,Wimbledon Great Britain Grand Slams,GRASS,3,Jo-Wilfried Tsonga,Jimmy Wang,Jo-Wilfried Tsonga,6-2; 6-2; 7-5,R32,103,15,2,53,77,46,53,13,24,4,4,14,59,77,3,2,64,94,32,64,18,30,7,12,14,50,94
2014-06-23 00:00:00.000,Wimbledon Great Britain Grand Slams,GRASS,3,Jeremy Chardy,Sergiy Stakhovsky,Jeremy Chardy,6-3; 6-7(4); 6-3; 6-0,R32,138,9,5,72,124,59,72,28,52,5,5,19,87,124,16,6,67,103,48,67,14,36,1,6,17,62,103
2014-06-23 00:00:00.000,Wimbledon Great Britain Grand Slams,GRASS,3,Marin Cilic,Tomas Berdych,Marin Cilic,7-6(5); 6-4; 7-6(6),R32,169,20,3,79,120,64,79,17,41,5,7,17,81,120,6,4,88,138,61,88,22,50,11,14,17,83,138
2014-06-23 00:00:00.000,Wimbledon Great Britain Grand Slams,GRASS,3,Andy Murray,Roberto Bautista Agut,Andy Murray,6-2; 6-3; 6-2,R32,95,11,2,40,63,35,40,9,23,0,2,12,44,63,1,3,54,77,27,54,8,23,8,16,13,35,77
2014-06-23 00:00:00.000,Wimbledon Great Britain Grand Slams,GRASS,3,Kevin Anderson,Fabio Fognini,Kevin Anderson,4-6; 6-4; 2-6; 6-2; 6-1,R32,165,16,6,87,125,70,87,17,38,4,8,22,87,125,6,11,83,128,59,83,21,45,9,15,21,80,128
2014-06-23 00:00:00.000,Wimbledon Great Britain Grand Slams,GRASS,3,Grigor Dimitrov,Alexandr Dolgopolov,Grigor Dimitrov,6-7(3); 6-4; 2-6; 6-4; 6-1,R32,175,14,6,93,139,72,93,24,46,10,12,23,96,139,19,7,84,153,65,84,33,69,7,12,24,98,153
2014-06-23 00:00:00.000,Wimbledon Great Britain Grand Slams,GRASS,3,Leonardo Mayer,Andrey Kuznetsov,Leonardo Mayer,6-4; 7-6(1); 6-3,R32,122,8,6,62,105,51,62,26,43,9,9,16,77,105,8,1,53,89,38,53,20,36,1,3,15,58,89
2014-06-23 00:00:00.000,Wimbledon Great Britain Grand Slams,GRASS,3,Stan Wawrinka,Denis Istomin,Stan Wawrinka,6-3; 6-3; 6-4,R32,87,12,1,41,72,34,41,23,31,3,3,14,57,72,2,0,60,78,36,60,12,18,1,5,14,48,78
2014-06-23 00:00:00.000,Wimbledon Great Britain Grand Slams,GRASS,3,Feliciano Lopez,John Isner,Feliciano Lopez,6-7(8); 7-6(6); 7-6(3); 7-5,R32,170,34,2,92,143,79,92,36,51,2,2,24,115,143,52,2,116,155,91,116,22,39,4,5,24,113,155
2014-06-23 00:00:00.000,Wimbledon Great Britain Grand Slams,GRASS,3,Tommy Robredo,Jerzy Janowicz,Tommy Robredo,6-2; 6-4; 6-7(5); 4-6; 6-3,R32,184,15,3,103,143,83,103,22,40,1,3,25,105,143,10,16,99,165,76,99,28,66,12,17,24,104,165
2014-06-23 00:00:00.000,Wimbledon Great Britain Grand Slams,GRASS,3,Roger Federer,Santiago Giraldo,Roger Federer,6-3; 6-1; 6-3,R32,81,8,1,50,73,42,50,12,23,2,2,13,54,73,0,4,61,85,37,61,8,24,4,9,12,45,85
2014-06-23 00:00:00.000,Wimbledon Great Britain Grand Slams,GRASS,3,Milos Raonic,Lukasz Kubot,Milos Raonic,7-6(2); 7-6(4); 6-2,R32,106,30,0,56,83,53,56,21,27,0,0,16,74,83,15,5,60,91,47,60,19,31,1,3,16,66,91
2014-06-23 00:00:00.000,Wimbledon Great Britain Grand Slams,GRASS,3,Kei Nishikori,Simone Bolelli,Kei Nishikori,3-6; 6-3; 4-6; 7-6(4); 6-4,R32,193,12,4,89,147,75,89,30,58,6,8,25,105,147,8,2,99,146,75,99,30,47,4,6,25,105,146
2014-06-23 00:00:00.000,Wimbledon Great Britain Grand Slams,GRASS,3,Nick Kyrgios,Jiri Vesely,Nick Kyrgios,3-6; 6-3; 7-5; 6-2,R32,124,26,1,77,106,63,77,14,29,0,1,19,77,106,8,2,75,106,51,75,19,31,5,9,19,70,106
2014-06-23 00:00:00.000,Wimbledon Great Britain Grand Slams,GRASS,3,Rafael Nadal,Mikhail Kukushkin,Rafael Nadal,6-7(4); 6-1; 6-1; 6-1,R32,154,9,0,62,93,48,62,24,31,2,2,17,72,93,9,1,83,135,53,83,18,52,11,18,16,71,135
2014-06-23 00:00:00.000,Wimbledon Great Britain Grand Slams,GRASS,3,Novak Djokovic,Jo-Wilfried Tsonga,Novak Djokovic,6-3; 6-4; 7-6(5),R16,112,14,0,68,96,55,68,19,28,2,2,16,74,96,19,2,59,89,46,59,18,30,7,9,15,64,89
2014-06-23 00:00:00.000,Wimbledon Great Britain Grand Slams,GRASS,3,Marin Cilic,Jeremy Chardy,Marin Cilic,7-6(8); 6-4; 6-4,R16,129,33,3,69,108,61,69,17,39,4,4,16,78,108,17,7,72,110,58,72,14,38,4,6,16,72,110
2014-06-23 00:00:00.000,Wimbledon Great Britain Grand Slams,GRASS,3,Andy Murray,Kevin Anderson,Andy Murray,6-4; 6-3; 7-6(6),R16,152,11,2,68,93,55,68,11,25,2,3,15,66,93,9,0,81,125,52,81,22,44,15,19,16,74,125
2014-06-23 00:00:00.000,Wimbledon Great Britain Grand Slams,GRASS,3,Grigor Dimitrov,Leonardo Mayer,Grigor Dimitrov,6-4; 7-6(6); 6-2,R16,129,10,3,66,97,52,66,19,31,3,3,15,71,97,11,2,61,98,41,61,19,37,2,5,15,60,98
2014-06-23 00:00:00.000,Wimbledon Great Britain Grand Slams,GRASS,3,Stan Wawrinka,Feliciano Lopez,Stan Wawrinka,7-6(5); 7-6(7); 6-3,R16,118,31,2,63,95,56,63,25,32,0,0,17,81,95,11,5,63,101,53,63,22,38,1,2,16,75,101
2014-06-23 00:00:00.000,Wimbledon Great Britain Grand Slams,GRASS,3,Roger Federer,Tommy Robredo,Roger Federer,6-1; 6-4; 6-4,R16,94,11,0,42,75,37,42,24,33,1,1,14,61,75,3,1,61,87,36,61,13,26,9,13,13,49,87
2014-06-23 00:00:00.000,Wimbledon Great Britain Grand Slams,GRASS,3,Milos Raonic,Kei Nishikori,Milos Raonic,4-6; 6-1; 7-6(4); 6-3,R16,147,35,2,75,114,64,75,23,39,6,7,20,87,114,11,1,72,113,52,72,23,41,4,7,18,75,113
2014-06-23 00:00:00.000,Wimbledon Great Britain Grand Slams,GRASS,3,Nick Kyrgios,Rafael Nadal,Nick Kyrgios,7-6(5); 5-7; 7-6(5); 6-3,R16,178,37,4,98,144,81,98,25,46,2,3,23,106,144,11,3,100,137,77,100,22,37,3,4,22,99,137
2014-06-23 00:00:00.000,Wimbledon Great Britain Grand Slams,GRASS,3,Novak Djokovic,Marin Cilic,Novak Djokovic,6-1; 3-6; 6-7(4); 6-2; 6-2,Q,198,10,3,92,132,68,92,23,40,2,4,22,91,132,10,6,89,160,61,89,29,71,12,19,22,90,160
2014-06-23 00:00:00.000,Wimbledon Great Britain Grand Slams,GRASS,3,Grigor Dimitrov,Andy Murray,Grigor Dimitrov,6-1; 7-6(4); 6-2,Q,121,10,3,57,91,44,57,20,34,1,2,14,64,91,5,5,50,82,36,50,10,32,4,9,13,46,82
2014-06-23 00:00:00.000,Wimbledon Great Britain Grand Slams,GRASS,3,Roger Federer,Stan Wawrinka,Roger Federer,3-6; 7-6(5); 6-4; 6-4,Q,153,10,1,77,119,61,77,29,42,3,4,20,90,119,9,1,74,124,57,74,31,50,5,7,21,88,124
2014-06-23 00:00:00.000,Wimbledon Great Britain Grand Slams,GRASS,3,Milos Raonic,Nick Kyrgios,Milos Raonic,6-7(4); 6-2; 6-4; 7-6(4),Q,144,39,2,78,111,69,78,22,33,0,1,21,91,111,15,1,103,144,69,103,22,41,5,9,21,91,144
2014-06-23 00:00:00.000,Wimbledon Great Britain Grand Slams,GRASS,3,Novak Djokovic,Grigor Dimitrov,Novak Djokovic,6-4; 3-6; 7-6(2); 7-6(7),S,182,17,2,102,145,74,102,24,43,8,11,21,98,145,15,8,82,131,67,82,22,49,3,6,22,89,131
2014-06-23 00:00:00.000,Wimbledon Great Britain Grand Slams,GRASS,3,Roger Federer,Milos Raonic,Roger Federer,6-4; 6-4; 6-4,S,101,6,1,52,80,42,52,19,28,1,1,15,61,80,17,4,46,84,37,46,19,38,4,7,15,56,84
2014-06-23 00:00:00.000,Wimbledon Great Britain Grand Slams,GRASS,3,Novak Djokovic,Roger Federer,Novak Djokovic,6-7(7); 6-4; 7-6(4); 5-7; 6-4,F,236,13,3,108,174,79,108,43,66,4,7,28,122,174,29,5,133,192,102,133,26,59,11,15,28,128,192
2014-07-07 00:00:00.000,Bastad Sweden ATP World Tour 250,CLAY,2,David Ferrer,N/A Bye,David Ferrer,,R32,0,0,0,0,0,0,0,0,0,0,0,0,0,0,0,0,0,0,0,0,0,0,0,0,0,0,0
2014-07-07 00:00:00.000,Bastad Sweden ATP World Tour 250,CLAY,2,Victor Hanescu,Pablo Andujar,Victor Hanescu,6-4; 6-4,R32,97,1,2,41,65,26,41,13,24,2,4,10,39,65,2,2,38,70,22,38,15,32,6,10,10,37,70
2014-07-07 00:00:00.000,Bastad Sweden ATP World Tour 250,CLAY,2,Radu Albot,Kenny De Schepper,Radu Albot,7-6(4); 6-1,R32,94,3,4,44,68,34,44,11,24,4,5,10,45,68,5,6,50,77,28,50,12,27,7,10,9,40,77
2014-07-07 00:00:00.000,Bastad Sweden ATP World Tour 250,CLAY,2,Carlos Berlocq,Julian Reister,Carlos Berlocq,2-6; 6-2; 6-2,R32,120,1,1,62,82,39,62,12,20,5,7,12,51,82,0,5,53,82,34,53,13,29,9,13,12,47,82
2014-07-07 00:00:00.000,Bastad Sweden ATP World Tour 250,CLAY,2,Jerzy Janowicz,N/A Bye,Jerzy Janowicz,,R32,0,0,0,0,0,0,0,0,0,0,0,0,0,0,0,0,0,0,0,0,0,0,0,0,0,0,0
2014-07-07 00:00:00.000,Bastad Sweden ATP World Tour 250,CLAY,2,Dusan Lajovic,Albert Montanes,Dusan Lajovic,6-3; 1-6; 7-6(4),R32,110,8,3,45,82,35,45,20,37,0,3,14,55,82,6,2,52,89,36,52,24,37,6,8,14,60,89
2014-07-07 00:00:00.000,Bastad Sweden ATP World Tour 250,CLAY,2,Elias Ymer,Mikhail Kukushkin,Elias Ymer,6-3; 7-5,R32,82,7,4,38,73,28,38,17,35,8,10,11,45,73,0,2,26,53,18,26,13,27,1,5,10,31,53
2014-07-07 00:00:00.000,Bastad Sweden ATP World Tour 250,CLAY,2,Joao Sousa,Pere Riba,Joao Sousa,0-1 RET,R32,11,0,0,0,0,0,0,0,0,0,0,0,0,0,0,1,7,12,7,7,0,5,2,2,1,7,12
2014-07-07 00:00:00.000,Bastad Sweden ATP World Tour 250,CLAY,2,Pablo Carreno Busta,Dustin Brown,Pablo Carreno Busta,6-3; 6-4,R32,78,5,4,46,76,37,46,13,30,9,9,10,50,76,4,6,30,57,23,30,14,27,1,3,9,37,57
2014-07-07 00:00:00.000,Bastad Sweden ATP World Tour 250,CLAY,2,Paolo Lorenzi,Markus Eriksson,Paolo Lorenzi,6-2; 6-1,R32,73,3,3,31,55,22,31,9,24,10,12,7,31,55,1,4,29,52,11,29,6,23,2,9,8,17,52
2014-07-07 00:00:00.000,Bastad Sweden ATP World Tour 250,CLAY,2,Albert Ramos-Vinolas,Jiri Vesely,Albert Ramos-Vinolas,7-5; 6-2,R32,90,3,2,34,54,28,34,11,20,2,3,10,39,54,6,1,53,72,29,53,9,19,5,9,10,38,72
2014-07-07 00:00:00.000,Bastad Sweden ATP World Tour 250,CLAY,2,Fernando Verdasco,N/A Bye,Fernando Verdasco,,R32,0,0,0,0,0,0,0,0,0,0,0,0,0,0,0,0,0,0,0,0,0,0,0,0,0,0,0
2014-07-07 00:00:00.000,Bastad Sweden ATP World Tour 250,CLAY,2,Pablo Cuevas,Jeremy Chardy,Pablo Cuevas,6-2; 6-2,R32,56,5,2,25,43,19,25,10,18,0,1,8,29,43,1,3,21,43,10,21,9,22,1,6,8,19,43
2014-07-07 00:00:00.000,Bastad Sweden ATP World Tour 250,CLAY,2,Christian Lindell,Inigo Cervantes,Christian Lindell,6-2; 6-3,R32,88,3,4,28,53,20,28,10,25,3,6,8,30,53,2,8,37,63,17,37,9,26,6,13,9,26,63
2014-07-07 00:00:00.000,Bastad Sweden ATP World Tour 250,CLAY,2,Renzo Olivo,Paul-Henri Mathieu,Renzo Olivo,5-2 RET,R32,27,0,2,7,15,7,7,5,8,0,0,3,12,15,0,5,10,24,6,10,6,14,2,4,4,12,24
2014-07-07 00:00:00.000,Bastad Sweden ATP World Tour 250,CLAY,2,Tommy Robredo,N/A Bye,Tommy Robredo,,R32,0,0,0,0,0,0,0,0,0,0,0,0,0,0,0,0,0,0,0,0,0,0,0,0,0,0,0
2014-07-07 00:00:00.000,Bastad Sweden ATP World Tour 250,CLAY,2,David Ferrer,Victor Hanescu,David Ferrer,6-4; 6-0,R16,61,2,2,18,43,16,18,17,25,1,1,8,33,43,1,0,28,43,16,28,6,15,4,8,8,22,43
2014-07-07 00:00:00.000,Bastad Sweden ATP World Tour 250,CLAY,2,Carlos Berlocq,Radu Albot,Carlos Berlocq,5-7; 6-4; 6-2,R16,162,5,4,66,98,46,66,17,32,6,8,15,63,98,0,2,68,102,42,68,16,34,7,11,15,58,102
2014-07-07 00:00:00.000,Bastad Sweden ATP World Tour 250,CLAY,2,Dusan Lajovic,Jerzy Janowicz,Dusan Lajovic,6-3; 1-1 RET,R16,46,6,2,18,34,16,18,10,16,0,0,6,26,34,3,7,21,37,16,21,7,16,4,5,5,23,37
2014-07-07 00:00:00.000,Bastad Sweden ATP World Tour 250,CLAY,2,Joao Sousa,Elias Ymer,Joao Sousa,6-3; 7-5,R16,88,2,2,34,69,29,34,20,35,5,6,11,49,69,2,2,38,63,28,38,10,25,3,6,10,38,63
2014-07-07 00:00:00.000,Bastad Sweden ATP World Tour 250,CLAY,2,Pablo Carreno Busta,Paolo Lorenzi,Pablo Carreno Busta,6-2; 6-2,R16,72,3,1,23,44,18,23,13,21,2,3,8,31,44,2,4,26,67,13,26,18,41,9,14,8,31,67
2014-07-07 00:00:00.000,Bastad Sweden ATP World Tour 250,CLAY,2,Fernando Verdasco,Albert Ramos-Vinolas,Fernando Verdasco,6-1; 7-5,R16,89,3,1,40,61,30,40,12,21,2,3,10,42,61,1,3,46,68,28,46,7,22,2,6,9,35,68
2014-07-07 00:00:00.000,Bastad Sweden ATP World Tour 250,CLAY,2,Pablo Cuevas,Christian Lindell,Pablo Cuevas,4-6; 6-2; 7-6(2),R16,135,6,2,58,91,42,58,18,33,3,6,15,60,91,8,6,61,98,43,61,13,37,6,10,15,56,98
2014-07-07 00:00:00.000,Bastad Sweden ATP World Tour 250,CLAY,2,Renzo Olivo,Tommy Robredo,Renzo Olivo,7-6(6); 6-3,R16,97,2,3,56,81,38,56,13,25,6,9,11,51,81,1,4,37,66,24,37,14,29,1,5,10,38,66
2014-07-07 00:00:00.000,Bastad Sweden ATP World Tour 250,CLAY,2,Carlos Berlocq,David Ferrer,Carlos Berlocq,6-3; 6-3,Q,85,5,4,35,59,28,35,11,24,4,6,9,39,59,0,1,32,62,14,32,17,30,2,7,9,31,62
2014-07-07 00:00:00.000,Bastad Sweden ATP World Tour 250,CLAY,2,Joao Sousa,Dusan Lajovic,Joao Sousa,6-4; 6-4,Q,92,3,2,42,73,29,42,16,31,8,10,10,45,73,3,4,46,77,23,46,16,31,8,12,10,39,77
2014-07-07 00:00:00.000,Bastad Sweden ATP World Tour 250,CLAY,2,Fernando Verdasco,Pablo Carreno Busta,Fernando Verdasco,7-5; 6-3,Q,88,2,3,43,67,34,43,14,24,1,1,11,48,67,3,1,29,53,22,29,13,24,1,3,10,35,53
2014-07-07 00:00:00.000,Bastad Sweden ATP World Tour 250,CLAY,2,Pablo Cuevas,Renzo Olivo,Pablo Cuevas,6-2; 6-4,Q,83,0,1,46,69,34,46,12,23,5,5,9,46,69,2,5,27,53,20,27,11,26,2,5,9,31,53
2014-07-07 00:00:00.000,Bastad Sweden ATP World Tour 250,CLAY,2,Joao Sousa,Carlos Berlocq,Joao Sousa,3-6; 6-4; 6-4,S,155,2,4,66,108,44,66,18,42,7,11,14,62,108,2,9,88,114,55,88,9,26,13,18,15,64,114
2014-07-07 00:00:00.000,Bastad Sweden ATP World Tour 250,CLAY,2,Pablo Cuevas,Fernando Verdasco,Pablo Cuevas,7-6(6); 6-3,S,104,10,4,44,81,37,44,19,37,5,5,11,56,81,5,4,41,68,29,41,14,27,6,7,10,43,68
2014-07-07 00:00:00.000,Bastad Sweden ATP World Tour 250,CLAY,2,Pablo Cuevas,Joao Sousa,Pablo Cuevas,6-2; 6-1,F,59,4,0,24,39,19,24,10,15,0,1,8,29,39,0,2,17,35,8,17,4,18,2,7,7,12,35
2014-07-07 00:00:00.000,Newport RI; U.S.A. ATP World Tour 250,GRASS,2,John Isner,Wayne Odesnik,John Isner,6-3; 7-6(6),R32,80,19,2,46,67,37,46,14,21,2,2,11,51,67,7,1,37,59,29,37,14,22,1,2,10,43,59
2014-07-07 00:00:00.000,Newport RI; U.S.A. ATP World Tour 250,GRASS,2,Austin Krajicek,Tim Smyczek,Austin Krajicek,7-6(7); 6-1,R32,83,5,2,35,63,29,35,19,28,0,0,10,48,63,3,4,47,76,35,47,11,29,3,5,9,46,76
2014-07-07 00:00:00.000,Newport RI; U.S.A. ATP World Tour 250,GRASS,2,Rajeev Ram,Matthew Ebden,Rajeev Ram,6-2; 7-5,R32,73,7,5,43,65,33,43,11,22,4,5,10,44,65,4,3,32,56,23,32,9,24,2,6,10,32,56
2014-07-07 00:00:00.000,Newport RI; U.S.A. ATP World Tour 250,GRASS,2,Jack Sock,Alex Kuznetsov,Jack Sock,6-4; 6-3,R32,84,4,9,37,75,26,37,21,38,5,6,10,47,75,6,2,27,66,20,27,18,39,3,6,9,38,66
2014-07-07 00:00:00.000,Newport RI; U.S.A. ATP World Tour 250,GRASS,2,Lleyton Hewitt,Ryan Harrison,Lleyton Hewitt,1-6; 7-5; 6-4,R32,130,3,10,45,93,30,45,20,48,5,10,14,50,93,9,6,37,88,29,37,22,51,4,9,15,51,88
2014-07-07 00:00:00.000,Newport RI; U.S.A. ATP World Tour 250,GRASS,2,Ante Pavic,Marius Copil,Ante Pavic,7-6(0); 6-4,R32,77,8,9,46,82,37,46,18,36,7,8,11,55,82,7,0,41,60,29,41,12,19,3,5,11,41,60
2014-07-07 00:00:00.000,Newport RI; U.S.A. ATP World Tour 250,GRASS,2,Tatsuma Ito,Mitchell Krueger,Tatsuma Ito,7-6(7); 6-1,R32,74,6,2,35,59,29,35,12,24,2,4,10,41,59,0,2,29,54,15,29,16,25,0,4,9,31,54
2014-07-07 00:00:00.000,Newport RI; U.S.A. ATP World Tour 250,GRASS,2,Steve Johnson,Clay Thompson,Steve Johnson,6-1; 6-2,R32,47,7,2,24,38,22,24,10,14,0,0,8,32,38,5,9,17,43,10,17,10,26,1,5,7,20,43
2014-07-07 00:00:00.000,Newport RI; U.S.A. ATP World Tour 250,GRASS,2,Sam Groth,Donald Young,Sam Groth,7-6(7); 6-2,R32,71,11,6,30,58,28,30,19,28,0,0,10,47,58,2,6,35,61,25,35,15,26,0,2,10,40,61
2014-07-07 00:00:00.000,Newport RI; U.S.A. ATP World Tour 250,GRASS,2,Malek Jaziri,Ricardas Berankis,Malek Jaziri,7-5; 6-3,R32,72,3,2,28,65,24,28,22,37,3,3,11,46,65,2,2,35,56,24,35,13,21,2,4,10,37,56
2014-07-07 00:00:00.000,Newport RI; U.S.A. ATP World Tour 250,GRASS,2,Luke Saville,Peter Polansky,Luke Saville,6-4; 6-2,R32,65,5,7,30,57,26,30,14,27,3,4,9,40,57,6,6,32,60,22,32,10,28,1,5,9,32,60
2014-07-07 00:00:00.000,Newport RI; U.S.A. ATP World Tour 250,GRASS,2,Nicolas Mahut,Facundo Arguello,Nicolas Mahut,7-6(1); 6-4,R32,90,11,6,35,64,28,35,22,29,0,0,11,50,64,5,3,44,77,33,44,16,33,2,3,11,49,77
2014-07-07 00:00:00.000,Newport RI; U.S.A. ATP World Tour 250,GRASS,2,Adrian Mannarino,Jimmy Wang,Adrian Mannarino,6-2; 6-4,R32,63,9,1,41,54,32,41,8,13,2,2,9,40,54,3,2,34,59,20,34,15,25,3,6,9,35,59
2014-07-07 00:00:00.000,Newport RI; U.S.A. ATP World Tour 250,GRASS,2,Dudi Sela,Michal Przysiezny,Dudi Sela,6-1; 7-6(2),R32,59,7,4,33,52,31,33,13,19,0,0,10,44,52,4,3,35,55,25,35,9,20,4,6,9,34,55
2014-07-07 00:00:00.000,Newport RI; U.S.A. ATP World Tour 250,GRASS,2,Sergiy Stakhovsky,Farrukh Dustov,Sergiy Stakhovsky,6-3; 6-2,R32,60,10,7,28,47,25,28,10,19,2,2,8,35,47,4,8,36,64,25,36,9,28,5,9,9,34,64
2014-07-07 00:00:00.000,Newport RI; U.S.A. ATP World Tour 250,GRASS,2,Ivo Karlovic,Robby Ginepri,Ivo Karlovic,7-6(2); 6-2,R32,64,17,1,38,55,35,38,10,17,1,1,10,45,55,2,2,34,57,24,34,14,23,2,4,10,38,57
2014-07-07 00:00:00.000,Newport RI; U.S.A. ATP World Tour 250,GRASS,2,John Isner,Austin Krajicek,John Isner,6-3; 6-3,R16,63,11,0,28,48,24,28,13,20,0,0,9,37,48,7,4,35,53,28,35,5,18,2,5,9,33,53
2014-07-07 00:00:00.000,Newport RI; U.S.A. ATP World Tour 250,GRASS,2,Jack Sock,Rajeev Ram,Jack Sock,7-5; 6-2,R16,78,12,5,55,85,41,55,15,30,9,9,10,56,85,5,3,29,51,22,29,11,22,1,4,10,33,51
2014-07-07 00:00:00.000,Newport RI; U.S.A. ATP World Tour 250,GRASS,2,Lleyton Hewitt,Ante Pavic,Lleyton Hewitt,6-2; 6-2,R16,66,4,4,34,56,26,34,13,22,7,7,8,39,56,7,5,24,52,16,24,11,28,4,8,8,27,52
2014-07-07 00:00:00.000,Newport RI; U.S.A. ATP World Tour 250,GRASS,2,Steve Johnson,Tatsuma Ito,Steve Johnson,6-3; 2-0 RET,R16,40,8,0,25,36,22,25,4,11,2,2,6,26,36,6,1,20,30,11,20,4,10,0,2,5,15,30
2014-07-07 00:00:00.000,Newport RI; U.S.A. ATP World Tour 250,GRASS,2,Sam Groth,Malek Jaziri,Sam Groth,7-6(7); 7-6(3),R16,102,24,3,47,75,41,47,15,28,2,3,12,56,75,3,7,36,97,27,36,32,61,3,4,12,59,97
2014-07-07 00:00:00.000,Newport RI; U.S.A. ATP World Tour 250,GRASS,2,Nicolas Mahut,Luke Saville,Nicolas Mahut,6-4; 6-2,R16,70,7,2,26,50,18,26,17,24,2,3,9,35,50,2,3,34,57,22,34,9,23,3,7,9,31,57
2014-07-07 00:00:00.000,Newport RI; U.S.A. ATP World Tour 250,GRASS,2,Dudi Sela,Adrian Mannarino,Dudi Sela,6-3; 6-1,R16,50,4,1,23,42,19,23,11,19,0,1,8,30,42,1,2,26,43,14,26,4,17,1,6,8,18,43
2014-07-07 00:00:00.000,Newport RI; U.S.A. ATP World Tour 250,GRASS,2,Ivo Karlovic,Sergiy Stakhovsky,Ivo Karlovic,7-5; 7-6(3),R16,80,18,4,40,63,37,40,11,23,0,1,12,48,63,2,6,42,72,31,42,16,30,4,6,12,47,72
2014-07-07 00:00:00.000,Newport RI; U.S.A. ATP World Tour 250,GRASS,2,Jack Sock,John Isner,Jack Sock,6-4; 7-6(4),Q,88,3,4,42,73,33,42,19,31,3,3,11,52,73,6,1,42,61,33,42,11,19,0,1,11,44,61
2014-07-07 00:00:00.000,Newport RI; U.S.A. ATP World Tour 250,GRASS,2,Lleyton Hewitt,Steve Johnson,Lleyton Hewitt,6-4; 6-4,Q,79,2,1,37,60,24,37,15,23,1,2,10,39,60,2,2,32,57,20,32,14,25,1,4,10,34,57
2014-07-07 00:00:00.000,Newport RI; U.S.A. ATP World Tour 250,GRASS,2,Sam Groth,Nicolas Mahut,Sam Groth,6-3; 6-4,Q,77,7,4,29,54,24,29,18,25,1,1,10,42,54,10,4,47,75,31,47,13,28,7,9,9,44,75
2014-07-07 00:00:00.000,Newport RI; U.S.A. ATP World Tour 250,GRASS,2,Ivo Karlovic,Dudi Sela,Ivo Karlovic,7-6(3); 7-5,Q,93,9,2,46,68,39,46,15,22,1,1,12,54,68,1,4,45,85,34,45,22,40,3,4,12,56,85
2014-07-07 00:00:00.000,Newport RI; U.S.A. ATP World Tour 250,GRASS,2,Lleyton Hewitt,Jack Sock,Lleyton Hewitt,6-1; 6-2,S,60,4,2,23,42,19,23,14,19,0,0,8,33,42,3,2,30,52,14,30,11,22,9,13,7,25,52
2014-07-07 00:00:00.000,Newport RI; U.S.A. ATP World Tour 250,GRASS,2,Ivo Karlovic,Sam Groth,Ivo Karlovic,6-4; 6-4,S,66,9,6,32,55,28,32,13,23,1,1,10,41,55,10,7,28,51,25,28,10,23,1,3,10,35,51
2014-07-07 00:00:00.000,Newport RI; U.S.A. ATP World Tour 250,GRASS,2,Lleyton Hewitt,Ivo Karlovic,Lleyton Hewitt,6-3; 6-7(4); 7-6(3),F,150,5,6,46,96,41,46,29,50,6,8,16,70,96,26,10,73,127,58,73,18,54,10,14,17,76,127
2014-07-07 00:00:00.000,Stuttgart Germany ATP World Tour 250,CLAY,2,Fabio Fognini,N/A Bye,Fabio Fognini,,R32,0,0,0,0,0,0,0,0,0,0,0,0,0,0,0,0,0,0,0,0,0,0,0,0,0,0,0
2014-07-07 00:00:00.000,Stuttgart Germany ATP World Tour 250,CLAY,2,Andrey Golubev,Philipp Petzschner,Andrey Golubev,6-4; 6-1,R32,80,6,4,30,63,23,30,17,33,3,4,9,40,63,0,5,30,64,20,30,13,34,7,11,8,33,64
2014-07-07 00:00:00.000,Stuttgart Germany ATP World Tour 250,CLAY,2,Philipp Davydenko,Blaz Rola,Philipp Davydenko,6-4; 7-6(8),R32,100,2,2,61,82,44,61,9,21,2,3,11,53,82,5,4,46,82,32,46,17,36,3,5,11,49,82
2014-07-07 00:00:00.000,Stuttgart Germany ATP World Tour 250,CLAY,2,Santiago Giraldo,Mate Delic,Santiago Giraldo,6-4; 6-2,R32,62,2,1,35,52,26,35,11,17,1,2,9,37,52,2,0,31,52,18,31,11,21,2,6,9,29,52
2014-07-07 00:00:00.000,Stuttgart Germany ATP World Tour 250,CLAY,2,Roberto Bautista Agut,N/A Bye,Roberto Bautista Agut,,R32,0,0,0,0,0,0,0,0,0,0,0,0,0,0,0,0,0,0,0,0,0,0,0,0,0,0,0
2014-07-07 00:00:00.000,Stuttgart Germany ATP World Tour 250,CLAY,2,Louk Sorensen,Igor Sijsling,Louk Sorensen,6-4; 6-1,R32,50,9,1,31,45,27,31,7,14,1,2,9,34,45,2,1,30,51,17,30,10,21,6,10,8,27,51
2014-07-07 00:00:00.000,Stuttgart Germany ATP World Tour 250,CLAY,2,Yann Marti,Henri Laaksonen,Yann Marti,7-5; 6-4,R32,92,3,3,41,73,28,41,14,32,5,8,11,42,73,0,7,37,63,20,37,12,26,1,6,11,32,63
2014-07-07 00:00:00.000,Stuttgart Germany ATP World Tour 250,CLAY,2,Guillermo Garcia-Lopez,Marco Cecchinato,Guillermo Garcia-Lopez,6-4; 1-6; 7-5,R32,122,2,4,61,88,41,61,13,27,6,10,14,54,88,2,2,69,97,44,69,13,28,8,12,15,57,97
2014-07-07 00:00:00.000,Stuttgart Germany ATP World Tour 250,CLAY,2,Philipp Kohlschreiber,Jan-Lennard Struff,Philipp Kohlschreiber,6-4; 6-3,R32,74,2,1,37,64,24,37,16,27,4,5,9,40,64,0,4,38,65,24,38,12,27,5,9,10,36,65
2014-07-07 00:00:00.000,Stuttgart Germany ATP World Tour 250,CLAY,2,Lukas Rosol,Alexander Zverev,Lukas Rosol,7-6(7); 7-6(9),R32,103,5,1,54,86,43,54,16,32,1,3,12,59,86,6,8,54,93,35,54,24,39,2,4,12,59,93
2014-07-07 00:00:00.000,Stuttgart Germany ATP World Tour 250,CLAY,2,Daniel Gimeno-Traver,Peter Gojowczyk,Daniel Gimeno-Traver,7-5; 6-3,R32,79,6,1,26,57,19,26,22,31,0,1,11,41,57,4,11,41,75,30,41,14,34,3,6,10,44,75
2014-07-07 00:00:00.000,Stuttgart Germany ATP World Tour 250,CLAY,2,Feliciano Lopez,N/A Bye,Feliciano Lopez,,R32,0,0,0,0,0,0,0,0,0,0,0,0,0,0,0,0,0,0,0,0,0,0,0,0,0,0,0
2014-07-07 00:00:00.000,Stuttgart Germany ATP World Tour 250,CLAY,2,Federico Delbonis,Juan Monaco,Federico Delbonis,6-4; 6-1,R32,80,3,7,41,74,31,41,17,33,7,8,9,48,74,1,1,36,52,19,36,8,16,5,9,8,27,52
2014-07-07 00:00:00.000,Stuttgart Germany ATP World Tour 250,CLAY,2,Benjamin Becker,Benoit Paire,Benjamin Becker,3-6; 6-2; 6-2,R32,84,11,6,49,87,40,49,18,38,5,6,12,58,87,11,3,40,81,28,40,18,41,8,12,13,46,81
2014-07-07 00:00:00.000,Stuttgart Germany ATP World Tour 250,CLAY,2,Leonardo Mayer,Michael Berrer,Leonardo Mayer,2-6; 6-3; 7-6(5),R32,130,7,7,49,90,39,49,24,41,1,3,15,63,90,2,3,52,89,39,52,21,37,4,5,14,60,89
2014-07-07 00:00:00.000,Stuttgart Germany ATP World Tour 250,CLAY,2,Mikhail Youzhny,N/A Bye,Mikhail Youzhny,,R32,0,0,0,0,0,0,0,0,0,0,0,0,0,0,0,0,0,0,0,0,0,0,0,0,0,0,0
2014-07-07 00:00:00.000,Stuttgart Germany ATP World Tour 250,CLAY,2,Fabio Fognini,Andrey Golubev,Fabio Fognini,6-4; 6-4,R16,79,0,4,40,66,30,40,15,26,2,2,10,45,66,1,0,34,59,23,34,16,25,1,3,10,39,59
2014-07-07 00:00:00.000,Stuttgart Germany ATP World Tour 250,CLAY,2,Santiago Giraldo,Philipp Davydenko,Santiago Giraldo,6-1; 6-7(5); 6-3,R16,116,2,1,67,88,53,67,12,21,2,4,15,65,88,1,1,74,101,46,74,11,27,11,16,13,57,101
2014-07-07 00:00:00.000,Stuttgart Germany ATP World Tour 250,CLAY,2,Roberto Bautista Agut,Louk Sorensen,Roberto Bautista Agut,6-3; 1-6; 6-1,R16,96,1,3,44,61,36,44,8,17,0,2,12,44,61,3,2,45,77,29,45,16,32,0,3,11,45,77
2014-07-07 00:00:00.000,Stuttgart Germany ATP World Tour 250,CLAY,2,Guillermo Garcia-Lopez,Yann Marti,Guillermo Garcia-Lopez,7-6(13); 7-5,R16,125,9,2,58,91,40,58,15,33,7,10,12,55,91,3,6,49,90,33,49,19,41,8,12,12,52,90
2014-07-07 00:00:00.000,Stuttgart Germany ATP World Tour 250,CLAY,2,Lukas Rosol,Philipp Kohlschreiber,Lukas Rosol,7-5; 7-6(5),R16,81,7,3,45,73,38,45,14,28,0,1,12,52,73,4,0,49,86,31,49,22,37,1,3,12,53,86
2014-07-07 00:00:00.000,Stuttgart Germany ATP World Tour 250,CLAY,2,Feliciano Lopez,Daniel Gimeno-Traver,Feliciano Lopez,6-7(3); 6-2; 6-3,R16,107,7,1,50,78,36,50,22,28,0,1,14,58,78,5,2,69,113,45,69,21,44,9,14,15,66,113
2014-07-07 00:00:00.000,Stuttgart Germany ATP World Tour 250,CLAY,2,Federico Delbonis,Benjamin Becker,Federico Delbonis,6-7(6); 6-4; 6-4,R16,133,3,1,71,112,53,71,26,41,1,1,16,79,112,6,4,64,113,50,64,23,49,7,9,16,73,113
2014-07-07 00:00:00.000,Stuttgart Germany ATP World Tour 250,CLAY,2,Mikhail Youzhny,Leonardo Mayer,Mikhail Youzhny,6-1; 6-1,R16,69,0,4,37,57,29,37,7,20,6,6,7,36,57,0,6,22,38,10,22,5,16,2,7,7,15,38
2014-07-07 00:00:00.000,Stuttgart Germany ATP World Tour 250,CLAY,2,Fabio Fognini,Santiago Giraldo,Fabio Fognini,6-4; 6-3,Q,81,2,3,34,61,25,34,18,27,1,1,10,43,61,3,0,42,63,31,42,8,21,4,6,9,39,63
2014-07-07 00:00:00.000,Stuttgart Germany ATP World Tour 250,CLAY,2,Roberto Bautista Agut,Guillermo Garcia-Lopez,Roberto Bautista Agut,3-6; 6-4; 7-6(1),Q,158,3,4,66,99,42,66,22,33,1,5,16,64,99,12,7,54,108,41,54,24,54,8,11,15,65,108
2014-07-07 00:00:00.000,Stuttgart Germany ATP World Tour 250,CLAY,2,Lukas Rosol,Feliciano Lopez,Lukas Rosol,4-6; 6-3; 7-6(4),Q,115,11,2,56,109,46,56,27,53,6,8,16,73,109,16,4,57,84,48,57,12,27,1,3,15,60,84
2014-07-07 00:00:00.000,Stuttgart Germany ATP World Tour 250,CLAY,2,Mikhail Youzhny,Federico Delbonis,Mikhail Youzhny,7-6(2); 6-2,Q,101,4,2,44,66,34,44,15,22,3,3,10,49,66,2,4,52,88,31,52,22,36,13,15,10,53,88
2014-07-07 00:00:00.000,Stuttgart Germany ATP World Tour 250,CLAY,2,Roberto Bautista Agut,Fabio Fognini,Roberto Bautista Agut,6-3; 6-4,S,74,2,1,39,57,32,39,10,18,5,5,10,42,57,4,3,36,60,24,36,11,24,0,2,9,35,60
2014-07-07 00:00:00.000,Stuttgart Germany ATP World Tour 250,CLAY,2,Lukas Rosol,Mikhail Youzhny,Lukas Rosol,7-6(3); 6-2,S,89,10,4,38,72,29,38,17,34,3,5,10,46,72,5,3,35,62,21,35,12,27,5,9,10,33,62
2014-07-07 00:00:00.000,Stuttgart Germany ATP World Tour 250,CLAY,2,Roberto Bautista Agut,Lukas Rosol,Roberto Bautista Agut,6-3; 4-6; 6-2,F,102,2,1,57,81,42,57,15,24,5,6,14,57,81,13,2,38,82,30,38,21,44,3,6,13,51,82
2014-07-14 00:00:00.000,Bogota Colombia ATP World Tour 250,HARD,2,Richard Gasquet,N/A Bye,Richard Gasquet,,R32,0,0,0,0,0,0,0,0,0,0,0,0,0,0,0,0,0,0,0,0,0,0,0,0,0,0,0
2014-07-14 00:00:00.000,Bogota Colombia ATP World Tour 250,HARD,2,Sam Groth,Juan Sebastian Cabal,Sam Groth,6-3; 6-7(10); 7-6(4),R32,141,22,6,68,110,56,68,19,42,2,4,17,75,110,11,8,78,119,54,78,22,41,5,8,16,76,119
2014-07-14 00:00:00.000,Bogota Colombia ATP World Tour 250,HARD,2,Peter Polansky,Nicolas Barrientos,Peter Polansky,3-6; 6-4; 6-3,R32,84,9,4,50,78,37,50,15,28,4,7,14,52,78,1,1,57,82,34,57,14,25,1,5,14,48,82
2014-07-14 00:00:00.000,Bogota Colombia ATP World Tour 250,HARD,2,Victor Estrella Burgos,Juan Ignacio Londero,Victor Estrella Burgos,7-5; 6-3,R32,81,6,0,39,67,29,39,15,28,1,3,11,44,67,1,1,30,57,16,30,16,27,3,7,10,32,57
2014-07-14 00:00:00.000,Bogota Colombia ATP World Tour 250,HARD,2,Vasek Pospisil,N/A Bye,Vasek Pospisil,,R32,0,0,0,0,0,0,0,0,0,0,0,0,0,0,0,0,0,0,0,0,0,0,0,0,0,0,0
2014-07-14 00:00:00.000,Bogota Colombia ATP World Tour 250,HARD,2,Alex Kuznetsov,Adrian Mannarino,Alex Kuznetsov,6-4; 7-6(3),R32,91,9,3,39,70,33,39,18,31,1,1,11,51,70,3,2,45,67,32,45,15,22,1,2,11,47,67
2014-07-14 00:00:00.000,Bogota Colombia ATP World Tour 250,HARD,2,Bernard Tomic,Farrukh Dustov,Bernard Tomic,6-3; 6-3,R32,59,10,0,36,47,31,36,7,11,0,0,9,38,47,4,1,40,58,29,40,5,18,1,4,9,34,58
2014-07-14 00:00:00.000,Bogota Colombia ATP World Tour 250,HARD,2,Alejandro Falla,Tatsuma Ito,Alejandro Falla,6-3; 6-2,R32,59,7,5,32,58,28,32,11,26,6,7,9,39,58,2,3,22,42,14,22,8,20,2,6,8,22,42
2014-07-14 00:00:00.000,Bogota Colombia ATP World Tour 250,HARD,2,Alejandro Gonzalez,Evgeny Donskoy,Alejandro Gonzalez,7-5; 3-6; 6-4,R32,140,7,4,58,102,45,58,17,44,5,9,16,62,102,7,1,64,103,37,64,22,39,3,7,15,59,103
2014-07-14 00:00:00.000,Bogota Colombia ATP World Tour 250,HARD,2,Thiemo de Bakker,Kevin King,Thiemo de Bakker,2-6; 7-6(4); 6-3,R32,122,14,6,69,100,51,69,13,31,2,5,15,64,100,7,8,60,100,44,60,22,40,7,9,14,66,100
2014-07-14 00:00:00.000,Bogota Colombia ATP World Tour 250,HARD,2,Guido Pella,Eduardo Struvay,Guido Pella,6-3; 6-4,R32,64,2,3,35,62,24,35,16,27,5,7,10,40,62,1,0,34,45,22,34,4,11,2,6,9,26,45
2014-07-14 00:00:00.000,Bogota Colombia ATP World Tour 250,HARD,2,Radek Stepanek,N/A Bye,Radek Stepanek,,R32,0,0,0,0,0,0,0,0,0,0,0,0,0,0,0,0,0,0,0,0,0,0,0,0,0,0,0
2014-07-14 00:00:00.000,Bogota Colombia ATP World Tour 250,HARD,2,James Ward,Matthew Ebden,James Ward,6-4; 3-0 RET,R32,54,5,2,27,42,22,27,9,15,3,3,7,31,42,1,4,21,41,14,21,10,20,3,5,6,24,41
2014-07-14 00:00:00.000,Bogota Colombia ATP World Tour 250,HARD,2,Jimmy Wang,Michal Przysiezny,Jimmy Wang,7-6(4); 4-6; 6-3,R32,131,4,5,67,112,45,67,19,45,6,11,16,64,112,12,5,50,86,36,50,15,36,3,8,15,51,86
2014-07-14 00:00:00.000,Bogota Colombia ATP World Tour 250,HARD,2,Dudi Sela,Facundo Arguello,Dudi Sela,6-4; 6-2,R32,60,0,6,31,48,25,31,7,17,1,3,9,32,48,2,10,33,60,22,33,7,27,0,5,9,29,60
2014-07-14 00:00:00.000,Bogota Colombia ATP World Tour 250,HARD,2,Ivo Karlovic,N/A Bye,Ivo Karlovic,,R32,0,0,0,0,0,0,0,0,0,0,0,0,0,0,0,0,0,0,0,0,0,0,0,0,0,0,0
2014-07-14 00:00:00.000,Bogota Colombia ATP World Tour 250,HARD,2,Richard Gasquet,Sam Groth,Richard Gasquet,7-6(3); 7-6(5),R16,104,12,3,50,71,41,50,15,21,0,0,12,56,71,20,4,44,78,37,44,20,34,5,5,12,57,78
2014-07-14 00:00:00.000,Bogota Colombia ATP World Tour 250,HARD,2,Victor Estrella Burgos,Peter Polansky,Victor Estrella Burgos,6-4; 6-1,R16,49,5,1,22,38,21,22,11,16,0,0,8,32,38,1,4,20,46,13,20,10,26,2,6,9,23,46
2014-07-14 00:00:00.000,Bogota Colombia ATP World Tour 250,HARD,2,Vasek Pospisil,Alex Kuznetsov,Vasek Pospisil,7-5; 7-5,R16,76,10,4,34,63,31,34,19,29,3,3,12,50,63,4,5,38,60,30,38,14,22,2,4,12,44,60
2014-07-14 00:00:00.000,Bogota Colombia ATP World Tour 250,HARD,2,Bernard Tomic,Alejandro Falla,Bernard Tomic,6-1; 7-6(2),R16,90,7,2,45,64,36,45,10,19,1,2,10,46,64,5,5,51,88,33,51,14,37,7,10,9,47,88
2014-07-14 00:00:00.000,Bogota Colombia ATP World Tour 250,HARD,2,Alejandro Gonzalez,Thiemo de Bakker,Alejandro Gonzalez,6-3; 6-4,R16,65,5,1,36,58,28,36,15,22,1,1,10,43,58,5,4,26,53,22,26,11,27,2,4,9,33,53
2014-07-14 00:00:00.000,Bogota Colombia ATP World Tour 250,HARD,2,Radek Stepanek,Guido Pella,Radek Stepanek,7-6(2); 6-2,R16,103,6,3,35,62,27,35,17,27,2,3,10,44,62,4,3,43,80,26,43,17,37,6,9,10,43,80
2014-07-14 00:00:00.000,Bogota Colombia ATP World Tour 250,HARD,2,Jimmy Wang,James Ward,Jimmy Wang,6-3; 6-1,R16,48,2,0,26,39,21,26,11,13,0,0,8,32,39,4,3,25,43,16,25,8,18,0,4,8,24,43
2014-07-14 00:00:00.000,Bogota Colombia ATP World Tour 250,HARD,2,Ivo Karlovic,Dudi Sela,Ivo Karlovic,7-6(8); 7-6(5),R16,100,16,4,50,76,44,50,17,26,0,0,12,61,76,3,2,55,90,42,55,24,35,7,7,12,66,90
2014-07-14 00:00:00.000,Bogota Colombia ATP World Tour 250,HARD,2,Victor Estrella Burgos,Richard Gasquet,Victor Estrella Burgos,6-3; 6-4,Q,65,2,3,22,48,19,22,18,26,2,2,9,37,48,5,2,25,52,19,25,16,27,2,5,10,35,52
2014-07-14 00:00:00.000,Bogota Colombia ATP World Tour 250,HARD,2,Bernard Tomic,Vasek Pospisil,Bernard Tomic,6-4; 6-4,Q,70,8,2,39,58,32,39,11,19,1,1,10,43,58,10,5,37,59,26,37,11,22,2,4,10,37,59
2014-07-14 00:00:00.000,Bogota Colombia ATP World Tour 250,HARD,2,Radek Stepanek,Alejandro Gonzalez,Radek Stepanek,6-4; 6-4,Q,80,8,2,43,60,36,43,8,17,3,3,10,44,60,7,2,40,62,27,40,11,22,1,3,10,38,62
2014-07-14 00:00:00.000,Bogota Colombia ATP World Tour 250,HARD,2,Ivo Karlovic,Jimmy Wang,Ivo Karlovic,6-3; 7-6(6),Q,84,21,0,35,54,33,35,12,19,0,0,10,45,54,5,5,45,79,32,45,18,34,5,7,11,50,79
2014-07-14 00:00:00.000,Bogota Colombia ATP World Tour 250,HARD,2,Bernard Tomic,Victor Estrella Burgos,Bernard Tomic,7-6(2); 6-7(5); 7-6(5),S,167,21,3,76,123,58,76,25,47,2,4,18,83,123,8,4,77,117,55,77,24,40,1,3,18,79,117
2014-07-14 00:00:00.000,Bogota Colombia ATP World Tour 250,HARD,2,Ivo Karlovic,Radek Stepanek,Ivo Karlovic,6-4; 3-6; 6-4,S,103,22,3,59,82,44,59,15,23,5,6,14,59,82,7,4,50,81,39,50,18,31,1,3,15,57,81
2014-07-14 00:00:00.000,Bogota Colombia ATP World Tour 250,HARD,2,Bernard Tomic,Ivo Karlovic,Bernard Tomic,7-6(5); 3-6; 7-6(4),F,133,11,2,69,101,55,69,20,32,4,5,16,75,101,39,7,74,114,65,74,19,40,5,5,17,84,114
2014-07-14 00:00:00.000,Hamburg Germany ATP World Tour 500,CLAY,2,David Ferrer,N/A Bye,David Ferrer,,R64,0,0,0,0,0,0,0,0,0,0,0,0,0,0,0,0,0,0,0,0,0,0,0,0,0,0,0
2014-07-14 00:00:00.000,Hamburg Germany ATP World Tour 500,CLAY,2,Mikhail Kukushkin,Marsel Ilhan,Mikhail Kukushkin,6-2; 6-2,R64,60,0,1,22,38,18,22,14,16,0,0,8,32,38,4,2,36,68,19,36,16,32,6,10,8,35,68
2014-07-14 00:00:00.000,Hamburg Germany ATP World Tour 500,CLAY,2,Juan Monaco,Pere Riba,Juan Monaco,6-3; 6-1,R64,53,6,1,31,49,20,31,11,18,2,4,8,31,49,0,1,37,50,14,37,5,13,4,10,8,19,50
2014-07-14 00:00:00.000,Hamburg Germany ATP World Tour 500,CLAY,2,Andreas Seppi,N/A Bye,Andreas Seppi,,R64,0,0,0,0,0,0,0,0,0,0,0,0,0,0,0,0,0,0,0,0,0,0,0,0,0,0,0
2014-07-14 00:00:00.000,Hamburg Germany ATP World Tour 500,CLAY,2,Fernando Verdasco,N/A Bye,Fernando Verdasco,,R64,0,0,0,0,0,0,0,0,0,0,0,0,0,0,0,0,0,0,0,0,0,0,0,0,0,0,0
2014-07-14 00:00:00.000,Hamburg Germany ATP World Tour 500,CLAY,2,Dustin Brown,Pablo Carreno Busta,Dustin Brown,7-6(5); 6-3,R64,81,2,3,43,64,37,43,14,21,1,1,11,51,64,6,3,41,73,30,41,19,32,2,3,10,49,73
2014-07-14 00:00:00.000,Hamburg Germany ATP World Tour 500,CLAY,2,Pablo Andujar,Mate Delic,Pablo Andujar,6-4; 6-2,R64,79,0,0,40,58,26,40,12,18,2,3,9,38,58,1,1,38,55,23,38,7,17,3,7,9,30,55
2014-07-14 00:00:00.000,Hamburg Germany ATP World Tour 500,CLAY,2,Thomaz Bellucci,N/A Bye,Thomaz Bellucci,,R64,0,0,0,0,0,0,0,0,0,0,0,0,0,0,0,0,0,0,0,0,0,0,0,0,0,0,0
2014-07-14 00:00:00.000,Hamburg Germany ATP World Tour 500,CLAY,2,Alexandr Dolgopolov,N/A Bye,Alexandr Dolgopolov,,R64,0,0,0,0,0,0,0,0,0,0,0,0,0,0,0,0,0,0,0,0,0,0,0,0,0,0,0
2014-07-14 00:00:00.000,Hamburg Germany ATP World Tour 500,CLAY,2,Jerzy Janowicz,Albert Ramos-Vinolas,Jerzy Janowicz,6-0; 7-5,R64,83,6,3,35,60,29,35,14,25,4,4,9,43,60,2,2,33,56,20,33,11,23,3,7,9,31,56
2014-07-14 00:00:00.000,Hamburg Germany ATP World Tour 500,CLAY,2,Tobias Kamke,Jarkko Nieminen,Tobias Kamke,6-3; 4-6; 6-2,R64,119,2,1,50,84,33,50,20,34,1,4,14,53,84,4,5,42,83,28,42,19,41,9,14,13,47,83
2014-07-14 00:00:00.000,Hamburg Germany ATP World Tour 500,CLAY,2,Federico Delbonis,N/A Bye,Federico Delbonis,,R64,0,0,0,0,0,0,0,0,0,0,0,0,0,0,0,0,0,0,0,0,0,0,0,0,0,0,0
2014-07-14 00:00:00.000,Hamburg Germany ATP World Tour 500,CLAY,2,Santiago Giraldo,N/A Bye,Santiago Giraldo,,R64,0,0,0,0,0,0,0,0,0,0,0,0,0,0,0,0,0,0,0,0,0,0,0,0,0,0,0
2014-07-14 00:00:00.000,Hamburg Germany ATP World Tour 500,CLAY,2,Benoit Paire,Andrey Golubev,Benoit Paire,1-6; 6-1; 7-6(4),R64,105,3,5,51,89,38,51,15,38,4,7,13,53,89,5,1,49,76,35,49,14,27,4,7,13,49,76
2014-07-14 00:00:00.000,Hamburg Germany ATP World Tour 500,CLAY,2,Alexander Zverev,Robin Haase,Alexander Zverev,6-0; 6-2,R64,58,3,1,25,44,17,25,15,19,2,2,7,32,44,1,0,34,52,17,34,5,18,4,9,7,22,52
2014-07-14 00:00:00.000,Hamburg Germany ATP World Tour 500,CLAY,2,Mikhail Youzhny,N/A Bye,Mikhail Youzhny,,R64,0,0,0,0,0,0,0,0,0,0,0,0,0,0,0,0,0,0,0,0,0,0,0,0,0,0,0
2014-07-14 00:00:00.000,Hamburg Germany ATP World Tour 500,CLAY,2,Philipp Kohlschreiber,N/A Bye,Philipp Kohlschreiber,,R64,0,0,0,0,0,0,0,0,0,0,0,0,0,0,0,0,0,0,0,0,0,0,0,0,0,0,0
2014-07-14 00:00:00.000,Hamburg Germany ATP World Tour 500,CLAY,2,Gastao Elias,Albert Montanes,Gastao Elias,6-4; 6-3,R64,75,9,1,32,61,28,32,16,29,4,4,10,44,61,1,6,29,61,19,29,16,32,3,5,9,35,61
2014-07-14 00:00:00.000,Hamburg Germany ATP World Tour 500,CLAY,2,Martin Klizan,Igor Sijsling,Martin Klizan,6-4; 3-6; 6-0,R64,81,6,5,37,76,31,37,19,39,4,7,13,50,76,0,1,66,82,35,66,9,16,6,11,12,44,82
2014-07-14 00:00:00.000,Hamburg Germany ATP World Tour 500,CLAY,2,Gilles Simon,N/A Bye,Gilles Simon,,R64,0,0,0,0,0,0,0,0,0,0,0,0,0,0,0,0,0,0,0,0,0,0,0,0,0,0,0
2014-07-14 00:00:00.000,Hamburg Germany ATP World Tour 500,CLAY,2,Joao Sousa,N/A Bye,Joao Sousa,,R64,0,0,0,0,0,0,0,0,0,0,0,0,0,0,0,0,0,0,0,0,0,0,0,0,0,0,0
2014-07-14 00:00:00.000,Hamburg Germany ATP World Tour 500,CLAY,2,Lukas Rosol,Julian Reister,Lukas Rosol,6-4; 2-1 RET,R64,61,3,2,24,43,16,24,10,19,5,6,6,26,43,0,3,33,46,23,33,2,13,3,6,7,25,46
2014-07-14 00:00:00.000,Hamburg Germany ATP World Tour 500,CLAY,2,Daniel Gimeno-Traver,Teymuraz Gabashvili,Daniel Gimeno-Traver,6-2; 6-3,R64,80,4,5,30,55,26,30,12,25,3,4,9,38,55,0,5,48,75,27,48,12,27,10,14,8,39,75
2014-07-14 00:00:00.000,Hamburg Germany ATP World Tour 500,CLAY,2,Tommy Robredo,N/A Bye,Tommy Robredo,,R64,0,0,0,0,0,0,0,0,0,0,0,0,0,0,0,0,0,0,0,0,0,0,0,0,0,0,0
2014-07-14 00:00:00.000,Hamburg Germany ATP World Tour 500,CLAY,2,Marcel Granollers,N/A Bye,Marcel Granollers,,R64,0,0,0,0,0,0,0,0,0,0,0,0,0,0,0,0,0,0,0,0,0,0,0,0,0,0,0
2014-07-14 00:00:00.000,Hamburg Germany ATP World Tour 500,CLAY,2,Dominic Thiem,Jiri Vesely,Dominic Thiem,7-5; 6-0,R64,83,3,1,21,49,20,21,15,28,0,1,9,35,49,2,5,54,74,31,54,5,20,11,16,9,36,74
2014-07-14 00:00:00.000,Hamburg Germany ATP World Tour 500,CLAY,2,Leonardo Mayer,Peter Gojowczyk,Leonardo Mayer,6-3; 6-2,R64,74,5,3,32,49,26,32,10,17,1,2,9,36,49,4,3,30,63,21,30,10,33,10,14,8,31,63
2014-07-14 00:00:00.000,Hamburg Germany ATP World Tour 500,CLAY,2,Guillermo Garcia-Lopez,N/A Bye,Guillermo Garcia-Lopez,,R64,0,0,0,0,0,0,0,0,0,0,0,0,0,0,0,0,0,0,0,0,0,0,0,0,0,0,0
2014-07-14 00:00:00.000,Hamburg Germany ATP World Tour 500,CLAY,2,Carlos Berlocq,N/A Bye,Carlos Berlocq,,R64,0,0,0,0,0,0,0,0,0,0,0,0,0,0,0,0,0,0,0,0,0,0,0,0,0,0,0
2014-07-14 00:00:00.000,Hamburg Germany ATP World Tour 500,CLAY,2,Dusan Lajovic,Kenny De Schepper,Dusan Lajovic,6-3; 6-2,R64,62,1,2,34,55,26,34,14,21,2,2,9,40,55,7,5,33,61,22,33,13,28,3,6,8,35,61
2014-07-14 00:00:00.000,Hamburg Germany ATP World Tour 500,CLAY,2,Filip Krajinovic,Jan-Lennard Struff,Filip Krajinovic,1-6; 7-5; 6-2,R64,107,7,3,44,75,29,44,13,31,1,6,13,42,75,3,5,38,81,28,38,18,43,3,9,14,46,81
2014-07-14 00:00:00.000,Hamburg Germany ATP World Tour 500,CLAY,2,Fabio Fognini,N/A Bye,Fabio Fognini,,R64,0,0,0,0,0,0,0,0,0,0,0,0,0,0,0,0,0,0,0,0,0,0,0,0,0,0,0
2014-07-14 00:00:00.000,Hamburg Germany ATP World Tour 500,CLAY,2,David Ferrer,Mikhail Kukushkin,David Ferrer,2-6; 6-3; 6-2,R32,117,2,3,41,80,28,41,24,39,8,11,13,52,80,2,2,41,90,29,41,19,49,6,10,12,48,90
2014-07-14 00:00:00.000,Hamburg Germany ATP World Tour 500,CLAY,2,Andreas Seppi,Juan Monaco,Andreas Seppi,1-6; 6-0; 7-6(3),R32,119,0,1,43,71,32,43,11,28,3,7,12,43,71,2,3,70,94,37,70,13,24,6,11,13,50,94
2014-07-14 00:00:00.000,Hamburg Germany ATP World Tour 500,CLAY,2,Dustin Brown,Fernando Verdasco,Dustin Brown,4-6; 6-2; 7-6(8),R32,113,9,6,65,113,46,65,22,48,7,10,15,68,113,0,5,66,93,46,66,14,27,4,8,15,60,93
2014-07-14 00:00:00.000,Hamburg Germany ATP World Tour 500,CLAY,2,Pablo Andujar,Thomaz Bellucci,Pablo Andujar,6-4; 3-6; 6-2,R32,118,1,1,37,65,29,37,16,28,0,2,13,45,65,6,3,50,92,32,50,22,42,6,10,14,54,92
2014-07-14 00:00:00.000,Hamburg Germany ATP World Tour 500,CLAY,2,Alexandr Dolgopolov,Jerzy Janowicz,Alexandr Dolgopolov,6-4; 6-1,R32,71,6,1,27,57,20,27,13,30,5,7,9,33,57,1,6,32,52,19,32,5,20,2,7,8,24,52
2014-07-14 00:00:00.000,Hamburg Germany ATP World Tour 500,CLAY,2,Tobias Kamke,Federico Delbonis,Tobias Kamke,6-3; 6-4,R32,85,1,2,50,76,35,50,14,26,4,4,10,49,76,4,2,31,50,23,31,10,19,1,3,9,33,50
2014-07-14 00:00:00.000,Hamburg Germany ATP World Tour 500,CLAY,2,Santiago Giraldo,Benoit Paire,Santiago Giraldo,7-6(6); 6-2,R32,83,3,2,55,69,41,55,7,14,2,3,10,48,69,6,1,40,80,31,40,16,40,7,10,10,47,80
2014-07-14 00:00:00.000,Hamburg Germany ATP World Tour 500,CLAY,2,Alexander Zverev,Mikhail Youzhny,Alexander Zverev,7-5; 7-5,R32,120,0,6,36,77,25,36,23,41,3,5,12,48,77,1,4,46,86,25,46,21,40,7,11,12,46,86
2014-07-14 00:00:00.000,Hamburg Germany ATP World Tour 500,CLAY,2,Philipp Kohlschreiber,Gastao Elias,Philipp Kohlschreiber,7-5; 6-1,R32,85,3,1,31,55,24,31,14,24,2,3,10,38,55,2,3,42,76,23,42,15,34,8,12,9,38,76
2014-07-14 00:00:00.000,Hamburg Germany ATP World Tour 500,CLAY,2,Gilles Simon,Martin Klizan,Gilles Simon,W/O,R32,0,0,0,0,0,0,0,0,0,0,0,0,0,0,0,0,0,0,0,0,0,0,0,0,0,0,0
2014-07-14 00:00:00.000,Hamburg Germany ATP World Tour 500,CLAY,2,Lukas Rosol,Joao Sousa,Lukas Rosol,6-2; 6-4,R32,70,3,1,21,49,14,21,19,28,1,3,9,33,49,1,1,40,63,20,40,10,23,4,9,9,30,63
2014-07-14 00:00:00.000,Hamburg Germany ATP World Tour 500,CLAY,2,Tommy Robredo,Daniel Gimeno-Traver,Tommy Robredo,6-2; 7-5,R32,85,2,0,34,55,25,34,11,21,1,3,10,36,55,1,1,38,68,22,38,12,30,2,7,10,34,68
2014-07-14 00:00:00.000,Hamburg Germany ATP World Tour 500,CLAY,2,Dominic Thiem,Marcel Granollers,Dominic Thiem,2-6; 6-3; 7-5,R32,149,1,1,54,95,36,54,23,41,5,8,15,59,95,9,3,60,100,45,60,18,40,9,12,14,63,100
2014-07-14 00:00:00.000,Hamburg Germany ATP World Tour 500,CLAY,2,Leonardo Mayer,Guillermo Garcia-Lopez,Leonardo Mayer,7-6(1); 7-6(3),R32,128,5,4,44,82,35,44,21,38,6,8,12,56,82,1,4,60,94,39,60,16,34,8,10,12,55,94
2014-07-14 00:00:00.000,Hamburg Germany ATP World Tour 500,CLAY,2,Dusan Lajovic,Carlos Berlocq,Dusan Lajovic,6-3; 6-4,R32,84,3,3,50,66,38,50,7,16,2,2,10,45,66,1,0,39,59,26,39,12,20,6,8,9,38,59
2014-07-14 00:00:00.000,Hamburg Germany ATP World Tour 500,CLAY,2,Filip Krajinovic,Fabio Fognini,Filip Krajinovic,6-4; 6-0,R32,54,4,0,26,44,20,26,12,18,1,2,8,32,44,3,3,32,51,16,32,7,19,5,10,8,23,51
2014-07-14 00:00:00.000,Hamburg Germany ATP World Tour 500,CLAY,2,David Ferrer,Andreas Seppi,David Ferrer,6-3; 3-6; 6-3,R16,114,9,6,49,84,36,49,19,35,4,6,14,55,84,2,1,56,80,33,56,17,24,5,8,13,50,80
2014-07-14 00:00:00.000,Hamburg Germany ATP World Tour 500,CLAY,2,Pablo Andujar,Dustin Brown,Pablo Andujar,6-1; 6-2,R16,63,0,2,44,59,30,44,8,15,3,3,8,38,59,3,2,24,43,13,24,8,19,2,6,7,21,43
2014-07-14 00:00:00.000,Hamburg Germany ATP World Tour 500,CLAY,2,Tobias Kamke,Alexandr Dolgopolov,Tobias Kamke,7-5; 2-6; 7-5,R16,122,1,3,66,100,41,66,21,34,8,11,16,62,100,8,1,53,89,42,53,20,36,2,5,16,62,89
2014-07-14 00:00:00.000,Hamburg Germany ATP World Tour 500,CLAY,2,Alexander Zverev,Santiago Giraldo,Alexander Zverev,6-4; 7-6(6),R16,113,7,2,52,85,35,52,19,33,2,3,11,54,85,6,0,51,74,35,51,13,23,3,5,11,48,74
2014-07-14 00:00:00.000,Hamburg Germany ATP World Tour 500,CLAY,2,Philipp Kohlschreiber,Gilles Simon,Philipp Kohlschreiber,7-5; 6-3,R16,90,2,0,33,58,21,33,15,25,2,5,10,36,58,4,2,48,82,28,48,12,34,6,12,11,40,82
2014-07-14 00:00:00.000,Hamburg Germany ATP World Tour 500,CLAY,2,Lukas Rosol,Tommy Robredo,Lukas Rosol,7-5; 7-6(6),R16,106,7,0,60,94,42,60,22,34,7,7,12,64,94,4,2,41,69,33,41,15,28,0,1,12,48,69
2014-07-14 00:00:00.000,Hamburg Germany ATP World Tour 500,CLAY,2,Leonardo Mayer,Dominic Thiem,Leonardo Mayer,6-3; 6-2,R16,77,5,4,34,58,27,34,15,24,4,4,9,42,58,1,2,32,50,21,32,7,18,4,7,8,28,50
2014-07-14 00:00:00.000,Hamburg Germany ATP World Tour 500,CLAY,2,Dusan Lajovic,Filip Krajinovic,Dusan Lajovic,3-1 RET,R16,12,2,0,5,9,5,5,3,4,0,0,2,8,9,2,0,5,13,4,5,3,8,2,3,2,7,13
2014-07-14 00:00:00.000,Hamburg Germany ATP World Tour 500,CLAY,2,David Ferrer,Pablo Andujar,David Ferrer,6-0; 6-2,Q,66,1,1,28,40,19,28,7,12,1,2,7,26,40,0,5,33,52,16,33,3,19,4,10,7,19,52
2014-07-14 00:00:00.000,Hamburg Germany ATP World Tour 500,CLAY,2,Alexander Zverev,Tobias Kamke,Alexander Zverev,0-6; 7-5; 6-3,Q,124,6,4,44,82,31,44,15,38,7,11,13,46,82,0,2,44,80,29,44,22,36,7,11,14,51,80
2014-07-14 00:00:00.000,Hamburg Germany ATP World Tour 500,CLAY,2,Philipp Kohlschreiber,Lukas Rosol,Philipp Kohlschreiber,6-4; 6-4,Q,77,2,0,31,52,23,31,14,21,1,2,10,37,52,5,1,42,74,32,42,11,32,7,10,10,43,74
2014-07-14 00:00:00.000,Hamburg Germany ATP World Tour 500,CLAY,2,Leonardo Mayer,Dusan Lajovic,Leonardo Mayer,6-1; 7-5,Q,75,4,0,34,58,29,34,14,24,1,1,10,43,58,0,1,24,50,18,24,12,26,2,5,9,30,50
2014-07-14 00:00:00.000,Hamburg Germany ATP World Tour 500,CLAY,2,David Ferrer,Alexander Zverev,David Ferrer,6-0; 6-1,S,56,2,3,31,43,26,31,6,12,2,2,7,32,43,3,3,18,40,9,18,6,22,3,8,6,15,40
2014-07-14 00:00:00.000,Hamburg Germany ATP World Tour 500,CLAY,2,Leonardo Mayer,Philipp Kohlschreiber,Leonardo Mayer,7-5; 6-4,S,89,6,2,31,60,23,31,17,29,1,3,11,40,60,5,0,37,61,23,37,13,24,3,7,11,36,61
2014-07-14 00:00:00.000,Hamburg Germany ATP World Tour 500,CLAY,2,Leonardo Mayer,David Ferrer,Leonardo Mayer,6-7(3); 6-1; 7-6(4),F,140,10,4,61,97,47,61,18,36,5,8,16,65,97,1,0,62,97,39,62,19,35,2,7,15,58,97
2014-07-21 00:00:00.000,Atlanta GA; USA ATP World Tour 250,HARD,2,John Isner,N/A Bye,John Isner,,R32,0,0,0,0,0,0,0,0,0,0,0,0,0,0,0,0,0,0,0,0,0,0,0,0,0,0,0
2014-07-21 00:00:00.000,Atlanta GA; USA ATP World Tour 250,HARD,2,Robby Ginepri,Sergiy Stakhovsky,Robby Ginepri,7-6(3); 3-6; 6-0,R32,101,5,4,55,86,40,55,16,31,8,11,13,56,86,11,11,59,94,43,59,8,35,3,8,14,51,94
2014-07-21 00:00:00.000,Atlanta GA; USA ATP World Tour 250,HARD,2,Tim Smyczek,Ryan Harrison,Tim Smyczek,6-0; 6-2,R32,53,3,1,36,44,27,36,5,8,2,2,7,32,44,7,4,25,44,11,25,6,19,5,10,7,17,44
2014-07-21 00:00:00.000,Atlanta GA; USA ATP World Tour 250,HARD,2,Marinko Matosevic,Victor Estrella Burgos,Marinko Matosevic,6-0; 6-2,R32,43,6,1,21,39,16,21,13,18,0,0,7,29,39,1,4,26,40,11,26,4,14,3,8,7,15,40
2014-07-21 00:00:00.000,Atlanta GA; USA ATP World Tour 250,HARD,2,Michael Venus,N/A Bye,Michael Venus,,R32,0,0,0,0,0,0,0,0,0,0,0,0,0,0,0,0,0,0,0,0,0,0,0,0,0,0,0
2014-07-21 00:00:00.000,Atlanta GA; USA ATP World Tour 250,HARD,2,Jack Sock,Alejandro Gonzalez,Jack Sock,6-2; 6-4,R32,66,9,1,28,51,25,28,15,23,1,1,9,40,51,2,2,29,51,18,29,12,22,3,6,9,30,51
2014-07-21 00:00:00.000,Atlanta GA; USA ATP World Tour 250,HARD,2,Lukas Lacko,Nathan Pasha,Lukas Lacko,6-2; 7-5,R32,70,6,2,25,52,21,25,17,27,0,1,10,38,52,6,10,29,60,21,29,10,31,0,4,10,31,60
2014-07-21 00:00:00.000,Atlanta GA; USA ATP World Tour 250,HARD,2,Denis Istomin,Rajeev Ram,Denis Istomin,6-1; 6-4,R32,69,8,0,29,49,23,29,14,20,0,0,9,37,49,2,3,33,58,21,33,11,25,2,5,8,32,58
2014-07-21 00:00:00.000,Atlanta GA; USA ATP World Tour 250,HARD,2,Sam Querrey,Steve Johnson,Sam Querrey,7-6(3); 7-5,R32,92,20,2,42,68,37,42,16,26,1,1,12,53,68,8,3,45,81,30,45,21,36,1,2,12,51,81
2014-07-21 00:00:00.000,Atlanta GA; USA ATP World Tour 250,HARD,2,Dudi Sela,Donald Young,Dudi Sela,6-3; 6-0,R32,61,0,5,40,54,29,40,6,14,3,3,7,35,54,0,1,27,47,15,27,6,20,3,8,8,21,47
2014-07-21 00:00:00.000,Atlanta GA; USA ATP World Tour 250,HARD,2,Illya Marchenko,John-Patrick Smith,Illya Marchenko,6-4; 6-4,R32,88,7,4,39,68,33,39,12,29,2,3,10,45,68,3,3,33,57,22,33,12,24,2,5,10,34,57
2014-07-21 00:00:00.000,Atlanta GA; USA ATP World Tour 250,HARD,2,Vasek Pospisil,N/A Bye,Vasek Pospisil,,R32,0,0,0,0,0,0,0,0,0,0,0,0,0,0,0,0,0,0,0,0,0,0,0,0,0,0,0
2014-07-21 00:00:00.000,Atlanta GA; USA ATP World Tour 250,HARD,2,Yen-Hsun Lu,Alex Kuznetsov,Yen-Hsun Lu,6-4; 6-4,R32,82,4,6,35,63,28,35,14,28,6,7,10,42,63,3,5,39,59,27,39,7,20,5,8,10,34,59
2014-07-21 00:00:00.000,Atlanta GA; USA ATP World Tour 250,HARD,2,Benjamin Becker,Matthew Ebden,Benjamin Becker,6-4; 6-2,R32,65,4,4,25,44,22,25,11,19,1,2,9,33,44,4,13,36,69,28,36,7,33,9,13,9,35,69
2014-07-21 00:00:00.000,Atlanta GA; USA ATP World Tour 250,HARD,2,Thiemo de Bakker,Steven Diez,Thiemo de Bakker,6-1; 6-2,R32,65,10,1,23,44,19,23,12,21,1,1,7,31,44,1,7,26,54,15,26,9,28,6,11,8,24,54
2014-07-21 00:00:00.000,Atlanta GA; USA ATP World Tour 250,HARD,2,Kevin Anderson,N/A Bye,Kevin Anderson,,R32,0,0,0,0,0,0,0,0,0,0,0,0,0,0,0,0,0,0,0,0,0,0,0,0,0,0,0
2014-07-21 00:00:00.000,Atlanta GA; USA ATP World Tour 250,HARD,2,John Isner,Robby Ginepri,John Isner,4-6; 7-6(5); 7-5,R16,147,30,3,71,109,53,71,23,38,5,6,17,76,109,8,3,72,116,56,72,23,44,9,10,17,79,116
2014-07-21 00:00:00.000,Atlanta GA; USA ATP World Tour 250,HARD,2,Marinko Matosevic,Tim Smyczek,Marinko Matosevic,6-4; 7-5,R16,96,6,5,48,71,33,48,10,23,3,6,11,43,71,2,2,47,78,26,47,14,31,2,7,11,40,78
2014-07-21 00:00:00.000,Atlanta GA; USA ATP World Tour 250,HARD,2,Jack Sock,Michael Venus,Jack Sock,6-4; 6-2,R16,67,2,5,29,55,27,29,12,26,2,2,9,39,55,10,3,27,49,19,27,9,22,2,5,9,28,49
2014-07-21 00:00:00.000,Atlanta GA; USA ATP World Tour 250,HARD,2,Lukas Lacko,Denis Istomin,Lukas Lacko,5-7; 6-1; 6-4,R16,114,5,6,58,108,41,58,23,50,8,12,15,64,108,4,6,44,75,33,44,9,31,1,7,14,42,75
2014-07-21 00:00:00.000,Atlanta GA; USA ATP World Tour 250,HARD,2,Dudi Sela,Sam Querrey,Dudi Sela,6-2; 6-4,R16,62,0,3,23,46,18,23,15,23,1,2,9,33,46,8,5,29,55,25,29,6,26,5,9,9,31,55
2014-07-21 00:00:00.000,Atlanta GA; USA ATP World Tour 250,HARD,2,Vasek Pospisil,Illya Marchenko,Vasek Pospisil,7-5; 6-3,R16,94,10,3,34,69,29,34,21,35,1,1,11,50,69,8,4,40,63,30,40,9,23,2,4,10,39,63
2014-07-21 00:00:00.000,Atlanta GA; USA ATP World Tour 250,HARD,2,Benjamin Becker,Yen-Hsun Lu,Benjamin Becker,6-4; 6-3,R16,79,6,2,30,59,26,30,15,29,2,2,9,41,59,2,6,44,72,28,44,14,28,4,7,10,42,72
2014-07-21 00:00:00.000,Atlanta GA; USA ATP World Tour 250,HARD,2,Thiemo de Bakker,Kevin Anderson,Thiemo de Bakker,6-4; 7-5,R16,109,4,3,35,71,28,35,18,36,3,4,11,46,71,9,5,47,85,31,47,17,38,10,13,11,48,85
2014-07-21 00:00:00.000,Atlanta GA; USA ATP World Tour 250,HARD,2,John Isner,Marinko Matosevic,John Isner,7-6(8); 6-4,Q,101,17,2,39,80,33,39,23,41,2,3,11,56,80,7,6,47,73,37,47,11,26,3,5,11,48,73
2014-07-21 00:00:00.000,Atlanta GA; USA ATP World Tour 250,HARD,2,Jack Sock,Lukas Lacko,Jack Sock,7-6(6); 6-2,Q,81,6,3,39,65,27,39,16,26,2,4,10,43,65,5,2,36,62,24,36,9,26,0,4,10,33,62
2014-07-21 00:00:00.000,Atlanta GA; USA ATP World Tour 250,HARD,2,Dudi Sela,Vasek Pospisil,Dudi Sela,7-5; 1-6; 6-2,Q,103,0,2,36,70,24,36,16,34,2,6,13,40,70,6,5,43,72,29,43,12,29,1,6,14,41,72
2014-07-21 00:00:00.000,Atlanta GA; USA ATP World Tour 250,HARD,2,Benjamin Becker,Thiemo de Bakker,Benjamin Becker,6-4; 6-2,Q,65,6,0,27,51,18,27,20,24,1,1,9,38,51,10,1,32,56,23,32,10,24,4,7,9,33,56
2014-07-21 00:00:00.000,Atlanta GA; USA ATP World Tour 250,HARD,2,John Isner,Jack Sock,John Isner,7-5; 6-4,S,98,8,4,34,64,32,34,15,30,2,2,11,47,64,9,5,46,87,31,46,24,41,6,8,11,55,87
2014-07-21 00:00:00.000,Atlanta GA; USA ATP World Tour 250,HARD,2,Dudi Sela,Benjamin Becker,Dudi Sela,6-3; 3-6; 6-3,S,111,3,4,48,85,35,48,20,37,5,7,14,55,85,7,3,47,81,35,47,14,34,7,10,13,49,81
2014-07-21 00:00:00.000,Atlanta GA; USA ATP World Tour 250,HARD,2,John Isner,Dudi Sela,John Isner,6-3; 6-4,F,71,15,2,33,58,28,33,14,25,1,1,10,42,58,2,4,33,51,26,33,7,18,0,2,9,33,51
2014-07-21 00:00:00.000,Gstaad Switzerland ATP World Tour 250,CLAY,2,Mikhail Youzhny,N/A Bye,Mikhail Youzhny,,R32,0,0,0,0,0,0,0,0,0,0,0,0,0,0,0,0,0,0,0,0,0,0,0,0,0,0,0
2014-07-21 00:00:00.000,Gstaad Switzerland ATP World Tour 250,CLAY,2,Kenny De Schepper,Filippo Volandri,Kenny De Schepper,6-3; 7-6(3),R32,75,7,6,36,65,29,36,19,29,0,0,11,48,65,1,1,54,74,37,54,11,20,4,5,10,48,74
2014-07-21 00:00:00.000,Gstaad Switzerland ATP World Tour 250,CLAY,2,Henri Laaksonen,Gianni Mina,Henri Laaksonen,7-6(5); 7-6(3),R32,125,1,10,65,95,45,65,11,30,6,9,12,56,95,1,2,53,86,32,53,17,33,3,6,12,49,86
2014-07-21 00:00:00.000,Gstaad Switzerland ATP World Tour 250,CLAY,2,Robin Haase,Aleksandr Nedovyesov,Robin Haase,6-4; 6-7(3); 6-3,R32,111,3,5,53,96,41,53,29,43,3,4,16,70,96,7,0,62,85,44,62,16,23,3,6,15,60,85
2014-07-21 00:00:00.000,Gstaad Switzerland ATP World Tour 250,CLAY,2,Guillermo Garcia-Lopez,N/A Bye,Guillermo Garcia-Lopez,,R32,0,0,0,0,0,0,0,0,0,0,0,0,0,0,0,0,0,0,0,0,0,0,0,0,0,0,0
2014-07-21 00:00:00.000,Gstaad Switzerland ATP World Tour 250,CLAY,2,Juan Monaco,Victor Hanescu,Juan Monaco,6-4; 7-5,R32,84,0,2,41,63,28,41,14,22,2,4,11,42,63,2,1,50,73,35,50,6,23,5,9,11,41,73
2014-07-21 00:00:00.000,Gstaad Switzerland ATP World Tour 250,CLAY,2,Thomaz Bellucci,Gerald Melzer,Thomaz Bellucci,6-3; 6-4,R32,74,4,2,36,60,31,36,13,24,3,3,10,44,60,2,2,29,48,20,29,12,19,1,3,9,32,48
2014-07-21 00:00:00.000,Gstaad Switzerland ATP World Tour 250,CLAY,2,Federico Delbonis,Dustin Brown,Federico Delbonis,6-3; 6-3,R32,54,5,3,32,46,28,32,5,14,0,1,9,33,46,3,4,34,56,23,34,6,22,1,5,9,29,56
2014-07-21 00:00:00.000,Gstaad Switzerland ATP World Tour 250,CLAY,2,Viktor Troicki,Dominic Thiem,Viktor Troicki,7-6(4); 6-4,R32,95,8,1,34,73,25,34,21,39,5,8,11,46,73,6,3,41,79,29,41,16,38,6,10,11,45,79
2014-07-21 00:00:00.000,Gstaad Switzerland ATP World Tour 250,CLAY,2,Andrey Golubev,Inigo Cervantes,Andrey Golubev,3-6; 6-3; 7-6(4),R32,123,3,2,75,112,52,75,20,37,10,12,15,72,112,8,6,47,90,36,47,25,43,6,8,15,61,90
2014-07-21 00:00:00.000,Gstaad Switzerland ATP World Tour 250,CLAY,2,Jan-Lennard Struff,Andreas Haider-Maurer,Jan-Lennard Struff,6-2; 1-0 RET,R32,42,0,0,14,21,12,14,6,7,0,0,4,18,21,2,4,28,51,16,28,7,23,4,7,5,23,51
2014-07-21 00:00:00.000,Gstaad Switzerland ATP World Tour 250,CLAY,2,Fernando Verdasco,N/A Bye,Fernando Verdasco,,R32,0,0,0,0,0,0,0,0,0,0,0,0,0,0,0,0,0,0,0,0,0,0,0,0,0,0,0
2014-07-21 00:00:00.000,Gstaad Switzerland ATP World Tour 250,CLAY,2,Pablo Andujar,Gilles Simon,Pablo Andujar,6-2; 3-2 RET,R32,63,4,1,30,44,16,30,9,14,4,6,6,25,44,0,2,25,48,11,25,9,23,3,8,7,20,48
2014-07-21 00:00:00.000,Gstaad Switzerland ATP World Tour 250,CLAY,2,Blaz Rola,Fabiano De Paula,Blaz Rola,6-4; 6-4,R32,70,2,2,32,48,24,32,11,16,1,3,10,35,48,3,2,51,68,28,51,8,17,4,8,10,36,68
2014-07-21 00:00:00.000,Gstaad Switzerland ATP World Tour 250,CLAY,2,Yann Marti,Daniel Gimeno-Traver,Yann Marti,5-7; 7-6(7); 7-6(5),R32,179,2,5,102,157,57,102,33,55,23,29,18,90,157,8,4,56,117,43,56,28,61,4,9,18,71,117
2014-07-21 00:00:00.000,Gstaad Switzerland ATP World Tour 250,CLAY,2,Marcel Granollers,N/A Bye,Marcel Granollers,,R32,0,0,0,0,0,0,0,0,0,0,0,0,0,0,0,0,0,0,0,0,0,0,0,0,0,0,0
2014-07-21 00:00:00.000,Gstaad Switzerland ATP World Tour 250,CLAY,2,Mikhail Youzhny,Kenny De Schepper,Mikhail Youzhny,6-3; 6-4,R16,70,1,4,36,56,29,36,13,20,0,0,10,42,56,7,6,39,62,30,39,7,23,5,7,9,37,62
2014-07-21 00:00:00.000,Gstaad Switzerland ATP World Tour 250,CLAY,2,Robin Haase,Henri Laaksonen,Robin Haase,6-4; 1-6; 7-5,R16,138,1,4,60,101,33,60,22,41,4,9,14,55,101,3,9,72,103,48,72,10,31,10,15,15,58,103
2014-07-21 00:00:00.000,Gstaad Switzerland ATP World Tour 250,CLAY,2,Juan Monaco,Guillermo Garcia-Lopez,Juan Monaco,6-2; 2-6; 6-4,R16,127,4,1,73,102,46,73,13,29,8,12,13,59,102,2,8,39,90,25,39,23,51,6,11,13,48,90
2014-07-21 00:00:00.000,Gstaad Switzerland ATP World Tour 250,CLAY,2,Thomaz Bellucci,Federico Delbonis,Thomaz Bellucci,6-4; 6-4,R16,84,2,4,28,62,23,28,21,34,3,3,10,44,62,1,4,45,68,27,45,14,23,2,4,10,41,68
2014-07-21 00:00:00.000,Gstaad Switzerland ATP World Tour 250,CLAY,2,Viktor Troicki,Andrey Golubev,Viktor Troicki,6-3; 6-4,R16,67,7,2,40,64,30,40,13,24,6,7,10,43,64,2,3,33,52,21,33,7,19,5,8,9,28,52
2014-07-21 00:00:00.000,Gstaad Switzerland ATP World Tour 250,CLAY,2,Fernando Verdasco,Jan-Lennard Struff,Fernando Verdasco,3-6; 6-3; 7-6(3),R16,130,7,2,45,87,36,45,29,42,3,4,15,65,87,10,1,58,109,46,58,28,51,8,9,15,74,109
2014-07-21 00:00:00.000,Gstaad Switzerland ATP World Tour 250,CLAY,2,Pablo Andujar,Blaz Rola,Pablo Andujar,6-3; 6-3,R16,76,1,4,37,61,29,37,13,24,3,3,9,42,61,2,1,30,54,15,30,15,24,4,7,9,30,54
2014-07-21 00:00:00.000,Gstaad Switzerland ATP World Tour 250,CLAY,2,Marcel Granollers,Yann Marti,Marcel Granollers,6-1; 6-4,R16,74,7,2,31,54,23,31,12,23,0,2,9,35,54,0,3,21,53,11,21,13,32,3,8,8,24,53
2014-07-21 00:00:00.000,Gstaad Switzerland ATP World Tour 250,CLAY,2,Robin Haase,Mikhail Youzhny,Robin Haase,3-6; 6-1; 6-4,Q,117,7,4,48,95,35,48,22,47,6,9,13,57,95,1,3,61,98,33,61,20,37,6,11,13,53,98
2014-07-21 00:00:00.000,Gstaad Switzerland ATP World Tour 250,CLAY,2,Juan Monaco,Thomaz Bellucci,Juan Monaco,7-6(1); 6-1,Q,91,1,0,42,61,32,42,11,19,1,2,9,43,61,5,5,33,69,25,33,13,36,4,8,10,38,69
2014-07-21 00:00:00.000,Gstaad Switzerland ATP World Tour 250,CLAY,2,Fernando Verdasco,Viktor Troicki,Fernando Verdasco,6-4; 6-7(7); 6-1,Q,125,1,4,52,92,37,52,27,40,3,4,15,64,92,8,2,61,108,46,61,18,47,8,12,14,64,108
2014-07-21 00:00:00.000,Gstaad Switzerland ATP World Tour 250,CLAY,2,Pablo Andujar,Marcel Granollers,Pablo Andujar,7-5; 6-3,Q,76,0,0,41,53,30,41,10,12,0,2,11,40,53,1,2,21,52,12,21,16,31,3,7,10,28,52
2014-07-21 00:00:00.000,Gstaad Switzerland ATP World Tour 250,CLAY,2,Juan Monaco,Robin Haase,Juan Monaco,6-3; 7-6(4),S,104,0,1,55,68,36,55,7,13,3,5,10,43,68,2,2,55,89,33,55,17,34,6,10,11,50,89
2014-07-21 00:00:00.000,Gstaad Switzerland ATP World Tour 250,CLAY,2,Pablo Andujar,Fernando Verdasco,Pablo Andujar,6-3; 6-7(2); 6-1,S,135,0,2,67,98,43,67,15,31,8,10,13,58,98,7,7,64,102,38,64,14,38,5,12,15,52,102
2014-07-21 00:00:00.000,Gstaad Switzerland ATP World Tour 250,CLAY,2,Pablo Andujar,Juan Monaco,Pablo Andujar,6-3; 7-5,F,92,1,2,42,72,29,42,17,30,3,5,11,46,72,1,2,40,60,24,40,11,20,2,6,10,35,60
2014-07-21 00:00:00.000,Umag Croatia ATP World Tour 250,CLAY,2,Fabio Fognini,N/A Bye,Fabio Fognini,,R32,0,0,0,0,0,0,0,0,0,0,0,0,0,0,0,0,0,0,0,0,0,0,0,0,0,0,0
2014-07-21 00:00:00.000,Umag Croatia ATP World Tour 250,CLAY,2,Albert Montanes,Alexander Zverev,Albert Montanes,6-4; 6-4,R32,86,1,5,37,63,29,37,11,26,5,7,10,40,63,7,4,34,57,21,34,10,23,2,6,10,31,57
2014-07-21 00:00:00.000,Umag Croatia ATP World Tour 250,CLAY,2,Horacio Zeballos,Ante Pavic,Horacio Zeballos,6-4; 6-7(2); 6-1,R32,108,2,0,50,80,37,50,25,30,0,0,15,62,80,18,5,56,83,45,56,9,27,4,7,14,54,83
2014-07-21 00:00:00.000,Umag Croatia ATP World Tour 250,CLAY,2,Borna Coric,Edouard Roger-Vasselin,Borna Coric,6-2; 6-4,R32,98,8,1,48,65,34,48,10,17,5,5,9,44,65,4,0,50,78,30,50,13,28,8,11,9,43,78
2014-07-21 00:00:00.000,Umag Croatia ATP World Tour 250,CLAY,2,Joao Sousa,N/A Bye,Joao Sousa,,R32,0,0,0,0,0,0,0,0,0,0,0,0,0,0,0,0,0,0,0,0,0,0,0,0,0,0,0
2014-07-21 00:00:00.000,Umag Croatia ATP World Tour 250,CLAY,2,Teymuraz Gabashvili,Dusan Lajovic,Teymuraz Gabashvili,6-4; 6-3,R32,83,2,0,38,55,28,38,12,17,4,4,9,40,55,1,1,38,62,22,38,14,24,4,7,10,36,62
2014-07-21 00:00:00.000,Umag Croatia ATP World Tour 250,CLAY,2,Pablo Cuevas,Mate Delic,Pablo Cuevas,4-6; 6-4; 6-4,R32,124,8,6,54,82,39,54,11,28,1,5,15,50,82,7,1,61,105,43,61,18,44,10,15,15,61,105
2014-07-21 00:00:00.000,Umag Croatia ATP World Tour 250,CLAY,2,Andreas Seppi,Marco Cecchinato,Andreas Seppi,6-2; 6-7(2); 6-1,R32,114,6,3,46,90,35,46,28,44,1,1,14,63,90,4,3,39,82,27,39,22,43,2,6,13,49,82
2014-07-21 00:00:00.000,Umag Croatia ATP World Tour 250,CLAY,2,Lukas Rosol,Diego Schwartzman,Lukas Rosol,6-3; 3-6; 7-6(2),R32,123,9,1,53,96,41,53,19,43,2,6,15,60,96,1,0,69,112,39,69,24,43,3,7,15,63,112
2014-07-21 00:00:00.000,Umag Croatia ATP World Tour 250,CLAY,2,Pere Riba,Jiri Vesely,Pere Riba,6-7(7); 6-3; 6-3,R32,126,10,1,52,98,34,52,29,46,5,8,15,63,98,3,6,54,87,34,54,17,33,2,8,15,51,87
2014-07-21 00:00:00.000,Umag Croatia ATP World Tour 250,CLAY,2,Igor Sijsling,Julian Reister,Igor Sijsling,7-6(2); 6-7(3); 6-2,R32,122,7,4,53,95,40,53,24,42,2,5,16,64,95,1,4,88,104,52,88,8,16,6,11,16,60,104
2014-07-21 00:00:00.000,Umag Croatia ATP World Tour 250,CLAY,2,Marin Cilic,N/A Bye,Marin Cilic,,R32,0,0,0,0,0,0,0,0,0,0,0,0,0,0,0,0,0,0,0,0,0,0,0,0,0,0,0
2014-07-21 00:00:00.000,Umag Croatia ATP World Tour 250,CLAY,2,Carlos Berlocq,Andrej Martin,Carlos Berlocq,7-6(4); 6-3,R32,97,0,0,50,83,33,50,18,33,5,7,11,51,83,1,2,41,64,25,41,12,23,3,6,10,37,64
2014-07-21 00:00:00.000,Umag Croatia ATP World Tour 250,CLAY,2,Pablo Carreno Busta,Paolo Lorenzi,Pablo Carreno Busta,4-6; 6-1; 7-5,R32,135,1,0,48,81,33,48,21,33,6,10,15,54,81,4,4,42,88,33,42,15,46,7,13,14,48,88
2014-07-21 00:00:00.000,Umag Croatia ATP World Tour 250,CLAY,2,Albert Ramos-Vinolas,Benoit Paire,Albert Ramos-Vinolas,7-5; 6-3,R32,97,2,0,55,82,36,55,14,27,4,6,11,50,82,7,6,34,63,24,34,10,29,3,7,10,34,63
2014-07-21 00:00:00.000,Umag Croatia ATP World Tour 250,CLAY,2,Tommy Robredo,N/A Bye,Tommy Robredo,,R32,0,0,0,0,0,0,0,0,0,0,0,0,0,0,0,0,0,0,0,0,0,0,0,0,0,0,0
2014-07-21 00:00:00.000,Umag Croatia ATP World Tour 250,CLAY,2,Fabio Fognini,Albert Montanes,Fabio Fognini,7-6(2); 6-0,R16,70,7,2,28,53,24,28,16,25,0,1,9,40,53,2,5,32,55,17,32,10,23,1,5,9,27,55
2014-07-21 00:00:00.000,Umag Croatia ATP World Tour 250,CLAY,2,Borna Coric,Horacio Zeballos,Borna Coric,7-6(4); 6-3,R16,101,9,1,41,73,32,41,22,32,3,3,11,54,73,3,2,45,67,34,45,11,22,4,5,10,45,67
2014-07-21 00:00:00.000,Umag Croatia ATP World Tour 250,CLAY,2,Teymuraz Gabashvili,Joao Sousa,Teymuraz Gabashvili,3-6; 6-4; 6-2,R16,118,5,2,54,79,35,54,13,25,6,10,13,48,79,5,2,54,82,31,54,12,28,2,8,14,43,82
2014-07-21 00:00:00.000,Umag Croatia ATP World Tour 250,CLAY,2,Pablo Cuevas,Andreas Seppi,Pablo Cuevas,6-3; 6-1,R16,63,2,0,29,48,23,29,12,19,3,3,8,35,48,0,3,30,46,16,30,7,16,4,8,8,23,46
2014-07-21 00:00:00.000,Umag Croatia ATP World Tour 250,CLAY,2,Lukas Rosol,Pere Riba,Lukas Rosol,7-6(4); 6-1,R16,74,9,2,36,64,33,36,12,28,2,3,10,45,64,2,1,32,56,20,32,11,24,1,4,9,31,56
2014-07-21 00:00:00.000,Umag Croatia ATP World Tour 250,CLAY,2,Marin Cilic,Igor Sijsling,Marin Cilic,7-5; 6-3,R16,68,11,1,28,51,26,28,16,23,0,1,11,42,51,2,2,35,60,24,35,12,25,1,4,10,36,60
2014-07-21 00:00:00.000,Umag Croatia ATP World Tour 250,CLAY,2,Pablo Carreno Busta,Carlos Berlocq,Pablo Carreno Busta,W/O,R16,0,0,0,0,0,0,0,0,0,0,0,0,0,0,0,0,0,0,0,0,0,0,0,0,0,0,0
2014-07-21 00:00:00.000,Umag Croatia ATP World Tour 250,CLAY,2,Tommy Robredo,Albert Ramos-Vinolas,Tommy Robredo,6-4; 6-4,R16,95,2,2,31,50,28,31,12,19,0,0,10,40,50,0,0,56,77,34,56,11,21,9,11,10,45,77
2014-07-21 00:00:00.000,Umag Croatia ATP World Tour 250,CLAY,2,Fabio Fognini,Borna Coric,Fabio Fognini,5-7; 7-6(4); 6-3,Q,162,2,6,49,98,38,49,23,49,4,9,16,61,98,3,6,70,110,46,70,22,40,7,13,17,68,110
2014-07-21 00:00:00.000,Umag Croatia ATP World Tour 250,CLAY,2,Pablo Cuevas,Teymuraz Gabashvili,Pablo Cuevas,6-3; 4-6; 6-2,Q,128,12,4,55,89,38,55,18,34,4,7,14,56,89,1,1,56,92,34,56,17,36,8,13,13,51,92
2014-07-21 00:00:00.000,Umag Croatia ATP World Tour 250,CLAY,2,Marin Cilic,Lukas Rosol,Marin Cilic,6-0; 6-2,Q,62,10,1,23,40,18,23,12,17,1,1,7,30,40,2,3,36,62,15,36,13,26,9,14,7,28,62
2014-07-21 00:00:00.000,Umag Croatia ATP World Tour 250,CLAY,2,Tommy Robredo,Pablo Carreno Busta,Tommy Robredo,6-1; 6-4,Q,78,1,3,28,55,19,28,15,27,4,6,8,34,55,0,1,39,63,20,39,7,24,5,11,9,27,63
2014-07-21 00:00:00.000,Umag Croatia ATP World Tour 250,CLAY,2,Pablo Cuevas,Fabio Fognini,Pablo Cuevas,6-3; 6-4,S,64,3,1,36,54,24,36,12,18,0,2,10,36,54,0,5,32,49,21,32,3,17,3,7,9,24,49
2014-07-21 00:00:00.000,Umag Croatia ATP World Tour 250,CLAY,2,Tommy Robredo,Marin Cilic,Tommy Robredo,7-6(10); 6-3,S,104,2,2,38,72,32,38,18,34,2,3,11,50,72,5,4,36,68,28,36,13,32,2,4,10,41,68
2014-07-21 00:00:00.000,Umag Croatia ATP World Tour 250,CLAY,2,Pablo Cuevas,Tommy Robredo,Pablo Cuevas,6-3; 6-4,F,90,2,1,49,63,33,49,8,14,4,5,10,41,63,3,1,44,65,29,44,8,21,6,9,9,37,65
2014-07-27 00:00:00.000,Kitzbühel Austria ATP World Tour 250,CLAY,2,Philipp Kohlschreiber,N/A Bye,Philipp Kohlschreiber,,R32,0,0,0,0,0,0,0,0,0,0,0,0,0,0,0,0,0,0,0,0,0,0,0,0,0,0,0
2014-07-27 00:00:00.000,Kitzbühel Austria ATP World Tour 250,CLAY,2,David Goffin,Kenny De Schepper,David Goffin,6-2; 6-4,R32,64,5,2,29,48,25,29,12,19,3,3,9,37,48,10,5,36,61,25,36,8,25,2,5,9,33,61
2014-07-27 00:00:00.000,Kitzbühel Austria ATP World Tour 250,CLAY,2,Pablo Andujar,Jurgen Melzer,Pablo Andujar,6-3; 6-4,R32,80,1,1,36,59,30,36,15,23,3,3,10,45,59,1,3,34,57,25,34,10,23,2,4,9,35,57
2014-07-27 00:00:00.000,Kitzbühel Austria ATP World Tour 250,CLAY,2,Paolo Lorenzi,Robin Haase,Paolo Lorenzi,6-2; 6-3,R32,70,4,1,33,53,26,33,12,20,2,2,8,38,53,0,0,32,53,18,32,10,21,3,7,9,28,53
2014-07-27 00:00:00.000,Kitzbühel Austria ATP World Tour 250,CLAY,2,Lukas Rosol,N/A Bye,Lukas Rosol,,R32,0,0,0,0,0,0,0,0,0,0,0,0,0,0,0,0,0,0,0,0,0,0,0,0,0,0,0
2014-07-27 00:00:00.000,Kitzbühel Austria ATP World Tour 250,CLAY,2,Andreas Haider-Maurer,Gerald Melzer,Andreas Haider-Maurer,6-2; 7-6(1),R32,112,7,5,40,79,29,40,17,39,8,11,10,46,79,3,6,52,88,29,52,13,36,7,12,10,42,88
2014-07-27 00:00:00.000,Kitzbühel Austria ATP World Tour 250,CLAY,2,Albert Ramos-Vinolas,Viktor Galovic,Albert Ramos-Vinolas,6-7(5); 7-5; 6-2,R32,150,2,6,60,98,42,60,21,38,2,5,16,63,98,7,4,62,102,37,62,19,40,0,6,16,56,102
2014-07-27 00:00:00.000,Kitzbühel Austria ATP World Tour 250,CLAY,2,Maximo Gonzalez,Pablo Carreno Busta,Maximo Gonzalez,6-3; 4-6; 7-5,R32,150,6,1,61,99,36,61,20,38,9,14,16,56,99,2,3,51,96,32,51,21,45,8,14,15,53,96
2014-07-27 00:00:00.000,Kitzbühel Austria ATP World Tour 250,CLAY,2,Jarkko Nieminen,Teymuraz Gabashvili,Jarkko Nieminen,6-4; 6-4,R32,81,1,2,44,61,32,44,7,17,3,5,10,39,61,5,5,39,66,28,39,8,27,3,7,10,36,66
2014-07-27 00:00:00.000,Kitzbühel Austria ATP World Tour 250,CLAY,2,Juan Monaco,Andrey Golubev,Juan Monaco,0-6; 6-2; 6-1,R32,92,0,0,45,71,26,45,15,26,6,9,11,41,71,3,5,45,73,27,45,12,28,5,9,10,39,73
2014-07-27 00:00:00.000,Kitzbühel Austria ATP World Tour 250,CLAY,2,Pere Riba,Dustin Brown,Pere Riba,7-6(6); 7-5,R32,84,6,3,38,76,29,38,25,38,2,3,12,54,76,14,6,43,71,36,43,11,28,3,5,12,47,71
2014-07-27 00:00:00.000,Kitzbühel Austria ATP World Tour 250,CLAY,2,Andreas Seppi,N/A Bye,Andreas Seppi,,R32,0,0,0,0,0,0,0,0,0,0,0,0,0,0,0,0,0,0,0,0,0,0,0,0,0,0,0
2014-07-27 00:00:00.000,Kitzbühel Austria ATP World Tour 250,CLAY,2,Dominic Thiem,Joao Souza,Dominic Thiem,7-6(4); 3-6; 7-5,R32,161,5,9,64,116,40,64,25,52,7,12,16,65,116,3,2,57,94,40,57,21,37,6,11,17,61,94
2014-07-27 00:00:00.000,Kitzbühel Austria ATP World Tour 250,CLAY,2,Jiri Vesely,Jan-Lennard Struff,Jiri Vesely,6-4; 6-4,R32,78,9,3,28,52,26,28,16,24,1,1,10,42,52,0,3,39,69,26,39,15,30,4,6,10,41,69
2014-07-27 00:00:00.000,Kitzbühel Austria ATP World Tour 250,CLAY,2,Diego Schwartzman,Alexander Zverev,Diego Schwartzman,6-1; 6-0,R32,57,1,1,25,40,15,25,10,15,3,4,6,25,40,2,3,21,47,4,21,12,26,5,12,7,16,47
2014-07-27 00:00:00.000,Kitzbühel Austria ATP World Tour 250,CLAY,2,Marcel Granollers,N/A Bye,Marcel Granollers,,R32,0,0,0,0,0,0,0,0,0,0,0,0,0,0,0,0,0,0,0,0,0,0,0,0,0,0,0
2014-07-27 00:00:00.000,Kitzbühel Austria ATP World Tour 250,CLAY,2,David Goffin,Philipp Kohlschreiber,David Goffin,6-3; 7-5,R16,84,3,7,30,74,24,30,23,44,6,7,11,47,74,7,1,31,58,24,31,10,27,0,3,10,34,58
2014-07-27 00:00:00.000,Kitzbühel Austria ATP World Tour 250,CLAY,2,Paolo Lorenzi,Pablo Andujar,Paolo Lorenzi,6-2; 6-0,R16,67,1,1,23,49,18,23,15,26,5,5,7,33,49,0,2,27,50,11,27,11,23,3,8,7,22,50
2014-07-27 00:00:00.000,Kitzbühel Austria ATP World Tour 250,CLAY,2,Lukas Rosol,Andreas Haider-Maurer,Lukas Rosol,6-3; 7-6(4),R16,98,9,4,40,75,30,40,20,35,4,5,10,50,75,1,3,51,96,34,51,20,45,8,11,11,54,96
2014-07-27 00:00:00.000,Kitzbühel Austria ATP World Tour 250,CLAY,2,Maximo Gonzalez,Albert Ramos-Vinolas,Maximo Gonzalez,6-4; 6-4,R16,98,1,0,41,59,26,41,10,18,4,7,10,36,59,0,1,44,64,25,44,6,20,4,9,10,31,64
2014-07-27 00:00:00.000,Kitzbühel Austria ATP World Tour 250,CLAY,2,Juan Monaco,Jarkko Nieminen,Juan Monaco,6-3; 6-4,R16,69,4,1,36,46,25,36,7,10,0,2,9,32,46,1,3,32,60,20,32,11,28,2,7,10,31,60
2014-07-27 00:00:00.000,Kitzbühel Austria ATP World Tour 250,CLAY,2,Andreas Seppi,Pere Riba,Andreas Seppi,W/O,R16,0,0,0,0,0,0,0,0,0,0,0,0,0,0,0,0,0,0,0,0,0,0,0,0,0,0,0
2014-07-27 00:00:00.000,Kitzbühel Austria ATP World Tour 250,CLAY,2,Dominic Thiem,Jiri Vesely,Dominic Thiem,6-3; 7-6(3),R16,95,2,2,40,73,30,40,16,33,3,5,11,46,73,4,4,39,65,24,39,12,26,5,8,10,36,65
2014-07-27 00:00:00.000,Kitzbühel Austria ATP World Tour 250,CLAY,2,Marcel Granollers,Diego Schwartzman,Marcel Granollers,6-3; 6-4,R16,80,3,1,35,58,21,35,12,23,1,4,10,33,58,0,2,33,52,16,33,7,19,0,5,9,23,52
2014-07-27 00:00:00.000,Kitzbühel Austria ATP World Tour 250,CLAY,2,David Goffin,Paolo Lorenzi,David Goffin,6-2; 6-1,Q,67,4,1,23,47,17,23,14,24,1,2,8,31,47,1,3,36,47,17,36,3,11,0,5,7,20,47
2014-07-27 00:00:00.000,Kitzbühel Austria ATP World Tour 250,CLAY,2,Maximo Gonzalez,Lukas Rosol,Maximo Gonzalez,6-3; 4-6; 6-3,Q,100,1,2,54,84,42,54,14,30,5,7,14,56,84,7,2,38,77,29,38,17,39,0,4,14,46,77
2014-07-27 00:00:00.000,Kitzbühel Austria ATP World Tour 250,CLAY,2,Juan Monaco,Andreas Seppi,Juan Monaco,6-2; 3-6; 6-3,Q,108,1,2,47,76,30,47,22,29,2,4,13,52,76,2,4,41,85,30,41,19,44,4,8,13,49,85
2014-07-27 00:00:00.000,Kitzbühel Austria ATP World Tour 250,CLAY,2,Dominic Thiem,Marcel Granollers,Dominic Thiem,6-4; 7-5,Q,107,3,1,30,59,23,30,16,29,0,3,11,39,59,2,6,38,72,25,38,11,34,3,8,11,36,72
2014-07-27 00:00:00.000,Kitzbühel Austria ATP World Tour 250,CLAY,2,David Goffin,Maximo Gonzalez,David Goffin,5-7; 6-4; 6-3,S,143,8,1,48,91,36,48,19,43,3,7,15,55,91,2,5,72,117,43,72,22,45,13,19,16,65,117
2014-07-27 00:00:00.000,Kitzbühel Austria ATP World Tour 250,CLAY,2,Dominic Thiem,Juan Monaco,Dominic Thiem,6-3; 6-1,S,59,6,0,28,42,23,28,7,14,0,1,8,30,42,0,1,31,49,14,31,8,18,2,7,8,22,49
2014-07-27 00:00:00.000,Kitzbühel Austria ATP World Tour 250,CLAY,2,David Goffin,Dominic Thiem,David Goffin,4-6; 6-1; 6-3,F,119,1,0,52,83,37,52,19,31,5,6,13,56,83,6,4,45,87,31,45,20,42,8,12,13,51,87
2014-07-28 00:00:00.000,Washington DC; USA ATP World Tour 500,HARD,2,Tomas Berdych,N/A Bye,Tomas Berdych,,R64,0,0,0,0,0,0,0,0,0,0,0,0,0,0,0,0,0,0,0,0,0,0,0,0,0,0,0
2014-07-28 00:00:00.000,Washington DC; USA ATP World Tour 500,HARD,2,Robby Ginepri,Alejandro Falla,Robby Ginepri,6-4; 6-2,R64,72,2,0,35,51,27,35,11,16,4,4,9,38,51,8,6,39,73,25,39,15,34,5,8,9,40,73
2014-07-28 00:00:00.000,Washington DC; USA ATP World Tour 500,HARD,2,Rajeev Ram,Jared Donaldson,Rajeev Ram,6-7(1); 6-4; 7-5,R64,127,6,4,53,90,42,53,29,37,2,2,17,71,90,12,2,48,93,37,48,32,45,0,2,17,69,93
2014-07-28 00:00:00.000,Washington DC; USA ATP World Tour 500,HARD,2,Vasek Pospisil,N/A Bye,Vasek Pospisil,,R64,0,0,0,0,0,0,0,0,0,0,0,0,0,0,0,0,0,0,0,0,0,0,0,0,0,0,0
2014-07-28 00:00:00.000,Washington DC; USA ATP World Tour 500,HARD,2,Santiago Giraldo,N/A Bye,Santiago Giraldo,,R64,0,0,0,0,0,0,0,0,0,0,0,0,0,0,0,0,0,0,0,0,0,0,0,0,0,0,0
2014-07-28 00:00:00.000,Washington DC; USA ATP World Tour 500,HARD,2,Benjamin Becker,Blaz Kavcic,Benjamin Becker,6-3; 7-6(7),R64,82,6,5,43,71,36,43,11,28,1,3,11,47,71,8,2,42,65,29,42,11,23,3,6,10,40,65
2014-07-28 00:00:00.000,Washington DC; USA ATP World Tour 500,HARD,2,Victor Estrella Burgos,Tobias Kamke,Victor Estrella Burgos,6-2; 4-6; 7-6(4),R64,140,6,4,51,95,39,51,22,44,3,7,15,61,95,2,7,79,128,49,79,21,49,8,13,15,70,128
2014-07-28 00:00:00.000,Washington DC; USA ATP World Tour 500,HARD,2,Feliciano Lopez,N/A Bye,Feliciano Lopez,,R64,0,0,0,0,0,0,0,0,0,0,0,0,0,0,0,0,0,0,0,0,0,0,0,0,0,0,0
2014-07-28 00:00:00.000,Washington DC; USA ATP World Tour 500,HARD,2,Kei Nishikori,N/A Bye,Kei Nishikori,,R64,0,0,0,0,0,0,0,0,0,0,0,0,0,0,0,0,0,0,0,0,0,0,0,0,0,0,0
2014-07-28 00:00:00.000,Washington DC; USA ATP World Tour 500,HARD,2,Sam Querrey,Michael Russell,Sam Querrey,6-4; 6-3,R64,71,17,2,30,50,28,30,11,20,1,2,10,39,50,3,1,51,74,32,51,9,23,8,11,9,41,74
2014-07-28 00:00:00.000,Washington DC; USA ATP World Tour 500,HARD,2,Lukas Lacko,Filip Peliwo,Lukas Lacko,7-5; 6-3,R64,71,2,2,34,58,24,34,16,24,3,5,11,40,58,5,4,36,61,26,36,9,25,6,10,10,35,61
2014-07-28 00:00:00.000,Washington DC; USA ATP World Tour 500,HARD,2,Yen-Hsun Lu,N/A Bye,Yen-Hsun Lu,,R64,0,0,0,0,0,0,0,0,0,0,0,0,0,0,0,0,0,0,0,0,0,0,0,0,0,0,0
2014-07-28 00:00:00.000,Washington DC; USA ATP World Tour 500,HARD,2,Jeremy Chardy,N/A Bye,Jeremy Chardy,,R64,0,0,0,0,0,0,0,0,0,0,0,0,0,0,0,0,0,0,0,0,0,0,0,0,0,0,0
2014-07-28 00:00:00.000,Washington DC; USA ATP World Tour 500,HARD,2,Tim Smyczek,Alex Kuznetsov,Tim Smyczek,6-3; 6-0,R64,57,3,2,30,47,25,30,9,17,1,1,8,34,47,3,1,29,43,18,29,2,14,1,5,7,20,43
2014-07-28 00:00:00.000,Washington DC; USA ATP World Tour 500,HARD,2,Dudi Sela,Sam Groth,Dudi Sela,7-6(3); 3-6; 6-4,R64,121,0,4,74,113,47,74,20,39,12,16,16,67,113,16,5,51,85,42,51,15,34,3,6,15,57,85
2014-07-28 00:00:00.000,Washington DC; USA ATP World Tour 500,HARD,2,Richard Gasquet,N/A Bye,Richard Gasquet,,R64,0,0,0,0,0,0,0,0,0,0,0,0,0,0,0,0,0,0,0,0,0,0,0,0,0,0,0
2014-07-28 00:00:00.000,Washington DC; USA ATP World Tour 500,HARD,2,Kevin Anderson,N/A Bye,Kevin Anderson,,R64,0,0,0,0,0,0,0,0,0,0,0,0,0,0,0,0,0,0,0,0,0,0,0,0,0,0,0
2014-07-28 00:00:00.000,Washington DC; USA ATP World Tour 500,HARD,2,Evgeny Donskoy,Francis Tiafoe,Evgeny Donskoy,6-4; 6-4,R64,78,5,2,36,56,31,36,9,20,2,3,10,40,56,2,6,39,71,29,39,13,32,9,12,10,42,71
2014-07-28 00:00:00.000,Washington DC; USA ATP World Tour 500,HARD,2,Malek Jaziri,Sergiy Stakhovsky,Malek Jaziri,7-6(2); 6-4,R64,89,1,1,33,76,29,33,26,43,4,4,11,55,76,7,9,41,84,36,41,16,43,6,7,11,52,84
2014-07-28 00:00:00.000,Washington DC; USA ATP World Tour 500,HARD,2,Radek Stepanek,N/A Bye,Radek Stepanek,,R64,0,0,0,0,0,0,0,0,0,0,0,0,0,0,0,0,0,0,0,0,0,0,0,0,0,0,0
2014-07-28 00:00:00.000,Washington DC; USA ATP World Tour 500,HARD,2,Denis Istomin,N/A Bye,Denis Istomin,,R64,0,0,0,0,0,0,0,0,0,0,0,0,0,0,0,0,0,0,0,0,0,0,0,0,0,0,0
2014-07-28 00:00:00.000,Washington DC; USA ATP World Tour 500,HARD,2,Bernard Tomic,Alejandro Gonzalez,Bernard Tomic,6-3; 6-2,R64,58,10,3,36,49,31,36,7,13,2,2,9,38,49,1,2,19,46,14,19,10,27,1,4,8,24,46
2014-07-28 00:00:00.000,Washington DC; USA ATP World Tour 500,HARD,2,Donald Young,Yuichi Sugita,Donald Young,6-4; 4-6; 6-4,R64,122,2,4,48,84,32,48,23,36,4,7,15,55,84,8,3,47,99,30,47,27,52,8,12,15,57,99
2014-07-28 00:00:00.000,Washington DC; USA ATP World Tour 500,HARD,2,Julien Benneteau,N/A Bye,Julien Benneteau,,R64,0,0,0,0,0,0,0,0,0,0,0,0,0,0,0,0,0,0,0,0,0,0,0,0,0,0,0
2014-07-28 00:00:00.000,Washington DC; USA ATP World Tour 500,HARD,2,John Isner,N/A Bye,John Isner,,R64,0,0,0,0,0,0,0,0,0,0,0,0,0,0,0,0,0,0,0,0,0,0,0,0,0,0,0
2014-07-28 00:00:00.000,Washington DC; USA ATP World Tour 500,HARD,2,Steve Johnson,James Duckworth,Steve Johnson,6-3; 7-6(4),R64,75,23,4,48,84,40,48,19,36,5,5,11,59,84,8,0,40,62,32,40,11,22,4,5,10,43,62
2014-07-28 00:00:00.000,Washington DC; USA ATP World Tour 500,HARD,2,Benoit Paire,Frank Dancevic,Benoit Paire,6-4; 6-0,R64,39,10,4,23,39,21,23,11,16,0,0,8,32,39,0,2,23,45,13,23,9,22,1,5,8,22,45
2014-07-28 00:00:00.000,Washington DC; USA ATP World Tour 500,HARD,2,Ivo Karlovic,N/A Bye,Ivo Karlovic,,R64,0,0,0,0,0,0,0,0,0,0,0,0,0,0,0,0,0,0,0,0,0,0,0,0,0,0,0
2014-07-28 00:00:00.000,Washington DC; USA ATP World Tour 500,HARD,2,Lleyton Hewitt,N/A Bye,Lleyton Hewitt,,R64,0,0,0,0,0,0,0,0,0,0,0,0,0,0,0,0,0,0,0,0,0,0,0,0,0,0,0
2014-07-28 00:00:00.000,Washington DC; USA ATP World Tour 500,HARD,2,Marinko Matosevic,Illya Marchenko,Marinko Matosevic,6-4; 7-5,R64,94,2,4,38,68,27,38,15,30,3,5,11,42,68,4,6,49,77,29,49,12,28,4,8,11,41,77
2014-07-28 00:00:00.000,Washington DC; USA ATP World Tour 500,HARD,2,Jack Sock,Michael Berrer,Jack Sock,7-6(2); 6-4,R64,75,4,6,33,63,32,33,17,30,0,0,11,49,63,3,3,47,73,34,47,14,26,3,4,11,48,73
2014-07-28 00:00:00.000,Washington DC; USA ATP World Tour 500,HARD,2,Milos Raonic,N/A Bye,Milos Raonic,,R64,0,0,0,0,0,0,0,0,0,0,0,0,0,0,0,0,0,0,0,0,0,0,0,0,0,0,0
2014-07-28 00:00:00.000,Washington DC; USA ATP World Tour 500,HARD,2,Tomas Berdych,Robby Ginepri,Tomas Berdych,6-1; 6-4,R32,69,4,5,25,52,21,25,16,27,1,2,9,37,52,2,4,32,53,21,32,5,21,1,5,8,26,53
2014-07-28 00:00:00.000,Washington DC; USA ATP World Tour 500,HARD,2,Vasek Pospisil,Rajeev Ram,Vasek Pospisil,6-0; 7-6(8),R32,98,3,2,41,65,32,41,17,24,5,5,9,49,65,3,2,55,88,34,55,18,33,9,12,9,52,88
2014-07-28 00:00:00.000,Washington DC; USA ATP World Tour 500,HARD,2,Santiago Giraldo,Benjamin Becker,Santiago Giraldo,6-2; 7-6(3),R32,99,3,0,49,79,33,49,17,30,7,9,10,50,79,7,1,42,74,27,42,13,32,3,7,10,40,74
2014-07-28 00:00:00.000,Washington DC; USA ATP World Tour 500,HARD,2,Victor Estrella Burgos,Feliciano Lopez,Victor Estrella Burgos,7-6(5); 6-4,R32,79,4,2,52,66,45,52,7,14,1,1,11,52,66,12,2,39,68,30,39,19,29,2,3,11,49,68
2014-07-28 00:00:00.000,Washington DC; USA ATP World Tour 500,HARD,2,Kei Nishikori,Sam Querrey,Kei Nishikori,6-4; 5-7; 6-4,R32,112,9,1,47,85,40,47,25,38,1,2,16,65,85,12,3,56,87,46,56,17,31,3,5,16,63,87
2014-07-28 00:00:00.000,Washington DC; USA ATP World Tour 500,HARD,2,Lukas Lacko,Yen-Hsun Lu,Lukas Lacko,6-1; 6-4,R32,52,3,0,28,43,26,28,10,15,0,0,9,36,43,4,3,29,44,18,29,5,15,1,4,8,23,44
2014-07-28 00:00:00.000,Washington DC; USA ATP World Tour 500,HARD,2,Tim Smyczek,Jeremy Chardy,Tim Smyczek,7-6(5); 3-6; 6-4,R32,124,5,6,60,107,43,60,23,47,3,6,15,66,107,9,6,60,105,43,60,22,45,5,8,16,65,105
2014-07-28 00:00:00.000,Washington DC; USA ATP World Tour 500,HARD,2,Richard Gasquet,Dudi Sela,Richard Gasquet,6-3; 6-2,R32,71,3,2,27,52,21,27,17,25,4,5,9,38,52,0,3,34,61,19,34,13,27,6,10,8,32,61
2014-07-28 00:00:00.000,Washington DC; USA ATP World Tour 500,HARD,2,Kevin Anderson,Evgeny Donskoy,Kevin Anderson,6-3; 6-4,R32,80,5,2,33,57,27,33,15,24,1,1,10,42,57,3,1,31,54,23,31,13,23,2,4,9,36,54
2014-07-28 00:00:00.000,Washington DC; USA ATP World Tour 500,HARD,2,Malek Jaziri,Radek Stepanek,Malek Jaziri,2-6; 7-6(3); 6-1,R32,120,6,2,50,102,32,50,30,52,7,10,14,62,102,4,4,46,81,29,46,22,35,4,7,13,51,81
2014-07-28 00:00:00.000,Washington DC; USA ATP World Tour 500,HARD,2,Denis Istomin,Bernard Tomic,Denis Istomin,6-4; 7-6(6),R32,89,4,2,49,71,34,49,12,22,5,7,11,46,71,11,0,47,77,31,47,14,30,5,8,11,45,77
2014-07-28 00:00:00.000,Washington DC; USA ATP World Tour 500,HARD,2,Donald Young,Julien Benneteau,Donald Young,6-4; 6-3,R32,97,1,2,49,77,33,49,12,28,10,12,10,45,77,6,7,28,65,21,28,13,37,8,12,9,34,65
2014-07-28 00:00:00.000,Washington DC; USA ATP World Tour 500,HARD,2,Steve Johnson,John Isner,Steve Johnson,6-7(5); 6-3; 7-6(6),R32,127,11,2,55,99,49,55,30,44,0,0,17,79,99,29,3,66,103,59,66,16,37,1,2,16,75,103
2014-07-28 00:00:00.000,Washington DC; USA ATP World Tour 500,HARD,2,Ivo Karlovic,Benoit Paire,Ivo Karlovic,7-6(5); 6-7(11); 7-6(2),R32,145,24,8,72,112,65,72,23,40,1,2,18,88,112,12,12,76,137,59,76,34,61,3,4,18,93,137
2014-07-28 00:00:00.000,Washington DC; USA ATP World Tour 500,HARD,2,Lleyton Hewitt,Marinko Matosevic,Lleyton Hewitt,6-4; 6-3,R32,82,2,7,31,56,23,31,11,25,5,7,9,34,56,4,1,31,55,17,31,12,24,3,8,10,29,55
2014-07-28 00:00:00.000,Washington DC; USA ATP World Tour 500,HARD,2,Milos Raonic,Jack Sock,Milos Raonic,7-6(3); 7-6(3),R32,103,16,2,44,71,36,44,19,27,2,3,12,55,71,8,2,60,86,44,60,11,26,4,5,12,55,86
2014-07-28 00:00:00.000,Washington DC; USA ATP World Tour 500,HARD,2,Vasek Pospisil,Tomas Berdych,Vasek Pospisil,6-2; 6-4,R16,82,6,2,28,54,23,28,14,26,3,4,9,37,54,4,5,33,59,22,33,10,26,6,10,9,32,59
2014-07-28 00:00:00.000,Washington DC; USA ATP World Tour 500,HARD,2,Santiago Giraldo,Victor Estrella Burgos,Santiago Giraldo,6-2; 6-0,R16,56,3,0,26,40,21,26,9,14,1,1,7,30,40,2,0,28,51,15,28,7,23,6,11,7,22,51
2014-07-28 00:00:00.000,Washington DC; USA ATP World Tour 500,HARD,2,Kei Nishikori,Lukas Lacko,Kei Nishikori,6-2; 2-6; 6-3,R16,89,8,6,39,74,32,39,14,35,3,6,12,46,74,1,8,39,79,25,39,17,40,2,7,13,42,79
2014-07-28 00:00:00.000,Washington DC; USA ATP World Tour 500,HARD,2,Richard Gasquet,Tim Smyczek,Richard Gasquet,6-3; 6-2,R16,61,5,0,22,47,19,22,18,25,0,0,9,37,47,4,1,25,45,17,25,10,20,0,3,8,27,45
2014-07-28 00:00:00.000,Washington DC; USA ATP World Tour 500,HARD,2,Kevin Anderson,Malek Jaziri,Kevin Anderson,6-3; 6-4,R16,63,14,3,37,51,34,37,8,14,1,1,10,42,51,1,2,23,51,16,23,17,28,1,3,9,33,51
2014-07-28 00:00:00.000,Washington DC; USA ATP World Tour 500,HARD,2,Donald Young,Denis Istomin,Donald Young,6-3; 3-6; 6-3,R16,100,5,1,52,85,41,52,19,33,4,5,14,60,85,11,3,63,89,44,63,13,26,8,10,13,57,89
2014-07-28 00:00:00.000,Washington DC; USA ATP World Tour 500,HARD,2,Steve Johnson,Ivo Karlovic,Steve Johnson,3-6; 7-6(4); 7-6(7),R16,120,7,1,60,97,50,60,24,37,1,3,17,74,97,27,3,57,91,51,57,23,34,0,0,16,74,91
2014-07-28 00:00:00.000,Washington DC; USA ATP World Tour 500,HARD,2,Milos Raonic,Lleyton Hewitt,Milos Raonic,7-6(1); 7-6(3),R16,110,27,9,54,87,48,54,15,33,4,4,12,63,87,9,4,39,77,33,39,20,38,1,1,12,53,77
2014-07-28 00:00:00.000,Washington DC; USA ATP World Tour 500,HARD,2,Vasek Pospisil,Santiago Giraldo,Vasek Pospisil,6-7(4); 6-3; 6-4,Q,152,10,6,58,103,47,58,23,45,4,4,15,70,103,3,1,74,110,47,74,24,36,9,12,16,71,110
2014-07-28 00:00:00.000,Washington DC; USA ATP World Tour 500,HARD,2,Richard Gasquet,Kei Nishikori,Richard Gasquet,6-1; 6-4,Q,59,9,1,30,52,25,30,14,22,1,1,9,39,52,2,2,25,40,16,25,8,15,0,3,8,24,40
2014-07-28 00:00:00.000,Washington DC; USA ATP World Tour 500,HARD,2,Donald Young,Kevin Anderson,Donald Young,3-6; 7-6(3); 6-2,Q,124,5,3,73,106,56,73,15,33,3,5,15,71,106,11,4,61,86,48,61,11,25,5,7,14,59,86
2014-07-28 00:00:00.000,Washington DC; USA ATP World Tour 500,HARD,2,Milos Raonic,Steve Johnson,Milos Raonic,7-6(2); 6-2,Q,80,16,2,37,63,32,37,17,26,0,0,10,49,63,13,2,42,58,33,42,6,16,0,2,10,39,58
2014-07-28 00:00:00.000,Washington DC; USA ATP World Tour 500,HARD,2,Vasek Pospisil,Richard Gasquet,Vasek Pospisil,6-7(5); 6-3; 7-5,S,149,10,3,57,108,42,57,32,51,1,2,17,74,108,5,3,66,98,47,66,19,32,6,9,16,66,98
2014-07-28 00:00:00.000,Washington DC; USA ATP World Tour 500,HARD,2,Milos Raonic,Donald Young,Milos Raonic,6-4; 7-5,S,75,15,3,36,56,33,36,11,20,0,0,11,44,56,3,2,38,57,29,38,9,19,1,3,11,38,57
2014-07-28 00:00:00.000,Washington DC; USA ATP World Tour 500,HARD,2,Milos Raonic,Vasek Pospisil,Milos Raonic,6-1; 6-4,F,68,9,3,28,41,26,28,7,13,1,1,8,33,41,5,2,34,55,24,34,6,21,2,6,9,30,55
2014-08-04 00:00:00.000,ATP World Tour Masters 1000 Canada Toronto; Canada ATP World Tour Masters 1000,HARD,2,Novak Djokovic,N/A Bye,Novak Djokovic,,R64,0,0,0,0,0,0,0,0,0,0,0,0,0,0,0,0,0,0,0,0,0,0,0,0,0,0,0
2014-08-04 00:00:00.000,ATP World Tour Masters 1000 Canada Toronto; Canada ATP World Tour Masters 1000,HARD,2,Gael Monfils,Radek Stepanek,Gael Monfils,6-3; 7-5,R64,92,5,2,36,69,26,36,16,33,3,5,11,42,69,5,7,43,81,32,43,12,38,5,9,10,44,81
2014-08-04 00:00:00.000,ATP World Tour Masters 1000 Canada Toronto; Canada ATP World Tour Masters 1000,HARD,2,Jeremy Chardy,Federico Delbonis,Jeremy Chardy,6-3; 5-7; 6-4,R64,118,10,5,49,90,40,49,24,41,6,7,16,64,90,7,5,48,87,35,48,25,39,4,6,15,60,87
2014-08-04 00:00:00.000,ATP World Tour Masters 1000 Canada Toronto; Canada ATP World Tour Masters 1000,HARD,2,Jo-Wilfried Tsonga,Edouard Roger-Vasselin,Jo-Wilfried Tsonga,7-6(3); 6-1,R64,76,10,1,34,62,32,34,18,28,3,3,10,50,62,4,2,33,57,26,33,11,24,3,5,9,37,57
2014-08-04 00:00:00.000,ATP World Tour Masters 1000 Canada Toronto; Canada ATP World Tour Masters 1000,HARD,2,Richard Gasquet,Vasek Pospisil,Richard Gasquet,7-5; 7-5,R64,109,4,2,37,73,27,37,23,36,2,3,12,50,73,13,1,42,73,31,42,13,31,0,3,12,44,73
2014-08-04 00:00:00.000,ATP World Tour Masters 1000 Canada Toronto; Canada ATP World Tour Masters 1000,HARD,2,Ivo Karlovic,Bernard Tomic,Ivo Karlovic,3-6; 7-6(5); 7-6(6),R64,114,30,2,60,92,55,60,19,32,2,3,16,74,92,13,0,62,106,51,62,29,44,0,0,17,80,106
2014-08-04 00:00:00.000,ATP World Tour Masters 1000 Canada Toronto; Canada ATP World Tour Masters 1000,HARD,2,Nick Kyrgios,Santiago Giraldo,Nick Kyrgios,7-6(3); 7-5,R64,95,11,4,38,68,32,38,18,30,1,2,12,50,68,2,2,52,77,35,52,14,25,6,8,12,49,77
2014-08-04 00:00:00.000,ATP World Tour Masters 1000 Canada Toronto; Canada ATP World Tour Masters 1000,HARD,2,Andy Murray,N/A Bye,Andy Murray,,R64,0,0,0,0,0,0,0,0,0,0,0,0,0,0,0,0,0,0,0,0,0,0,0,0,0,0,0
2014-08-04 00:00:00.000,ATP World Tour Masters 1000 Canada Toronto; Canada ATP World Tour Masters 1000,HARD,2,Stan Wawrinka,N/A Bye,Stan Wawrinka,,R64,0,0,0,0,0,0,0,0,0,0,0,0,0,0,0,0,0,0,0,0,0,0,0,0,0,0,0
2014-08-04 00:00:00.000,ATP World Tour Masters 1000 Canada Toronto; Canada ATP World Tour Masters 1000,HARD,2,Benoit Paire,Alejandro Falla,Benoit Paire,6-7(3); 6-4; 6-2,R64,117,13,5,47,81,39,47,17,34,4,7,15,56,81,2,11,56,113,38,56,25,57,12,18,15,63,113
2014-08-04 00:00:00.000,ATP World Tour Masters 1000 Canada Toronto; Canada ATP World Tour Masters 1000,HARD,2,Kevin Anderson,Thanasi Kokkinakis,Kevin Anderson,4-6; 6-2; 6-3,R64,126,13,1,62,88,43,62,18,26,4,5,14,61,88,3,5,48,78,33,48,15,30,3,6,13,48,78
2014-08-04 00:00:00.000,ATP World Tour Masters 1000 Canada Toronto; Canada ATP World Tour Masters 1000,HARD,2,Fabio Fognini,Mikhail Youzhny,Fabio Fognini,6-4; 6-3,R64,81,3,8,29,67,22,29,20,38,3,4,9,42,67,1,4,38,61,19,38,14,23,1,5,10,33,61
2014-08-04 00:00:00.000,ATP World Tour Masters 1000 Canada Toronto; Canada ATP World Tour Masters 1000,HARD,2,Tommy Robredo,Philipp Kohlschreiber,Tommy Robredo,6-3; 7-6(3),R64,90,4,3,49,78,40,49,15,29,3,3,11,55,78,4,3,35,72,26,35,22,37,4,5,10,48,72
2014-08-04 00:00:00.000,ATP World Tour Masters 1000 Canada Toronto; Canada ATP World Tour Masters 1000,HARD,2,Gilles Simon,Dominic Thiem,Gilles Simon,3-6; 6-4; 6-0,R64,100,9,1,43,82,33,43,16,39,3,7,13,49,82,0,0,36,63,22,36,10,27,0,6,12,32,63
2014-08-04 00:00:00.000,ATP World Tour Masters 1000 Canada Toronto; Canada ATP World Tour Masters 1000,HARD,2,Donald Young,Frank Dancevic,Donald Young,5-7; 6-0; 6-3,R64,100,3,3,47,84,34,47,22,37,2,4,14,56,84,7,2,50,84,34,50,13,34,4,9,13,47,84
2014-08-04 00:00:00.000,ATP World Tour Masters 1000 Canada Toronto; Canada ATP World Tour Masters 1000,HARD,2,Grigor Dimitrov,N/A Bye,Grigor Dimitrov,,R64,0,0,0,0,0,0,0,0,0,0,0,0,0,0,0,0,0,0,0,0,0,0,0,0,0,0,0
2014-08-04 00:00:00.000,ATP World Tour Masters 1000 Canada Toronto; Canada ATP World Tour Masters 1000,HARD,2,Milos Raonic,N/A Bye,Milos Raonic,,R64,0,0,0,0,0,0,0,0,0,0,0,0,0,0,0,0,0,0,0,0,0,0,0,0,0,0,0
2014-08-04 00:00:00.000,ATP World Tour Masters 1000 Canada Toronto; Canada ATP World Tour Masters 1000,HARD,2,Jack Sock,Jurgen Melzer,Jack Sock,6-1; 6-3,R64,56,6,1,31,49,26,31,9,18,3,3,8,35,49,3,0,32,44,17,32,5,12,2,6,8,22,44
2014-08-04 00:00:00.000,ATP World Tour Masters 1000 Canada Toronto; Canada ATP World Tour Masters 1000,HARD,2,Julien Benneteau,Lleyton Hewitt,Julien Benneteau,6-1; 6-2,R64,77,3,2,32,45,26,32,7,13,1,1,8,33,45,2,8,34,63,20,34,11,29,12,16,7,31,63
2014-08-04 00:00:00.000,ATP World Tour Masters 1000 Canada Toronto; Canada ATP World Tour Masters 1000,HARD,2,Ernests Gulbis,Joao Sousa,Ernests Gulbis,6-3; 6-4,R64,74,16,2,37,55,31,37,12,18,0,0,10,43,55,0,5,29,61,22,29,15,32,6,8,9,37,61
2014-08-04 00:00:00.000,ATP World Tour Masters 1000 Canada Toronto; Canada ATP World Tour Masters 1000,HARD,2,Feliciano Lopez,Roberto Bautista Agut,Feliciano Lopez,7-6(7); 6-3,R64,88,13,0,42,72,31,42,20,30,7,8,11,51,72,2,3,44,66,31,44,11,22,4,6,10,42,66
2014-08-04 00:00:00.000,ATP World Tour Masters 1000 Canada Toronto; Canada ATP World Tour Masters 1000,HARD,2,Tim Smyczek,Tobias Kamke,Tim Smyczek,6-3; 6-2,R64,104,4,3,28,55,24,28,16,27,2,2,9,40,55,0,5,42,61,26,42,7,19,3,6,8,33,61
2014-08-04 00:00:00.000,ATP World Tour Masters 1000 Canada Toronto; Canada ATP World Tour Masters 1000,HARD,2,Yen-Hsun Lu,Marcel Granollers,Yen-Hsun Lu,7-6(6); 7-5,R64,109,0,4,39,77,30,39,17,38,3,7,12,47,77,4,6,28,71,24,28,17,43,0,5,12,41,71
2014-08-04 00:00:00.000,ATP World Tour Masters 1000 Canada Toronto; Canada ATP World Tour Masters 1000,HARD,2,Tomas Berdych,N/A Bye,Tomas Berdych,,R64,0,0,0,0,0,0,0,0,0,0,0,0,0,0,0,0,0,0,0,0,0,0,0,0,0,0,0
2014-08-04 00:00:00.000,ATP World Tour Masters 1000 Canada Toronto; Canada ATP World Tour Masters 1000,HARD,2,David Ferrer,N/A Bye,David Ferrer,,R64,0,0,0,0,0,0,0,0,0,0,0,0,0,0,0,0,0,0,0,0,0,0,0,0,0,0,0
2014-08-04 00:00:00.000,ATP World Tour Masters 1000 Canada Toronto; Canada ATP World Tour Masters 1000,HARD,2,Michael Russell,Nicolas Mahut,Michael Russell,6-3; 6-3,R64,76,1,2,42,58,32,42,9,16,3,3,9,41,58,4,3,24,57,17,24,16,33,2,5,9,33,57
2014-08-04 00:00:00.000,ATP World Tour Masters 1000 Canada Toronto; Canada ATP World Tour Masters 1000,HARD,2,Andreas Seppi,Brayden Schnur,Andreas Seppi,6-3; 6-3,R64,72,4,1,33,51,26,33,10,18,1,2,9,36,51,4,6,29,60,19,29,12,31,0,4,9,31,60
2014-08-04 00:00:00.000,ATP World Tour Masters 1000 Canada Toronto; Canada ATP World Tour Masters 1000,HARD,2,Ivan Dodig,John Isner,Ivan Dodig,6-4; 6-7(4); 6-3,R64,112,9,4,60,88,52,60,17,28,0,0,16,69,88,13,6,57,92,48,57,15,35,7,9,15,63,92
2014-08-04 00:00:00.000,ATP World Tour Masters 1000 Canada Toronto; Canada ATP World Tour Masters 1000,HARD,2,Marin Cilic,Denis Istomin,Marin Cilic,6-2; 4-6; 7-5,R64,0,5,2,43,76,36,43,18,33,1,4,15,54,76,5,3,62,109,37,62,23,47,12,17,15,60,109
2014-08-04 00:00:00.000,ATP World Tour Masters 1000 Canada Toronto; Canada ATP World Tour Masters 1000,HARD,2,Malek Jaziri,Guillermo Garcia-Lopez,Malek Jaziri,6-4; 7-6(6),R64,116,2,2,43,85,30,43,23,42,6,7,11,53,85,0,1,47,76,33,47,15,29,5,7,11,48,76
2014-08-04 00:00:00.000,ATP World Tour Masters 1000 Canada Toronto; Canada ATP World Tour Masters 1000,HARD,2,Peter Polansky,Jerzy Janowicz,Peter Polansky,7-6(5); 6-4,R64,95,4,3,42,70,32,42,16,28,1,2,11,48,70,6,10,37,68,32,37,12,31,1,3,11,44,68
2014-08-04 00:00:00.000,ATP World Tour Masters 1000 Canada Toronto; Canada ATP World Tour Masters 1000,HARD,2,Roger Federer,N/A Bye,Roger Federer,,R64,0,0,0,0,0,0,0,0,0,0,0,0,0,0,0,0,0,0,0,0,0,0,0,0,0,0,0
2014-08-04 00:00:00.000,ATP World Tour Masters 1000 Canada Toronto; Canada ATP World Tour Masters 1000,HARD,2,Novak Djokovic,Gael Monfils,Novak Djokovic,6-2; 6-7(4); 7-6(2),R32,161,5,4,68,105,55,68,19,37,6,7,16,74,105,8,8,74,131,54,74,26,57,7,10,16,80,131
2014-08-04 00:00:00.000,ATP World Tour Masters 1000 Canada Toronto; Canada ATP World Tour Masters 1000,HARD,2,Jo-Wilfried Tsonga,Jeremy Chardy,Jo-Wilfried Tsonga,7-6(6); 6-4,R32,97,23,2,52,83,40,52,19,31,4,4,11,59,83,4,7,32,69,30,32,19,37,0,1,11,49,69
2014-08-04 00:00:00.000,ATP World Tour Masters 1000 Canada Toronto; Canada ATP World Tour Masters 1000,HARD,2,Richard Gasquet,Ivo Karlovic,Richard Gasquet,5-7; 7-6(5); 6-3,R32,116,3,2,61,92,48,61,22,31,0,1,16,70,92,27,5,63,96,53,63,18,33,3,5,17,71,96
2014-08-04 00:00:00.000,ATP World Tour Masters 1000 Canada Toronto; Canada ATP World Tour Masters 1000,HARD,2,Andy Murray,Nick Kyrgios,Andy Murray,6-2; 6-2,R32,55,7,2,25,38,24,25,8,13,0,0,8,32,38,1,1,26,44,16,26,7,18,1,5,8,23,44
2014-08-04 00:00:00.000,ATP World Tour Masters 1000 Canada Toronto; Canada ATP World Tour Masters 1000,HARD,2,Stan Wawrinka,Benoit Paire,Stan Wawrinka,4-6; 6-3; 7-6(2),R32,125,12,6,57,105,44,57,25,48,5,7,16,69,105,7,3,51,94,41,51,22,43,4,6,15,63,94
2014-08-04 00:00:00.000,ATP World Tour Masters 1000 Canada Toronto; Canada ATP World Tour Masters 1000,HARD,2,Kevin Anderson,Fabio Fognini,Kevin Anderson,7-5; 6-2,R32,68,12,2,37,54,29,37,9,17,2,3,10,38,54,1,7,37,55,27,37,4,18,2,6,10,31,55
2014-08-04 00:00:00.000,ATP World Tour Masters 1000 Canada Toronto; Canada ATP World Tour Masters 1000,HARD,2,Tommy Robredo,Gilles Simon,Tommy Robredo,7-5; 6-4,R32,86,2,0,38,58,32,38,13,20,1,1,11,45,58,2,2,35,67,28,35,16,32,6,8,11,44,67
2014-08-04 00:00:00.000,ATP World Tour Masters 1000 Canada Toronto; Canada ATP World Tour Masters 1000,HARD,2,Grigor Dimitrov,Donald Young,Grigor Dimitrov,4-6; 6-2; 6-3,R32,100,1,7,45,86,36,45,20,41,5,7,14,56,86,0,3,39,70,28,39,17,31,0,4,13,45,70
2014-08-04 00:00:00.000,ATP World Tour Masters 1000 Canada Toronto; Canada ATP World Tour Masters 1000,HARD,2,Milos Raonic,Jack Sock,Milos Raonic,4-6; 7-6(2); 7-6(4),R32,144,15,2,73,110,58,73,24,37,5,6,17,82,110,3,4,69,103,56,69,20,34,4,4,17,76,103
2014-08-04 00:00:00.000,ATP World Tour Masters 1000 Canada Toronto; Canada ATP World Tour Masters 1000,HARD,2,Julien Benneteau,Ernests Gulbis,Julien Benneteau,7-6(4); 6-3,R32,94,6,4,43,71,37,43,18,28,5,5,11,55,71,8,1,36,63,25,36,18,27,3,4,10,43,63
2014-08-04 00:00:00.000,ATP World Tour Masters 1000 Canada Toronto; Canada ATP World Tour Masters 1000,HARD,2,Feliciano Lopez,Tim Smyczek,Feliciano Lopez,7-5; 6-4,R32,81,12,1,44,69,33,44,19,25,6,6,11,52,69,2,1,36,60,27,36,14,24,2,4,11,41,60
2014-08-04 00:00:00.000,ATP World Tour Masters 1000 Canada Toronto; Canada ATP World Tour Masters 1000,HARD,2,Tomas Berdych,Yen-Hsun Lu,Tomas Berdych,6-7(4); 6-4; 6-4,R32,138,14,8,61,104,46,61,24,43,2,3,16,70,104,6,4,63,111,40,63,29,48,4,7,16,69,111
2014-08-04 00:00:00.000,ATP World Tour Masters 1000 Canada Toronto; Canada ATP World Tour Masters 1000,HARD,2,David Ferrer,Michael Russell,David Ferrer,6-4; 2-6; 6-1,R32,108,4,4,42,87,30,42,23,45,9,11,12,53,87,0,1,59,81,37,59,10,22,3,7,13,47,81
2014-08-04 00:00:00.000,ATP World Tour Masters 1000 Canada Toronto; Canada ATP World Tour Masters 1000,HARD,2,Ivan Dodig,Andreas Seppi,Ivan Dodig,6-4; 3-6; 7-6(5),R32,153,12,7,67,111,46,67,20,44,7,10,15,66,111,5,8,51,109,36,51,32,58,5,8,16,68,109
2014-08-04 00:00:00.000,ATP World Tour Masters 1000 Canada Toronto; Canada ATP World Tour Masters 1000,HARD,2,Marin Cilic,Malek Jaziri,Marin Cilic,4-6; 6-0; 7-6(4),R32,121,8,3,46,88,38,46,20,42,2,5,14,58,88,2,6,53,98,35,53,20,45,3,8,14,55,98
2014-08-04 00:00:00.000,ATP World Tour Masters 1000 Canada Toronto; Canada ATP World Tour Masters 1000,HARD,2,Roger Federer,Peter Polansky,Roger Federer,6-2; 6-0,R32,52,5,3,29,43,24,29,5,14,1,2,7,29,43,0,2,25,49,9,25,10,24,0,6,7,19,49
2014-08-04 00:00:00.000,ATP World Tour Masters 1000 Canada Toronto; Canada ATP World Tour Masters 1000,HARD,2,Jo-Wilfried Tsonga,Novak Djokovic,Jo-Wilfried Tsonga,6-2; 6-2,R16,64,8,2,26,49,21,26,13,23,1,1,8,34,49,2,1,30,49,17,30,9,19,0,4,8,26,49
2014-08-04 00:00:00.000,ATP World Tour Masters 1000 Canada Toronto; Canada ATP World Tour Masters 1000,HARD,2,Andy Murray,Richard Gasquet,Andy Murray,W/O,R16,0,0,0,0,0,0,0,0,0,0,0,0,0,0,0,0,0,0,0,0,0,0,0,0,0,0,0
2014-08-04 00:00:00.000,ATP World Tour Masters 1000 Canada Toronto; Canada ATP World Tour Masters 1000,HARD,2,Kevin Anderson,Stan Wawrinka,Kevin Anderson,7-6(8); 7-5,R16,105,11,0,50,73,42,50,13,23,1,2,12,55,73,1,3,32,74,25,32,26,42,3,5,12,51,74
2014-08-04 00:00:00.000,ATP World Tour Masters 1000 Canada Toronto; Canada ATP World Tour Masters 1000,HARD,2,Grigor Dimitrov,Tommy Robredo,Grigor Dimitrov,7-5; 5-7; 6-4,R16,124,6,4,46,87,37,46,24,41,0,2,17,61,87,4,1,80,102,56,80,13,22,5,8,17,69,102
2014-08-04 00:00:00.000,ATP World Tour Masters 1000 Canada Toronto; Canada ATP World Tour Masters 1000,HARD,2,Milos Raonic,Julien Benneteau,Milos Raonic,6-3; 4-6; 6-4,R16,107,15,3,52,77,44,52,12,25,0,2,15,56,77,8,1,50,81,38,50,15,31,6,9,14,53,81
2014-08-04 00:00:00.000,ATP World Tour Masters 1000 Canada Toronto; Canada ATP World Tour Masters 1000,HARD,2,Feliciano Lopez,Tomas Berdych,Feliciano Lopez,3-6; 6-3; 6-4,R16,116,11,6,54,85,43,54,14,31,5,6,14,57,85,11,4,46,86,38,46,19,40,2,4,14,57,86
2014-08-04 00:00:00.000,ATP World Tour Masters 1000 Canada Toronto; Canada ATP World Tour Masters 1000,HARD,2,David Ferrer,Ivan Dodig,David Ferrer,1-6; 6-3; 6-3,R16,115,6,4,51,89,37,51,18,38,12,14,12,55,89,6,7,45,85,34,45,20,40,4,7,13,54,85
2014-08-04 00:00:00.000,ATP World Tour Masters 1000 Canada Toronto; Canada ATP World Tour Masters 1000,HARD,2,Roger Federer,Marin Cilic,Roger Federer,7-6(5); 6-7(3); 6-4,R16,159,11,4,67,106,55,67,23,39,2,2,17,78,106,12,1,83,145,60,83,36,62,9,10,17,96,145
2014-08-04 00:00:00.000,ATP World Tour Masters 1000 Canada Toronto; Canada ATP World Tour Masters 1000,HARD,2,Jo-Wilfried Tsonga,Andy Murray,Jo-Wilfried Tsonga,7-6(5); 4-6; 6-4,Q,139,18,4,59,91,49,59,13,32,1,4,16,62,91,7,3,60,93,44,60,20,33,6,9,16,64,93
2014-08-04 00:00:00.000,ATP World Tour Masters 1000 Canada Toronto; Canada ATP World Tour Masters 1000,HARD,2,Grigor Dimitrov,Kevin Anderson,Grigor Dimitrov,5-7; 7-5; 7-6(6),Q,179,10,3,64,113,50,64,22,49,2,5,18,72,113,15,5,79,128,57,79,21,49,6,9,18,78,128
2014-08-04 00:00:00.000,ATP World Tour Masters 1000 Canada Toronto; Canada ATP World Tour Masters 1000,HARD,2,Feliciano Lopez,Milos Raonic,Feliciano Lopez,6-4; 6-7(5); 6-3,Q,117,9,4,65,104,56,65,21,39,9,9,16,77,104,18,1,55,79,44,55,14,24,2,4,15,58,79
2014-08-04 00:00:00.000,ATP World Tour Masters 1000 Canada Toronto; Canada ATP World Tour Masters 1000,HARD,2,Roger Federer,David Ferrer,Roger Federer,6-3; 4-6; 6-3,Q,114,7,3,50,87,40,50,15,37,3,6,14,55,87,0,3,56,92,32,56,18,36,4,9,14,50,92
2014-08-04 00:00:00.000,ATP World Tour Masters 1000 Canada Toronto; Canada ATP World Tour Masters 1000,HARD,2,Jo-Wilfried Tsonga,Grigor Dimitrov,Jo-Wilfried Tsonga,6-4; 6-3,S,84,7,4,26,53,23,26,17,27,4,4,9,40,53,5,2,39,70,25,39,13,31,7,10,10,38,70
2014-08-04 00:00:00.000,ATP World Tour Masters 1000 Canada Toronto; Canada ATP World Tour Masters 1000,HARD,2,Roger Federer,Feliciano Lopez,Roger Federer,6-3; 6-4,S,82,13,1,29,53,25,29,16,24,0,0,10,41,53,8,9,29,77,24,29,21,48,9,11,9,45,77
2014-08-04 00:00:00.000,ATP World Tour Masters 1000 Canada Toronto; Canada ATP World Tour Masters 1000,HARD,2,Jo-Wilfried Tsonga,Roger Federer,Jo-Wilfried Tsonga,7-5; 7-6(3),F,108,11,2,35,70,33,35,22,35,0,0,12,55,70,7,4,64,100,45,64,18,36,6,7,12,63,100
2014-08-10 00:00:00.000,ATP World Tour Masters 1000 Cincinnati OH; U.S.A. ATP World Tour Masters 1000,HARD,2,Novak Djokovic,N/A Bye,Novak Djokovic,,R64,0,0,0,0,0,0,0,0,0,0,0,0,0,0,0,0,0,0,0,0,0,0,0,0,0,0,0
2014-08-10 00:00:00.000,ATP World Tour Masters 1000 Cincinnati OH; U.S.A. ATP World Tour Masters 1000,HARD,2,Gilles Simon,Bernard Tomic,Gilles Simon,6-3; 6-2,R64,61,10,1,32,53,26,32,14,21,0,0,9,40,53,7,1,28,51,18,28,10,23,3,6,8,28,51
2014-08-10 00:00:00.000,ATP World Tour Masters 1000 Cincinnati OH; U.S.A. ATP World Tour Masters 1000,HARD,2,Sam Querrey,Alejandro Falla,Sam Querrey,6-3; 6-1,R64,47,8,1,28,41,25,28,8,13,1,1,8,33,41,3,6,23,50,13,23,12,27,0,4,8,25,50
2014-08-10 00:00:00.000,ATP World Tour Masters 1000 Cincinnati OH; U.S.A. ATP World Tour Masters 1000,HARD,2,Tommy Robredo,Jack Sock,Tommy Robredo,7-6(5); 6-3,R64,98,5,0,40,57,31,40,11,17,0,1,10,42,57,3,3,51,88,34,51,18,37,6,9,11,52,88
2014-08-10 00:00:00.000,ATP World Tour Masters 1000 Cincinnati OH; U.S.A. ATP World Tour Masters 1000,HARD,2,Mikhail Youzhny,Jo-Wilfried Tsonga,Mikhail Youzhny,6-1; 6-4,R64,68,4,1,29,52,23,29,12,23,0,1,9,35,52,3,0,25,48,16,25,7,23,1,5,8,23,48
2014-08-10 00:00:00.000,ATP World Tour Masters 1000 Cincinnati OH; U.S.A. ATP World Tour Masters 1000,HARD,2,Andreas Seppi,Santiago Giraldo,Andreas Seppi,4-6; 6-2; 7-5,R64,125,8,5,51,93,37,51,19,42,5,9,15,56,93,5,4,52,87,32,52,16,35,8,14,15,48,87
2014-08-10 00:00:00.000,ATP World Tour Masters 1000 Cincinnati OH; U.S.A. ATP World Tour Masters 1000,HARD,2,Philipp Kohlschreiber,Jeremy Chardy,Philipp Kohlschreiber,6-3; 4-6; 6-4,R64,116,11,1,48,88,38,48,25,40,3,4,15,63,88,7,9,46,94,33,46,25,48,6,8,14,58,94
2014-08-10 00:00:00.000,ATP World Tour Masters 1000 Cincinnati OH; U.S.A. ATP World Tour Masters 1000,HARD,2,David Ferrer,N/A Bye,David Ferrer,,R64,0,0,0,0,0,0,0,0,0,0,0,0,0,0,0,0,0,0,0,0,0,0,0,0,0,0,0
2014-08-10 00:00:00.000,ATP World Tour Masters 1000 Cincinnati OH; U.S.A. ATP World Tour Masters 1000,HARD,2,Stan Wawrinka,N/A Bye,Stan Wawrinka,,R64,0,0,0,0,0,0,0,0,0,0,0,0,0,0,0,0,0,0,0,0,0,0,0,0,0,0,0
2014-08-10 00:00:00.000,ATP World Tour Masters 1000 Cincinnati OH; U.S.A. ATP World Tour Masters 1000,HARD,2,Benjamin Becker,Ivo Karlovic,Benjamin Becker,7-6(5); 6-4,R64,81,4,3,51,72,41,51,12,21,2,2,11,53,72,17,2,43,64,39,43,11,21,1,2,11,50,64
2014-08-10 00:00:00.000,ATP World Tour Masters 1000 Cincinnati OH; U.S.A. ATP World Tour Masters 1000,HARD,2,Fernando Verdasco,Marcel Granollers,Fernando Verdasco,5-7; 6-3; 7-6(5),R64,170,8,16,65,129,51,65,26,64,5,9,17,77,129,1,3,56,105,36,56,27,49,4,8,16,63,105
2014-08-10 00:00:00.000,ATP World Tour Masters 1000 Cincinnati OH; U.S.A. ATP World Tour Masters 1000,HARD,2,Marin Cilic,Feliciano Lopez,Marin Cilic,6-3; 6-4,R64,67,6,5,33,55,28,33,14,22,3,3,10,42,55,7,1,31,49,20,31,11,18,2,4,9,31,49
2014-08-10 00:00:00.000,ATP World Tour Masters 1000 Cincinnati OH; U.S.A. ATP World Tour Masters 1000,HARD,2,Julien Benneteau,Blaz Rola,Julien Benneteau,6-7(7); 6-3; 7-6(7),R64,159,11,6,77,122,51,77,27,45,5,8,17,78,122,8,2,71,123,48,71,27,52,5,9,16,75,123
2014-08-10 00:00:00.000,ATP World Tour Masters 1000 Cincinnati OH; U.S.A. ATP World Tour Masters 1000,HARD,2,James Ward,Guillermo Garcia-Lopez,James Ward,6-2; 3-6; 6-1,R64,101,8,1,30,66,23,30,25,36,1,2,12,48,66,1,7,62,89,39,62,11,27,9,13,12,50,89
2014-08-10 00:00:00.000,ATP World Tour Masters 1000 Cincinnati OH; U.S.A. ATP World Tour Masters 1000,HARD,2,Jerzy Janowicz,Teymuraz Gabashvili,Jerzy Janowicz,6-4; 6-4,R64,75,5,9,31,57,27,31,16,26,0,0,10,43,57,4,1,38,60,28,38,11,22,3,5,10,39,60
2014-08-10 00:00:00.000,ATP World Tour Masters 1000 Cincinnati OH; U.S.A. ATP World Tour Masters 1000,HARD,2,Grigor Dimitrov,N/A Bye,Grigor Dimitrov,,R64,0,0,0,0,0,0,0,0,0,0,0,0,0,0,0,0,0,0,0,0,0,0,0,0,0,0,0
2014-08-10 00:00:00.000,ATP World Tour Masters 1000 Cincinnati OH; U.S.A. ATP World Tour Masters 1000,HARD,2,Milos Raonic,N/A Bye,Milos Raonic,,R64,0,0,0,0,0,0,0,0,0,0,0,0,0,0,0,0,0,0,0,0,0,0,0,0,0,0,0
2014-08-10 00:00:00.000,ATP World Tour Masters 1000 Cincinnati OH; U.S.A. ATP World Tour Masters 1000,HARD,2,Robby Ginepri,Dominic Thiem,Robby Ginepri,6-3; 5-7; 7-5,R64,123,6,1,57,93,44,57,18,36,2,5,16,62,93,8,3,62,100,41,62,20,38,4,9,17,61,100
2014-08-10 00:00:00.000,ATP World Tour Masters 1000 Cincinnati OH; U.S.A. ATP World Tour Masters 1000,HARD,2,Steve Johnson,Benoit Paire,Steve Johnson,6-4; 6-1,R64,66,1,0,36,53,30,36,9,17,2,2,9,39,53,7,6,31,63,19,31,16,32,6,9,8,35,63
2014-08-10 00:00:00.000,ATP World Tour Masters 1000 Cincinnati OH; U.S.A. ATP World Tour Masters 1000,HARD,2,Ernests Gulbis,Ivan Dodig,Ernests Gulbis,7-6(8); 7-6(4),R64,122,8,1,50,87,40,50,19,37,3,5,12,59,87,7,3,52,85,33,52,18,33,4,6,12,51,85
2014-08-10 00:00:00.000,ATP World Tour Masters 1000 Cincinnati OH; U.S.A. ATP World Tour Masters 1000,HARD,2,Fabio Fognini,Edouard Roger-Vasselin,Fabio Fognini,6-4; 4-6; 7-6(5),R64,158,3,5,56,100,39,56,17,44,6,12,16,56,100,6,3,76,123,47,76,21,47,9,15,16,68,123
2014-08-10 00:00:00.000,ATP World Tour Masters 1000 Cincinnati OH; U.S.A. ATP World Tour Masters 1000,HARD,2,Lleyton Hewitt,Jurgen Melzer,Lleyton Hewitt,3-6; 6-4; 6-4,R64,127,11,8,52,96,39,52,19,44,8,12,15,58,96,10,7,49,82,33,49,16,33,2,6,14,49,82
2014-08-10 00:00:00.000,ATP World Tour Masters 1000 Cincinnati OH; U.S.A. ATP World Tour Masters 1000,HARD,2,Yen-Hsun Lu,Denis Istomin,Yen-Hsun Lu,6-3; 6-4,R64,55,7,2,30,48,28,30,14,18,1,1,10,42,48,2,2,38,51,29,38,3,13,1,3,9,32,51
2014-08-10 00:00:00.000,ATP World Tour Masters 1000 Cincinnati OH; U.S.A. ATP World Tour Masters 1000,HARD,2,Tomas Berdych,N/A Bye,Tomas Berdych,,R64,0,0,0,0,0,0,0,0,0,0,0,0,0,0,0,0,0,0,0,0,0,0,0,0,0,0,0
2014-08-10 00:00:00.000,ATP World Tour Masters 1000 Cincinnati OH; U.S.A. ATP World Tour Masters 1000,HARD,2,Andy Murray,N/A Bye,Andy Murray,,R64,0,0,0,0,0,0,0,0,0,0,0,0,0,0,0,0,0,0,0,0,0,0,0,0,0,0,0
2014-08-10 00:00:00.000,ATP World Tour Masters 1000 Cincinnati OH; U.S.A. ATP World Tour Masters 1000,HARD,2,Joao Sousa,Chase Buchanan,Joao Sousa,5-7; 7-6(3); 7-6(5),R64,155,15,2,58,114,42,58,30,56,6,11,18,72,114,8,5,77,117,54,77,19,40,3,7,18,73,117
2014-08-10 00:00:00.000,ATP World Tour Masters 1000 Cincinnati OH; U.S.A. ATP World Tour Masters 1000,HARD,2,Marinko Matosevic,Nicolas Mahut,Marinko Matosevic,6-4; 7-6(4),R64,117,5,3,52,83,39,52,18,31,6,6,11,57,83,6,5,42,84,30,42,24,42,10,11,11,54,84
2014-08-10 00:00:00.000,ATP World Tour Masters 1000 Cincinnati OH; U.S.A. ATP World Tour Masters 1000,HARD,2,John Isner,Kevin Anderson,John Isner,6-3; 6-4,R64,65,15,3,34,55,30,34,12,21,3,3,10,42,55,8,4,40,55,28,40,7,15,4,6,9,35,55
2014-08-10 00:00:00.000,ATP World Tour Masters 1000 Cincinnati OH; U.S.A. ATP World Tour Masters 1000,HARD,2,Roberto Bautista Agut,Martin Klizan,Roberto Bautista Agut,6-2; 4-6; 7-5,R64,125,3,5,57,89,40,57,15,32,2,6,15,55,89,4,8,44,96,28,44,22,52,6,12,15,50,96
2014-08-10 00:00:00.000,ATP World Tour Masters 1000 Cincinnati OH; U.S.A. ATP World Tour Masters 1000,HARD,2,Gael Monfils,Federico Delbonis,Gael Monfils,6-3; 3-6; 6-3,R64,91,5,4,63,80,47,63,10,17,5,6,14,57,80,1,4,41,72,32,41,17,31,2,4,13,49,72
2014-08-10 00:00:00.000,ATP World Tour Masters 1000 Cincinnati OH; U.S.A. ATP World Tour Masters 1000,HARD,2,Vasek Pospisil,Radek Stepanek,Vasek Pospisil,5-7; 6-1; 7-6(4),R64,139,16,5,74,113,57,74,18,39,6,8,16,75,113,5,4,56,93,37,56,23,37,0,3,15,60,93
2014-08-10 00:00:00.000,ATP World Tour Masters 1000 Cincinnati OH; U.S.A. ATP World Tour Masters 1000,HARD,2,Roger Federer,N/A Bye,Roger Federer,,R64,0,0,0,0,0,0,0,0,0,0,0,0,0,0,0,0,0,0,0,0,0,0,0,0,0,0,0
2014-08-10 00:00:00.000,ATP World Tour Masters 1000 Cincinnati OH; U.S.A. ATP World Tour Masters 1000,HARD,2,Novak Djokovic,Gilles Simon,Novak Djokovic,6-3; 4-6; 6-4,R32,130,7,3,60,85,44,60,11,25,2,5,15,55,85,5,2,48,89,33,48,23,41,6,10,14,56,89
2014-08-10 00:00:00.000,ATP World Tour Masters 1000 Cincinnati OH; U.S.A. ATP World Tour Masters 1000,HARD,2,Tommy Robredo,Sam Querrey,Tommy Robredo,6-2; 6-4,R32,60,3,3,38,50,31,38,4,12,0,1,9,35,50,3,2,25,51,17,25,11,26,0,4,9,28,51
2014-08-10 00:00:00.000,ATP World Tour Masters 1000 Cincinnati OH; U.S.A. ATP World Tour Masters 1000,HARD,2,Mikhail Youzhny,Andreas Seppi,Mikhail Youzhny,6-3; 6-4,R32,79,3,1,37,53,26,37,10,16,3,5,10,36,53,4,3,32,60,20,32,13,28,6,10,9,33,60
2014-08-10 00:00:00.000,ATP World Tour Masters 1000 Cincinnati OH; U.S.A. ATP World Tour Masters 1000,HARD,2,David Ferrer,Philipp Kohlschreiber,David Ferrer,6-7(4); 7-6(4); 7-6(4),R32,162,7,5,75,118,53,75,27,43,5,7,18,80,118,18,2,85,138,60,85,25,53,7,9,18,85,138
2014-08-10 00:00:00.000,ATP World Tour Masters 1000 Cincinnati OH; U.S.A. ATP World Tour Masters 1000,HARD,2,Stan Wawrinka,Benjamin Becker,Stan Wawrinka,6-3; 7-6(5),R32,83,8,2,45,75,37,45,15,30,2,3,11,52,75,7,0,58,78,37,58,12,20,6,8,10,49,78
2014-08-10 00:00:00.000,ATP World Tour Masters 1000 Cincinnati OH; U.S.A. ATP World Tour Masters 1000,HARD,2,Marin Cilic,Fernando Verdasco,Marin Cilic,7-6(6); 7-6(5),R32,120,9,1,56,86,46,56,18,30,4,4,12,64,86,11,7,61,95,47,61,16,34,4,4,12,63,95
2014-08-10 00:00:00.000,ATP World Tour Masters 1000 Cincinnati OH; U.S.A. ATP World Tour Masters 1000,HARD,2,Julien Benneteau,James Ward,Julien Benneteau,6-2; 6-2,R32,64,1,1,32,47,24,32,11,15,2,2,8,35,47,1,1,30,43,15,30,7,13,3,7,8,22,43
2014-08-10 00:00:00.000,ATP World Tour Masters 1000 Cincinnati OH; U.S.A. ATP World Tour Masters 1000,HARD,2,Jerzy Janowicz,Grigor Dimitrov,Jerzy Janowicz,6-4; 3-6; 6-3,R32,108,12,7,42,71,33,42,16,29,0,2,14,49,71,7,5,40,79,32,40,17,39,4,7,14,49,79
2014-08-10 00:00:00.000,ATP World Tour Masters 1000 Cincinnati OH; U.S.A. ATP World Tour Masters 1000,HARD,2,Milos Raonic,Robby Ginepri,Milos Raonic,6-2; 6-2,R32,54,11,3,20,40,19,20,13,20,0,0,8,32,40,2,2,26,41,13,26,8,15,4,8,8,21,41
2014-08-10 00:00:00.000,ATP World Tour Masters 1000 Cincinnati OH; U.S.A. ATP World Tour Masters 1000,HARD,2,Steve Johnson,Ernests Gulbis,Steve Johnson,6-4; 6-4,R32,77,4,0,34,59,29,34,12,25,2,3,10,41,59,11,3,37,65,24,37,14,28,9,12,10,38,65
2014-08-10 00:00:00.000,ATP World Tour Masters 1000 Cincinnati OH; U.S.A. ATP World Tour Masters 1000,HARD,2,Fabio Fognini,Lleyton Hewitt,Fabio Fognini,6-1; 6-4,R32,74,2,6,26,49,19,26,9,23,3,6,8,28,49,2,9,21,57,11,21,12,36,5,12,9,23,57
2014-08-10 00:00:00.000,ATP World Tour Masters 1000 Cincinnati OH; U.S.A. ATP World Tour Masters 1000,HARD,2,Yen-Hsun Lu,Tomas Berdych,Yen-Hsun Lu,3-6; 6-3; 6-4,R32,105,9,2,51,82,37,51,19,31,4,5,14,56,82,6,4,41,76,32,41,20,35,2,4,14,52,76
2014-08-10 00:00:00.000,ATP World Tour Masters 1000 Cincinnati OH; U.S.A. ATP World Tour Masters 1000,HARD,2,Andy Murray,Joao Sousa,Andy Murray,6-3; 6-3,R32,72,4,2,40,63,32,40,11,23,2,2,9,43,63,2,3,28,57,20,28,13,29,1,4,9,33,57
2014-08-10 00:00:00.000,ATP World Tour Masters 1000 Cincinnati OH; U.S.A. ATP World Tour Masters 1000,HARD,2,John Isner,Marinko Matosevic,John Isner,6-3; 7-6(1),R32,73,16,0,41,60,35,41,13,19,0,0,11,48,60,1,4,45,66,31,45,12,21,4,5,10,43,66
2014-08-10 00:00:00.000,ATP World Tour Masters 1000 Cincinnati OH; U.S.A. ATP World Tour Masters 1000,HARD,2,Gael Monfils,Roberto Bautista Agut,Gael Monfils,6-4; 6-1,R32,59,4,1,26,45,21,26,13,19,1,1,8,34,45,1,1,38,54,19,38,8,16,3,7,9,27,54
2014-08-10 00:00:00.000,ATP World Tour Masters 1000 Cincinnati OH; U.S.A. ATP World Tour Masters 1000,HARD,2,Roger Federer,Vasek Pospisil,Roger Federer,7-6(4); 5-7; 6-2,R32,122,6,0,61,88,46,61,22,27,1,2,16,68,88,8,9,57,99,45,57,20,42,4,6,16,65,99
2014-08-10 00:00:00.000,ATP World Tour Masters 1000 Cincinnati OH; U.S.A. ATP World Tour Masters 1000,HARD,2,Tommy Robredo,Novak Djokovic,Tommy Robredo,7-6(6); 7-5,R16,105,5,1,45,69,34,45,17,24,0,1,12,51,69,10,3,51,78,36,51,12,27,4,6,12,48,78
2014-08-10 00:00:00.000,ATP World Tour Masters 1000 Cincinnati OH; U.S.A. ATP World Tour Masters 1000,HARD,2,David Ferrer,Mikhail Youzhny,David Ferrer,7-5; 6-0,R16,82,2,5,38,61,27,38,14,23,4,5,9,41,61,1,0,32,62,18,32,13,30,5,10,9,31,62
2014-08-10 00:00:00.000,ATP World Tour Masters 1000 Cincinnati OH; U.S.A. ATP World Tour Masters 1000,HARD,2,Stan Wawrinka,Marin Cilic,Stan Wawrinka,3-6; 6-0; 6-1,R16,83,7,5,31,67,26,31,20,36,3,4,11,46,67,2,1,40,62,29,40,6,22,3,8,11,35,62
2014-08-10 00:00:00.000,ATP World Tour Masters 1000 Cincinnati OH; U.S.A. ATP World Tour Masters 1000,HARD,2,Julien Benneteau,Jerzy Janowicz,Julien Benneteau,7-5; 6-1,R16,74,5,0,51,66,40,51,6,15,3,3,10,46,66,9,4,27,48,19,27,11,21,1,4,9,30,48
2014-08-10 00:00:00.000,ATP World Tour Masters 1000 Cincinnati OH; U.S.A. ATP World Tour Masters 1000,HARD,2,Milos Raonic,Steve Johnson,Milos Raonic,6-7(7); 6-3; 7-6(4),R16,134,30,8,60,98,56,60,20,38,1,2,17,76,98,4,4,75,119,55,75,22,44,6,8,16,77,119
2014-08-10 00:00:00.000,ATP World Tour Masters 1000 Cincinnati OH; U.S.A. ATP World Tour Masters 1000,HARD,2,Fabio Fognini,Yen-Hsun Lu,Fabio Fognini,3-6; 6-3; 6-3,R16,105,6,4,43,90,36,43,23,47,9,10,13,59,90,7,1,56,82,42,56,10,26,5,8,14,52,82
2014-08-10 00:00:00.000,ATP World Tour Masters 1000 Cincinnati OH; U.S.A. ATP World Tour Masters 1000,HARD,2,Andy Murray,John Isner,Andy Murray,6-7(3); 6-4; 7-6(2),R16,143,14,4,62,103,57,62,22,41,3,3,17,79,103,21,2,63,100,52,63,23,37,4,5,17,75,100
2014-08-10 00:00:00.000,ATP World Tour Masters 1000 Cincinnati OH; U.S.A. ATP World Tour Masters 1000,HARD,2,Roger Federer,Gael Monfils,Roger Federer,6-4; 4-6; 6-3,R16,109,4,5,52,87,37,52,18,35,3,6,15,55,87,7,8,45,91,29,45,22,46,5,9,14,51,91
2014-08-10 00:00:00.000,ATP World Tour Masters 1000 Cincinnati OH; U.S.A. ATP World Tour Masters 1000,HARD,2,David Ferrer,Tommy Robredo,David Ferrer,6-4; 3-6; 6-3,Q,126,5,5,54,91,40,54,16,37,4,7,14,56,91,4,2,72,109,45,72,18,37,7,11,14,63,109
2014-08-10 00:00:00.000,ATP World Tour Masters 1000 Cincinnati OH; U.S.A. ATP World Tour Masters 1000,HARD,2,Julien Benneteau,Stan Wawrinka,Julien Benneteau,1-6; 6-1; 6-2,Q,81,9,4,41,60,34,41,7,19,1,3,11,41,60,8,0,36,69,25,36,15,33,5,9,11,40,69
2014-08-10 00:00:00.000,ATP World Tour Masters 1000 Cincinnati OH; U.S.A. ATP World Tour Masters 1000,HARD,2,Milos Raonic,Fabio Fognini,Milos Raonic,6-1; 6-0,Q,57,7,3,23,45,19,23,12,22,7,7,6,31,45,2,4,17,40,7,17,7,23,0,6,7,14,40
2014-08-10 00:00:00.000,ATP World Tour Masters 1000 Cincinnati OH; U.S.A. ATP World Tour Masters 1000,HARD,2,Roger Federer,Andy Murray,Roger Federer,6-3; 7-5,Q,93,3,3,38,63,27,38,13,25,4,6,10,40,63,6,2,35,73,21,35,17,38,8,13,11,38,73
2014-08-10 00:00:00.000,ATP World Tour Masters 1000 Cincinnati OH; U.S.A. ATP World Tour Masters 1000,HARD,2,David Ferrer,Julien Benneteau,David Ferrer,6-3; 6-2,S,72,3,0,32,46,24,32,10,14,1,1,8,34,46,3,5,44,66,28,44,7,22,6,10,9,35,66
2014-08-10 00:00:00.000,ATP World Tour Masters 1000 Cincinnati OH; U.S.A. ATP World Tour Masters 1000,HARD,2,Roger Federer,Milos Raonic,Roger Federer,6-2; 6-3,S,69,2,0,33,52,29,33,10,19,1,1,9,39,52,6,3,25,57,17,25,16,32,2,5,8,33,57
2014-08-10 00:00:00.000,ATP World Tour Masters 1000 Cincinnati OH; U.S.A. ATP World Tour Masters 1000,HARD,2,Roger Federer,David Ferrer,Roger Federer,6-3; 1-6; 6-2,F,102,6,2,47,74,36,47,13,27,9,11,12,49,74,3,3,54,88,38,54,14,34,11,14,12,52,88
2014-08-17 00:00:00.000,Winston-Salem NC; U.S.A. ATP World Tour 250,HARD,2,John Isner,N/A Bye,John Isner,,R64,0,0,0,0,0,0,0,0,0,0,0,0,0,0,0,0,0,0,0,0,0,0,0,0,0,0,0
2014-08-17 00:00:00.000,Winston-Salem NC; U.S.A. ATP World Tour 250,HARD,2,Bradley Klahn,Noah Rubin,Bradley Klahn,6-2; 0-6; 7-6(5),R64,132,7,10,62,120,44,62,21,58,14,19,13,65,120,1,3,56,84,37,56,14,28,3,7,13,51,84
2014-08-17 00:00:00.000,Winston-Salem NC; U.S.A. ATP World Tour 250,HARD,2,Robin Haase,Benoit Paire,Robin Haase,6-4; 2-6; 6-2,R64,92,2,3,50,78,32,50,20,28,4,6,13,52,78,3,4,35,82,25,35,25,47,5,8,13,50,82
2014-08-17 00:00:00.000,Winston-Salem NC; U.S.A. ATP World Tour 250,HARD,2,Mikhail Kukushkin,N/A Bye,Mikhail Kukushkin,,R64,0,0,0,0,0,0,0,0,0,0,0,0,0,0,0,0,0,0,0,0,0,0,0,0,0,0,0
2014-08-17 00:00:00.000,Winston-Salem NC; U.S.A. ATP World Tour 250,HARD,2,Pablo Andujar,N/A Bye,Pablo Andujar,,R64,0,0,0,0,0,0,0,0,0,0,0,0,0,0,0,0,0,0,0,0,0,0,0,0,0,0,0
2014-08-17 00:00:00.000,Winston-Salem NC; U.S.A. ATP World Tour 250,HARD,2,Igor Sijsling,Andrey Golubev,Igor Sijsling,7-6(5); 6-3,R64,94,8,3,36,63,25,36,16,27,1,4,11,41,63,2,9,39,87,26,39,21,48,7,11,10,47,87
2014-08-17 00:00:00.000,Winston-Salem NC; U.S.A. ATP World Tour 250,HARD,2,Ryan Harrison,Jan-Lennard Struff,Ryan Harrison,6-4; 6-2,R64,84,6,3,38,69,30,38,16,31,4,4,9,46,69,4,1,36,60,22,36,13,24,1,4,9,35,60
2014-08-17 00:00:00.000,Winston-Salem NC; U.S.A. ATP World Tour 250,HARD,2,Lukas Rosol,N/A Bye,Lukas Rosol,,R64,0,0,0,0,0,0,0,0,0,0,0,0,0,0,0,0,0,0,0,0,0,0,0,0,0,0,0
2014-08-17 00:00:00.000,Winston-Salem NC; U.S.A. ATP World Tour 250,HARD,2,Tommy Robredo,N/A Bye,Tommy Robredo,,R64,0,0,0,0,0,0,0,0,0,0,0,0,0,0,0,0,0,0,0,0,0,0,0,0,0,0,0
2014-08-17 00:00:00.000,Winston-Salem NC; U.S.A. ATP World Tour 250,HARD,2,Nicolas Mahut,Blaz Kavcic,Nicolas Mahut,6-3; 6-2,R64,73,5,4,27,48,21,27,11,21,1,2,8,32,48,2,7,46,73,26,46,10,27,3,8,9,36,73
2014-08-17 00:00:00.000,Winston-Salem NC; U.S.A. ATP World Tour 250,HARD,2,Federico Delbonis,Martin Klizan,Federico Delbonis,7-6(5); 6-4,R64,95,9,3,41,70,31,41,16,29,3,5,11,47,70,6,9,38,73,29,38,14,35,3,6,11,43,73
2014-08-17 00:00:00.000,Winston-Salem NC; U.S.A. ATP World Tour 250,HARD,2,Andreas Seppi,N/A Bye,Andreas Seppi,,R64,0,0,0,0,0,0,0,0,0,0,0,0,0,0,0,0,0,0,0,0,0,0,0,0,0,0,0
2014-08-17 00:00:00.000,Winston-Salem NC; U.S.A. ATP World Tour 250,HARD,2,Yen-Hsun Lu,N/A Bye,Yen-Hsun Lu,,R64,0,0,0,0,0,0,0,0,0,0,0,0,0,0,0,0,0,0,0,0,0,0,0,0,0,0,0
2014-08-17 00:00:00.000,Winston-Salem NC; U.S.A. ATP World Tour 250,HARD,2,Blaz Rola,Wayne Odesnik,Blaz Rola,7-6(4); 6-3,R64,102,4,3,42,64,34,42,11,22,3,4,10,45,64,5,3,43,76,25,43,22,33,8,11,11,47,76
2014-08-17 00:00:00.000,Winston-Salem NC; U.S.A. ATP World Tour 250,HARD,2,Paul-Henri Mathieu,Robby Ginepri,Paul-Henri Mathieu,6-3; 7-5,R64,76,9,4,32,59,27,32,16,27,1,2,11,43,59,4,3,38,60,22,38,12,22,1,4,10,34,60
2014-08-17 00:00:00.000,Winston-Salem NC; U.S.A. ATP World Tour 250,HARD,2,Marcel Granollers,N/A Bye,Marcel Granollers,,R64,0,0,0,0,0,0,0,0,0,0,0,0,0,0,0,0,0,0,0,0,0,0,0,0,0,0,0
2014-08-17 00:00:00.000,Winston-Salem NC; U.S.A. ATP World Tour 250,HARD,2,Joao Sousa,N/A Bye,Joao Sousa,,R64,0,0,0,0,0,0,0,0,0,0,0,0,0,0,0,0,0,0,0,0,0,0,0,0,0,0,0
2014-08-17 00:00:00.000,Winston-Salem NC; U.S.A. ATP World Tour 250,HARD,2,Jerzy Janowicz,Carlos Berlocq,Jerzy Janowicz,6-1; 6-4,R64,90,7,3,31,59,27,31,16,28,5,5,9,43,59,6,4,40,67,29,40,8,27,8,11,8,37,67
2014-08-17 00:00:00.000,Winston-Salem NC; U.S.A. ATP World Tour 250,HARD,2,Aleksandr Nedovyesov,Marcos Giron,Aleksandr Nedovyesov,6-4; 6-4,R64,98,4,2,45,70,33,45,13,25,6,7,10,46,70,1,9,51,80,33,51,11,29,6,9,10,44,80
2014-08-17 00:00:00.000,Winston-Salem NC; U.S.A. ATP World Tour 250,HARD,2,Edouard Roger-Vasselin,N/A Bye,Edouard Roger-Vasselin,,R64,0,0,0,0,0,0,0,0,0,0,0,0,0,0,0,0,0,0,0,0,0,0,0,0,0,0,0
2014-08-17 00:00:00.000,Winston-Salem NC; U.S.A. ATP World Tour 250,HARD,2,Jarkko Nieminen,N/A Bye,Jarkko Nieminen,,R64,0,0,0,0,0,0,0,0,0,0,0,0,0,0,0,0,0,0,0,0,0,0,0,0,0,0,0
2014-08-17 00:00:00.000,Winston-Salem NC; U.S.A. ATP World Tour 250,HARD,2,Benjamin Becker,Pablo Carreno Busta,Benjamin Becker,6-2; 2-6; 6-1,R64,85,9,4,37,69,32,37,13,32,5,7,12,45,69,2,3,45,73,28,45,13,28,4,8,11,41,73
2014-08-17 00:00:00.000,Winston-Salem NC; U.S.A. ATP World Tour 250,HARD,2,David Goffin,Jurgen Melzer,David Goffin,6-3; 6-4,R64,80,8,2,39,68,29,39,19,29,6,6,10,48,68,2,1,27,52,19,27,16,25,1,3,9,35,52
2014-08-17 00:00:00.000,Winston-Salem NC; U.S.A. ATP World Tour 250,HARD,2,Leonardo Mayer,N/A Bye,Leonardo Mayer,,R64,0,0,0,0,0,0,0,0,0,0,0,0,0,0,0,0,0,0,0,0,0,0,0,0,0,0,0
2014-08-17 00:00:00.000,Winston-Salem NC; U.S.A. ATP World Tour 250,HARD,2,Guillermo Garcia-Lopez,N/A Bye,Guillermo Garcia-Lopez,,R64,0,0,0,0,0,0,0,0,0,0,0,0,0,0,0,0,0,0,0,0,0,0,0,0,0,0,0
2014-08-17 00:00:00.000,Winston-Salem NC; U.S.A. ATP World Tour 250,HARD,2,Dustin Brown,Alejandro Gonzalez,Dustin Brown,6-3; 6-2,R64,49,10,1,31,50,28,31,8,19,2,3,9,36,50,1,4,28,51,18,28,9,23,6,10,8,27,51
2014-08-17 00:00:00.000,Winston-Salem NC; U.S.A. ATP World Tour 250,HARD,2,Frank Dancevic,Thomaz Bellucci,Frank Dancevic,7-5; 3-6; 6-2,R64,126,8,5,55,96,43,55,14,41,6,10,15,57,96,7,4,36,77,26,36,20,41,2,7,14,46,77
2014-08-17 00:00:00.000,Winston-Salem NC; U.S.A. ATP World Tour 250,HARD,2,Donald Young,N/A Bye,Donald Young,,R64,0,0,0,0,0,0,0,0,0,0,0,0,0,0,0,0,0,0,0,0,0,0,0,0,0,0,0
2014-08-17 00:00:00.000,Winston-Salem NC; U.S.A. ATP World Tour 250,HARD,2,Steve Johnson,N/A Bye,Steve Johnson,,R64,0,0,0,0,0,0,0,0,0,0,0,0,0,0,0,0,0,0,0,0,0,0,0,0,0,0,0
2014-08-17 00:00:00.000,Winston-Salem NC; U.S.A. ATP World Tour 250,HARD,2,Sam Querrey,Pere Riba,Sam Querrey,7-6(5); 6-4,R64,79,16,1,36,63,28,36,21,27,1,1,11,49,63,9,3,38,77,27,38,23,39,2,3,11,50,77
2014-08-17 00:00:00.000,Winston-Salem NC; U.S.A. ATP World Tour 250,HARD,2,Adrian Mannarino,Damir Dzumhur,Adrian Mannarino,6-2; 6-2,R64,62,2,1,29,42,20,29,8,13,0,2,8,28,42,1,4,26,42,9,26,6,16,0,6,8,15,42
2014-08-17 00:00:00.000,Winston-Salem NC; U.S.A. ATP World Tour 250,HARD,2,Kevin Anderson,N/A Bye,Kevin Anderson,,R64,0,0,0,0,0,0,0,0,0,0,0,0,0,0,0,0,0,0,0,0,0,0,0,0,0,0,0
2014-08-17 00:00:00.000,Winston-Salem NC; U.S.A. ATP World Tour 250,HARD,2,John Isner,Bradley Klahn,John Isner,7-6(5); 6-2,R32,69,13,2,44,64,37,44,11,20,2,2,10,48,64,7,3,32,56,25,32,13,24,1,3,10,38,56
2014-08-17 00:00:00.000,Winston-Salem NC; U.S.A. ATP World Tour 250,HARD,2,Mikhail Kukushkin,Robin Haase,Mikhail Kukushkin,5-7; 7-6(2); 6-4,R32,132,9,0,51,98,44,51,27,47,2,4,17,71,98,8,2,55,103,44,55,24,48,6,8,17,68,103
2014-08-17 00:00:00.000,Winston-Salem NC; U.S.A. ATP World Tour 250,HARD,2,Pablo Andujar,Igor Sijsling,Pablo Andujar,6-4; 6-3,R32,80,0,3,41,62,29,41,11,21,6,7,9,40,62,4,5,31,65,23,31,13,34,5,9,10,36,65
2014-08-17 00:00:00.000,Winston-Salem NC; U.S.A. ATP World Tour 250,HARD,2,Lukas Rosol,Ryan Harrison,Lukas Rosol,3-6; 2-1 RET,R32,44,7,1,24,34,16,24,2,10,3,5,6,18,34,3,5,23,42,18,23,7,19,1,2,6,25,42
2014-08-17 00:00:00.000,Winston-Salem NC; U.S.A. ATP World Tour 250,HARD,2,Nicolas Mahut,Tommy Robredo,Nicolas Mahut,6-1; 7-6(0),R32,81,6,4,36,57,29,36,11,21,3,4,9,40,57,2,2,54,71,33,54,3,17,4,8,10,36,71
2014-08-17 00:00:00.000,Winston-Salem NC; U.S.A. ATP World Tour 250,HARD,2,Andreas Seppi,Federico Delbonis,Andreas Seppi,7-5; 6-7(4); 6-2,R32,147,8,3,61,111,43,61,27,50,9,12,16,70,111,4,7,59,112,38,59,25,53,9,15,16,63,112
2014-08-17 00:00:00.000,Winston-Salem NC; U.S.A. ATP World Tour 250,HARD,2,Yen-Hsun Lu,Blaz Rola,Yen-Hsun Lu,6-4; 7-5,R32,87,7,1,29,54,26,29,19,25,1,1,11,45,54,10,7,44,75,34,44,15,31,6,8,11,49,75
2014-08-17 00:00:00.000,Winston-Salem NC; U.S.A. ATP World Tour 250,HARD,2,Marcel Granollers,Paul-Henri Mathieu,Marcel Granollers,6-3; 6-3,R32,72,14,5,34,56,28,34,10,22,6,7,9,38,56,0,4,21,56,12,21,18,35,3,7,9,30,56
2014-08-17 00:00:00.000,Winston-Salem NC; U.S.A. ATP World Tour 250,HARD,2,Jerzy Janowicz,Joao Sousa,Jerzy Janowicz,6-1; 3-6; 7-6(5),R32,123,7,10,47,92,37,47,24,45,4,7,14,61,92,0,5,53,87,37,53,17,34,3,7,14,54,87
2014-08-17 00:00:00.000,Winston-Salem NC; U.S.A. ATP World Tour 250,HARD,2,Edouard Roger-Vasselin,Aleksandr Nedovyesov,Edouard Roger-Vasselin,7-6(9); 6-7(5); 6-4,R32,163,6,4,76,120,55,76,25,44,6,8,17,80,120,15,1,83,123,58,83,20,40,8,11,17,78,123
2014-08-17 00:00:00.000,Winston-Salem NC; U.S.A. ATP World Tour 250,HARD,2,Jarkko Nieminen,Benjamin Becker,Jarkko Nieminen,7-5; 6-4,R32,79,2,5,30,62,22,30,19,32,0,2,11,41,62,3,7,33,77,26,33,17,44,7,11,11,43,77
2014-08-17 00:00:00.000,Winston-Salem NC; U.S.A. ATP World Tour 250,HARD,2,David Goffin,Leonardo Mayer,David Goffin,6-3; 6-1,R32,59,5,1,22,40,21,22,11,18,0,0,8,32,40,3,5,30,57,15,30,13,27,3,7,8,28,57
2014-08-17 00:00:00.000,Winston-Salem NC; U.S.A. ATP World Tour 250,HARD,2,Guillermo Garcia-Lopez,Dustin Brown,Guillermo Garcia-Lopez,6-7(5); 6-2; 6-2,R32,103,4,5,49,90,38,49,25,41,4,4,14,63,90,11,8,47,88,33,47,19,41,7,11,14,52,88
2014-08-17 00:00:00.000,Winston-Salem NC; U.S.A. ATP World Tour 250,HARD,2,Donald Young,Frank Dancevic,Donald Young,6-1; 6-3,R32,47,1,1,26,39,18,26,11,13,1,2,8,29,39,4,13,32,59,17,32,10,27,4,9,8,27,59
2014-08-17 00:00:00.000,Winston-Salem NC; U.S.A. ATP World Tour 250,HARD,2,Sam Querrey,Steve Johnson,Sam Querrey,6-4; 6-3,R32,65,19,4,37,62,28,37,15,25,3,4,10,43,62,6,2,35,60,27,35,7,25,1,4,9,34,60
2014-08-17 00:00:00.000,Winston-Salem NC; U.S.A. ATP World Tour 250,HARD,2,Kevin Anderson,Adrian Mannarino,Kevin Anderson,6-3; 2-6; 6-4,R32,114,17,1,60,88,43,60,16,28,6,8,14,59,88,3,2,36,63,25,36,21,27,0,2,13,46,63
2014-08-17 00:00:00.000,Winston-Salem NC; U.S.A. ATP World Tour 250,HARD,2,John Isner,Mikhail Kukushkin,John Isner,6-1; 7-6(3),R16,69,17,1,36,54,31,36,14,18,0,0,10,45,54,1,3,44,58,30,44,5,14,4,6,9,35,58
2014-08-17 00:00:00.000,Winston-Salem NC; U.S.A. ATP World Tour 250,HARD,2,Lukas Rosol,Pablo Andujar,Lukas Rosol,1-6; 6-2; 6-2,R16,82,4,2,41,78,29,41,18,37,4,7,12,47,78,0,4,30,54,20,30,13,24,2,6,11,33,54
2014-08-17 00:00:00.000,Winston-Salem NC; U.S.A. ATP World Tour 250,HARD,2,Andreas Seppi,Nicolas Mahut,Andreas Seppi,6-4; 7-6(7),R16,98,7,5,41,71,35,41,16,30,3,4,11,51,71,5,2,37,69,27,37,19,32,1,3,11,46,69
2014-08-17 00:00:00.000,Winston-Salem NC; U.S.A. ATP World Tour 250,HARD,2,Yen-Hsun Lu,Marcel Granollers,Yen-Hsun Lu,6-1; 6-2,R16,65,1,3,19,41,17,19,15,22,0,0,8,32,41,3,3,39,58,22,39,8,19,5,9,7,30,58
2014-08-17 00:00:00.000,Winston-Salem NC; U.S.A. ATP World Tour 250,HARD,2,Jerzy Janowicz,Edouard Roger-Vasselin,Jerzy Janowicz,4-6; 6-3; 6-4,R16,129,5,9,52,97,37,52,25,45,2,4,15,62,97,8,3,50,80,37,50,16,30,1,4,14,53,80
2014-08-17 00:00:00.000,Winston-Salem NC; U.S.A. ATP World Tour 250,HARD,2,David Goffin,Jarkko Nieminen,David Goffin,6-4; 4-6; 6-4,R16,104,6,7,46,81,36,46,19,35,0,2,15,55,81,6,2,47,83,37,47,16,36,0,3,15,53,83
2014-08-17 00:00:00.000,Winston-Salem NC; U.S.A. ATP World Tour 250,HARD,2,Guillermo Garcia-Lopez,Donald Young,Guillermo Garcia-Lopez,6-7(4); 6-3; 7-6(6),R16,167,10,4,63,129,47,63,39,66,7,9,17,86,129,2,2,58,103,38,58,30,45,3,6,16,68,103
2014-08-17 00:00:00.000,Winston-Salem NC; U.S.A. ATP World Tour 250,HARD,2,Sam Querrey,Kevin Anderson,Sam Querrey,7-6(4); 6-4,R16,90,9,0,46,67,40,46,11,21,2,2,11,51,67,10,2,43,76,33,43,19,33,4,5,11,52,76
2014-08-17 00:00:00.000,Winston-Salem NC; U.S.A. ATP World Tour 250,HARD,2,Lukas Rosol,John Isner,Lukas Rosol,W/O,Q,0,0,0,0,0,0,0,0,0,0,0,0,0,0,0,0,0,0,0,0,0,0,0,0,0,0,0
2014-08-17 00:00:00.000,Winston-Salem NC; U.S.A. ATP World Tour 250,HARD,2,Yen-Hsun Lu,Andreas Seppi,Yen-Hsun Lu,6-4; 6-4,Q,82,7,2,39,70,31,39,18,31,5,5,10,49,70,4,1,33,64,27,33,15,31,3,5,10,42,64
2014-08-17 00:00:00.000,Winston-Salem NC; U.S.A. ATP World Tour 250,HARD,2,Jerzy Janowicz,David Goffin,Jerzy Janowicz,6-4; 6-2,Q,78,6,0,31,57,22,31,15,26,0,1,9,37,57,1,1,29,50,19,29,8,21,3,7,9,27,50
2014-08-17 00:00:00.000,Winston-Salem NC; U.S.A. ATP World Tour 250,HARD,2,Sam Querrey,Guillermo Garcia-Lopez,Sam Querrey,6-7(3); 6-2; 6-4,Q,121,22,5,54,86,46,54,18,32,3,3,15,64,86,6,6,50,93,35,50,25,43,2,5,15,60,93
2014-08-17 00:00:00.000,Winston-Salem NC; U.S.A. ATP World Tour 250,HARD,2,Lukas Rosol,Yen-Hsun Lu,Lukas Rosol,7-5; 4-6; 6-4,S,124,8,4,58,105,38,58,27,47,6,9,16,65,105,11,4,49,97,38,49,23,48,7,11,16,61,97
2014-08-17 00:00:00.000,Winston-Salem NC; U.S.A. ATP World Tour 250,HARD,2,Jerzy Janowicz,Sam Querrey,Jerzy Janowicz,4-6; 7-5; 6-4,S,138,7,6,67,103,52,67,14,36,16,20,16,66,103,18,6,55,104,39,55,23,49,9,14,16,62,104
2014-08-17 00:00:00.000,Winston-Salem NC; U.S.A. ATP World Tour 250,HARD,2,Lukas Rosol,Jerzy Janowicz,Lukas Rosol,3-6; 7-6(3); 7-5,F,131,13,4,69,117,51,69,25,48,8,10,16,76,117,11,3,58,89,48,58,19,31,3,5,17,67,89
2014-08-25 00:00:00.000,US Open NY; U.S.A. Grand Slams,HARD,3,Novak Djokovic,Diego Schwartzman,Novak Djokovic,6-1; 6-2; 6-4,R128,97,7,3,47,76,36,47,18,29,4,6,13,54,76,1,3,35,70,21,35,12,35,5,12,12,33,70
2014-08-25 00:00:00.000,US Open NY; U.S.A. Grand Slams,HARD,3,Paul-Henri Mathieu,Gilles Muller,Paul-Henri Mathieu,6-7(7); 7-5; 7-6(6); 6-7(5); 6-1,R128,258,19,8,106,186,81,106,49,80,12,14,28,130,186,38,11,102,182,82,102,38,80,5,10,27,120,182
2014-08-25 00:00:00.000,US Open NY; U.S.A. Grand Slams,HARD,3,Sam Querrey,Maximo Gonzalez,Sam Querrey,6-2; 4-6; 6-4; 4-6; 6-3,R128,173,30,5,82,140,67,82,30,58,8,11,24,97,140,2,6,79,138,54,79,34,59,5,10,23,88,138
2014-08-25 00:00:00.000,US Open NY; U.S.A. Grand Slams,HARD,3,Guillermo Garcia-Lopez,Yen-Hsun Lu,Guillermo Garcia-Lopez,6-4; 6-2; 6-2,R128,113,10,5,42,82,34,42,22,40,2,3,13,56,82,3,7,48,87,31,48,14,39,5,11,13,45,87
2014-08-25 00:00:00.000,US Open NY; U.S.A. Grand Slams,HARD,3,Philipp Kohlschreiber,Facundo Bagnis,Philipp Kohlschreiber,6-2; 7-6(3); 6-3,R128,98,16,7,40,81,36,40,26,41,1,2,15,62,81,5,9,44,87,33,44,19,43,2,6,14,52,87
2014-08-25 00:00:00.000,US Open NY; U.S.A. Grand Slams,HARD,3,Michael Llodra,Daniel Gimeno-Traver,Michael Llodra,6-4; 6-3; 7-5,R128,108,5,0,71,93,50,71,12,22,3,5,16,62,93,6,3,47,87,31,47,19,40,4,9,15,50,87
2014-08-25 00:00:00.000,US Open NY; U.S.A. Grand Slams,HARD,3,Jan-Lennard Struff,Mikhail Kukushkin,Jan-Lennard Struff,2-6; 3-6; 6-3; 6-3; 7-5,R128,193,14,6,96,164,74,96,29,68,14,19,24,103,164,13,4,84,137,66,84,23,53,5,10,23,89,137
2014-08-25 00:00:00.000,US Open NY; U.S.A. Grand Slams,HARD,3,John Isner,Marcos Giron,John Isner,7-6(5); 6-2; 7-6(2),R128,120,26,0,59,85,51,59,22,26,0,0,16,73,85,6,9,88,123,65,88,12,35,12,14,16,77,123
2014-08-25 00:00:00.000,US Open NY; U.S.A. Grand Slams,HARD,3,Jo-Wilfried Tsonga,Juan Monaco,Jo-Wilfried Tsonga,6-3; 4-6; 7-6(2); 6-1,R128,165,21,5,72,131,54,72,34,59,11,13,20,88,131,6,5,84,116,54,84,18,32,4,8,18,72,116
2014-08-25 00:00:00.000,US Open NY; U.S.A. Grand Slams,HARD,3,Aleksandr Nedovyesov,James McGee,Aleksandr Nedovyesov,4-6; 6-2; 6-1; 7-6(3),R128,164,16,3,83,124,61,83,21,41,2,4,19,82,124,4,9,77,139,51,77,28,62,11,16,18,79,139
2014-08-25 00:00:00.000,US Open NY; U.S.A. Grand Slams,HARD,3,Pablo Carreno Busta,Andreas Beck,Pablo Carreno Busta,6-3; 4-6; 6-2; 7-6(0),R128,157,9,6,69,114,49,69,25,45,2,7,20,74,114,3,9,63,127,36,63,32,64,8,15,19,68,127
2014-08-25 00:00:00.000,US Open NY; U.S.A. Grand Slams,HARD,3,Benoit Paire,Julien Benneteau,Benoit Paire,7-6(4); 5-7; 6-4; 4-6; 6-4,R128,244,14,15,86,168,64,86,29,82,11,20,27,93,168,6,9,133,205,88,133,27,72,21,30,27,115,205
2014-08-25 00:00:00.000,US Open NY; U.S.A. Grand Slams,HARD,3,Fernando Verdasco,Blaz Rola,Fernando Verdasco,6-3; 3-6; 7-5; 1-6; 6-4,R128,197,9,11,95,141,63,95,22,46,11,18,23,85,141,5,6,103,162,67,103,28,59,10,17,24,95,162
2014-08-25 00:00:00.000,US Open NY; U.S.A. Grand Slams,HARD,3,Andrey Kuznetsov,Bradley Klahn,Andrey Kuznetsov,6-4; 4-6; 6-3; 7-5,R128,154,5,1,80,130,52,80,29,50,8,13,20,81,130,8,6,79,132,47,79,27,53,10,18,21,74,132
2014-08-25 00:00:00.000,US Open NY; U.S.A. Grand Slams,HARD,3,Matthias Bachinger,Radek Stepanek,Matthias Bachinger,6-3; 6-2; 6-2,R128,90,7,2,44,68,36,44,16,24,0,0,13,52,68,0,4,36,75,24,36,19,39,4,9,12,43,75
2014-08-25 00:00:00.000,US Open NY; U.S.A. Grand Slams,HARD,3,Andy Murray,Robin Haase,Andy Murray,6-3; 7-6(6); 1-6; 7-5,R128,188,8,9,96,157,58,96,31,61,12,19,21,89,157,16,6,81,134,55,81,23,53,7,13,19,78,134
2014-08-25 00:00:00.000,US Open NY; U.S.A. Grand Slams,HARD,3,Stan Wawrinka,Jiri Vesely,Stan Wawrinka,6-2; 7-6(6); 7-6(3),R128,135,9,7,47,100,38,47,31,53,2,4,16,69,100,5,6,69,109,46,69,22,40,8,12,16,68,109
2014-08-25 00:00:00.000,US Open NY; U.S.A. Grand Slams,HARD,3,Thomaz Bellucci,Nicolas Mahut,Thomaz Bellucci,7-6(4); 6-4; 6-1,R128,122,11,6,54,94,44,54,24,40,7,7,15,68,94,6,4,52,93,39,52,18,41,7,10,14,57,93
2014-08-25 00:00:00.000,US Open NY; U.S.A. Grand Slams,HARD,3,Blaz Kavcic,Donald Young,Blaz Kavcic,7-5; 6-4; 6-4,R128,133,7,3,73,100,56,73,10,27,6,9,16,66,100,4,5,60,101,41,60,17,41,13,19,16,58,101
2014-08-25 00:00:00.000,US Open NY; U.S.A. Grand Slams,HARD,3,Jeremy Chardy,Alejandro Falla,Jeremy Chardy,6-7(5); 6-2; 7-5; 6-4,R128,178,10,10,83,149,57,83,33,66,5,10,21,90,149,11,18,70,146,47,70,33,76,11,20,21,80,146
2014-08-25 00:00:00.000,US Open NY; U.S.A. Grand Slams,HARD,3,Nick Kyrgios,Mikhail Youzhny,Nick Kyrgios,7-5; 7-6(4); 2-6; 7-6(1),R128,183,26,8,102,150,73,102,24,48,4,8,22,97,150,6,8,114,160,78,114,23,46,11,14,21,101,160
2014-08-25 00:00:00.000,US Open NY; U.S.A. Grand Slams,HARD,3,Andreas Seppi,Sergiy Stakhovsky,Andreas Seppi,6-3; 6-1; 6-4,R128,115,3,5,66,101,47,66,17,35,16,17,13,64,101,6,5,60,95,36,60,13,35,2,8,13,49,95
2014-08-25 00:00:00.000,US Open NY; U.S.A. Grand Slams,HARD,3,Simone Bolelli,Vasek Pospisil,Simone Bolelli,2-6; 6-4; 6-2; 3-6; 6-3,R128,173,8,5,67,111,57,67,25,44,1,4,22,82,111,12,6,76,137,54,76,31,61,4,8,22,85,137
2014-08-25 00:00:00.000,US Open NY; U.S.A. Grand Slams,HARD,3,Tommy Robredo,Edouard Roger-Vasselin,Tommy Robredo,6-4; 6-3; 6-4,R128,128,3,3,78,105,53,78,15,27,9,10,15,68,105,3,4,56,91,37,56,18,35,7,11,14,55,91
2014-08-25 00:00:00.000,US Open NY; U.S.A. Grand Slams,HARD,3,Kei Nishikori,Wayne Odesnik,Kei Nishikori,6-2; 6-4; 6-2,R128,125,7,7,44,89,34,44,25,45,8,9,13,59,89,4,4,47,94,25,47,24,47,10,16,13,49,94
2014-08-25 00:00:00.000,US Open NY; U.S.A. Grand Slams,HARD,3,Pablo Andujar,Jack Sock,Pablo Andujar,6-4; 3-6; 6-1 RET,R128,101,3,4,43,65,38,43,11,22,1,2,13,49,65,10,5,41,78,29,41,19,37,2,5,13,48,78
2014-08-25 00:00:00.000,US Open NY; U.S.A. Grand Slams,HARD,3,Matthew Ebden,Tobias Kamke,Matthew Ebden,6-4; 6-3; 7-6(2),R128,153,10,9,66,123,53,66,19,57,13,16,16,72,123,0,2,60,94,37,60,16,34,9,14,15,53,94
2014-08-25 00:00:00.000,US Open NY; U.S.A. Grand Slams,HARD,3,Leonardo Mayer,Albert Montanes,Leonardo Mayer,6-2; 3-0 RET,R128,39,8,1,19,28,17,19,7,9,0,0,6,24,28,0,2,20,33,12,20,5,13,2,5,5,17,33
2014-08-25 00:00:00.000,US Open NY; U.S.A. Grand Slams,HARD,3,Borna Coric,Lukas Rosol,Borna Coric,6-4; 6-1; 6-2,R128,111,20,3,53,83,42,53,16,30,5,5,13,58,83,8,3,57,96,35,57,17,39,14,19,12,52,96
2014-08-25 00:00:00.000,US Open NY; U.S.A. Grand Slams,HARD,3,Victor Estrella Burgos,Igor Sijsling,Victor Estrella Burgos,2-6; 6-4; 6-3; 6-2,R128,114,5,4,57,95,42,57,21,38,2,6,18,63,95,6,9,55,98,40,55,17,43,5,11,17,57,98
2014-08-25 00:00:00.000,US Open NY; U.S.A. Grand Slams,HARD,3,Peter Gojowczyk,Benjamin Becker,Peter Gojowczyk,6-2; 6-4; 6-2,R128,86,18,1,44,69,36,44,16,25,3,4,13,52,69,6,2,43,80,23,43,19,37,6,12,13,42,80
2014-08-25 00:00:00.000,US Open NY; U.S.A. Grand Slams,HARD,3,Milos Raonic,Taro Daniel,Milos Raonic,6-3; 6-2; 7-6(1),R128,115,19,4,55,83,49,55,17,28,7,8,15,66,83,1,5,62,92,41,62,13,30,5,9,14,54,92
2014-08-25 00:00:00.000,US Open NY; U.S.A. Grand Slams,HARD,3,Tomas Berdych,Lleyton Hewitt,Tomas Berdych,6-3; 6-4; 6-3,R128,138,10,0,55,94,39,55,22,39,5,7,14,61,94,2,9,48,98,28,48,23,50,13,19,14,51,98
2014-08-25 00:00:00.000,US Open NY; U.S.A. Grand Slams,HARD,3,Martin Klizan,Steve Darcis,Martin Klizan,3-6; 2-6; 7-6(5); 7-5; 6-4,R128,217,12,7,86,161,62,86,38,75,7,13,25,100,161,9,6,103,168,69,103,38,65,11,16,26,107,168
2014-08-25 00:00:00.000,US Open NY; U.S.A. Grand Slams,HARD,3,Alexander Kudryavtsev,Evgeny Donskoy,Alexander Kudryavtsev,2-6; 7-6(6); 3-6; 6-3; 6-4,R128,166,12,6,78,146,59,78,38,68,3,6,24,97,146,11,4,88,153,69,88,36,65,8,10,24,105,153
2014-08-25 00:00:00.000,US Open NY; U.S.A. Grand Slams,HARD,3,Teymuraz Gabashvili,Santiago Giraldo,Teymuraz Gabashvili,6-3; 1-6; 7-6(6); 6-3,R128,179,11,7,63,130,46,63,32,67,8,13,18,78,130,6,5,71,110,50,71,14,39,4,10,19,64,110
2014-08-25 00:00:00.000,US Open NY; U.S.A. Grand Slams,HARD,3,Feliciano Lopez,Ivan Dodig,Feliciano Lopez,1-6; 7-5; 2-6; 6-4; 1-1 RET,R128,169,14,5,67,124,54,67,22,57,10,15,20,76,124,10,7,65,110,50,65,25,45,3,6,20,75,110
2014-08-25 00:00:00.000,US Open NY; U.S.A. Grand Slams,HARD,3,Tatsuma Ito,Steve Johnson,Tatsuma Ito,6-2; 3-6; 5-7; 4-1 RET,R128,148,7,9,82,124,59,82,17,42,12,15,16,76,124,15,5,49,92,43,49,20,43,5,7,15,63,92
2014-08-25 00:00:00.000,US Open NY; U.S.A. Grand Slams,HARD,3,Dominic Thiem,Lukas Lacko,Dominic Thiem,6-3; 6-3; 6-2,R128,86,6,1,34,68,29,34,25,34,3,3,13,54,68,2,3,43,78,30,43,15,35,7,12,13,45,78
2014-08-25 00:00:00.000,US Open NY; U.S.A. Grand Slams,HARD,3,Ernests Gulbis,Kenny De Schepper,Ernests Gulbis,6-1; 6-4; 6-2,R128,94,10,6,44,69,38,44,14,25,1,2,13,52,69,2,10,45,75,26,45,11,30,5,11,12,37,75
2014-08-25 00:00:00.000,US Open NY; U.S.A. Grand Slams,HARD,3,Marin Cilic,Marcos Baghdatis,Marin Cilic,6-3; 3-1 RET,R128,52,3,1,23,34,20,23,9,11,0,0,7,29,34,1,4,17,37,15,17,7,20,0,2,7,22,37
2014-08-25 00:00:00.000,US Open NY; U.S.A. Grand Slams,HARD,3,Illya Marchenko,Marco Chiudinelli,Illya Marchenko,7-6(3); 4-6; 7-6(13); 7-6(4),R128,259,12,9,97,147,68,97,32,50,4,10,23,100,147,11,3,112,179,78,112,31,67,10,15,23,109,179
2014-08-25 00:00:00.000,US Open NY; U.S.A. Grand Slams,HARD,3,Jerzy Janowicz,Dusan Lajovic,Jerzy Janowicz,6-3; 7-5; 5-7; 7-5,R128,179,20,8,78,123,57,78,27,45,2,6,23,84,123,7,4,106,165,65,106,31,59,9,15,22,96,165
2014-08-25 00:00:00.000,US Open NY; U.S.A. Grand Slams,HARD,3,Kevin Anderson,Pablo Cuevas,Kevin Anderson,6-3; 6-7(3); 4-6; 6-2; 7-6(1),R128,242,29,5,121,172,91,121,25,51,14,17,26,116,172,10,9,86,158,68,86,35,72,9,14,25,103,158
2014-08-25 00:00:00.000,US Open NY; U.S.A. Grand Slams,HARD,3,Gilles Simon,Radu Albot,Gilles Simon,6-3; 6-4; 6-2,R128,129,12,1,52,98,39,52,28,46,7,7,14,67,98,3,3,54,83,36,54,10,29,4,8,13,46,83
2014-08-25 00:00:00.000,US Open NY; U.S.A. Grand Slams,HARD,3,Federico Delbonis,Noah Rubin,Federico Delbonis,6-4; 6-3; 6-0,R128,99,12,1,41,66,31,41,15,25,2,4,12,46,66,0,1,41,80,21,41,17,39,7,15,13,38,80
2014-08-25 00:00:00.000,US Open NY; U.S.A. Grand Slams,HARD,3,Bernard Tomic,Dustin Brown,Bernard Tomic,7-6(2); 6-4; 7-6(3),R128,114,21,1,76,116,64,76,22,40,3,3,17,86,116,11,3,75,118,51,75,26,43,8,9,17,77,118
2014-08-25 00:00:00.000,US Open NY; U.S.A. Grand Slams,HARD,3,David Ferrer,Damir Dzumhur,David Ferrer,6-1; 6-2; 2-6; 6-2,R128,134,5,4,59,102,41,59,20,43,6,9,15,61,102,0,4,62,94,34,62,12,32,4,12,16,46,94
2014-08-25 00:00:00.000,US Open NY; U.S.A. Grand Slams,HARD,3,Grigor Dimitrov,Ryan Harrison,Grigor Dimitrov,6-2; 7-6(4); 6-2,R128,124,8,0,42,78,35,42,24,36,1,2,14,59,78,3,6,59,104,36,59,21,45,8,13,14,57,104
2014-08-25 00:00:00.000,US Open NY; U.S.A. Grand Slams,HARD,3,Dudi Sela,Carlos Berlocq,Dudi Sela,1-6; 6-3; 6-2; 7-5,R128,163,5,1,68,109,46,68,27,41,4,7,18,73,109,12,5,67,123,44,67,28,56,7,12,18,72,123
2014-08-25 00:00:00.000,US Open NY; U.S.A. Grand Slams,HARD,3,David Goffin,Niels Desein,David Goffin,6-1; 6-3; 6-3,R128,91,9,2,39,62,33,39,16,23,1,2,13,49,62,5,4,53,84,33,53,10,31,6,12,12,43,84
2014-08-25 00:00:00.000,US Open NY; U.S.A. Grand Slams,HARD,3,Joao Sousa,Frank Dancevic,Joao Sousa,7-6(6); 3-6; 6-2; 4-6; 7-6(2),R128,212,9,7,101,181,72,101,43,80,10,14,25,115,181,13,2,90,166,62,90,44,76,4,8,26,106,166
2014-08-25 00:00:00.000,US Open NY; U.S.A. Grand Slams,HARD,3,Gael Monfils,Jared Donaldson,Gael Monfils,6-4; 6-2; 6-4,R128,121,8,6,49,91,38,49,23,42,5,6,14,61,91,4,3,60,103,35,60,20,43,7,12,14,55,103
2014-08-25 00:00:00.000,US Open NY; U.S.A. Grand Slams,HARD,3,Alejandro Gonzalez,Dmitry Tursunov,Alejandro Gonzalez,6-4; 6-4; 7-5,R128,122,12,2,50,83,44,50,20,33,1,2,16,64,83,6,5,68,116,41,68,26,48,6,10,16,67,116
2014-08-25 00:00:00.000,US Open NY; U.S.A. Grand Slams,HARD,3,Paolo Lorenzi,Yoshihito Nishioka,Paolo Lorenzi,6-1; 6-2; 2-1 RET,R128,86,4,0,22,45,19,22,17,23,0,0,9,36,45,1,5,36,66,21,36,10,30,5,10,9,31,66
2014-08-25 00:00:00.000,US Open NY; U.S.A. Grand Slams,HARD,3,Richard Gasquet,Denis Istomin,Richard Gasquet,7-5; 7-6(5); 6-4,R128,157,9,2,61,99,49,61,22,38,1,3,17,71,99,18,1,72,108,54,72,16,36,8,12,17,70,108
2014-08-25 00:00:00.000,US Open NY; U.S.A. Grand Slams,HARD,3,Fabio Fognini,Andrey Golubev,Fabio Fognini,6-4; 6-4; 6-2,R128,115,6,2,49,88,39,49,23,39,7,8,14,62,88,3,6,51,95,36,51,18,44,9,14,14,54,95
2014-08-25 00:00:00.000,US Open NY; U.S.A. Grand Slams,HARD,3,Adrian Mannarino,Pere Riba,Adrian Mannarino,3-6; 7-5; 6-3; 6-2,R128,172,11,5,71,112,51,71,19,41,2,6,19,70,112,12,10,67,130,42,67,29,63,14,21,19,71,130
2014-08-25 00:00:00.000,US Open NY; U.S.A. Grand Slams,HARD,3,Tim Smyczek,Filip Krajinovic,Tim Smyczek,4-6; 6-3; 6-2; 7-6(5),R128,149,18,2,67,122,51,67,38,55,2,3,20,89,122,8,2,75,117,57,75,22,42,4,7,19,79,117
2014-08-25 00:00:00.000,US Open NY; U.S.A. Grand Slams,HARD,3,Roberto Bautista Agut,Andreas Haider-Maurer,Roberto Bautista Agut,5-7; 7-6(1); 1-6; 7-5; 6-1,R128,232,10,3,95,151,65,95,34,56,8,13,25,99,151,16,13,94,180,60,94,47,86,10,15,25,107,180
2014-08-25 00:00:00.000,US Open NY; U.S.A. Grand Slams,HARD,3,Ivo Karlovic,Jarkko Nieminen,Ivo Karlovic,6-4; 6-4; 3-6; 6-4,R128,131,24,4,62,102,55,62,24,40,3,4,19,79,102,10,6,66,114,55,66,23,48,5,8,20,78,114
2014-08-25 00:00:00.000,US Open NY; U.S.A. Grand Slams,HARD,3,Marcel Granollers,Jurgen Melzer,Marcel Granollers,7-6(1); 6-3; 6-2,R128,134,6,7,57,96,45,57,20,39,6,8,15,65,96,2,0,59,89,34,59,15,30,5,10,14,49,89
2014-08-25 00:00:00.000,US Open NY; U.S.A. Grand Slams,HARD,3,Sam Groth,Albert Ramos-Vinolas,Sam Groth,6-3; 7-6(5); 6-3,R128,122,12,6,52,90,46,52,24,38,0,0,16,70,90,3,3,51,85,37,51,21,34,2,4,14,58,85
2014-08-25 00:00:00.000,US Open NY; U.S.A. Grand Slams,HARD,3,Roger Federer,Marinko Matosevic,Roger Federer,6-3; 6-4; 7-6(4),R128,127,10,1,60,87,53,60,15,27,2,3,16,68,87,4,4,71,120,44,71,26,49,11,14,15,70,120
2014-08-25 00:00:00.000,US Open NY; U.S.A. Grand Slams,HARD,3,Novak Djokovic,Paul-Henri Mathieu,Novak Djokovic,6-1; 6-3; 6-0,R64,88,13,0,43,57,38,43,8,14,1,1,11,46,57,2,9,39,77,23,39,12,38,5,12,11,35,77
2014-08-25 00:00:00.000,US Open NY; U.S.A. Grand Slams,HARD,3,Sam Querrey,Guillermo Garcia-Lopez,Sam Querrey,6-3; 6-4; 6-4,R64,105,16,1,48,81,42,48,22,33,2,2,15,64,81,1,7,49,89,37,49,19,40,4,7,14,56,89
2014-08-25 00:00:00.000,US Open NY; U.S.A. Grand Slams,HARD,3,Philipp Kohlschreiber,Michael Llodra,Philipp Kohlschreiber,6-2 RET,R64,30,4,1,14,24,11,14,6,10,0,0,4,17,24,0,0,17,25,8,17,5,8,0,2,5,13,25
2014-08-25 00:00:00.000,US Open NY; U.S.A. Grand Slams,HARD,3,John Isner,Jan-Lennard Struff,John Isner,7-6(5); 6-4; 6-2,R64,116,29,1,61,84,53,61,15,23,1,1,15,68,84,3,6,62,94,48,62,14,32,3,6,15,62,94
2014-08-25 00:00:00.000,US Open NY; U.S.A. Grand Slams,HARD,3,Jo-Wilfried Tsonga,Aleksandr Nedovyesov,Jo-Wilfried Tsonga,6-3; 6-4; 6-4,R64,107,13,4,54,89,46,54,18,35,7,8,15,64,89,2,2,45,76,30,45,18,31,4,8,14,48,76
2014-08-25 00:00:00.000,US Open NY; U.S.A. Grand Slams,HARD,3,Pablo Carreno Busta,Benoit Paire,Pablo Carreno Busta,6-1; 6-4; 3-6; 6-3,R64,146,5,0,76,109,55,76,17,33,6,9,18,72,109,16,6,74,135,49,74,24,61,11,17,17,73,135
2014-08-25 00:00:00.000,US Open NY; U.S.A. Grand Slams,HARD,3,Andrey Kuznetsov,Fernando Verdasco,Andrey Kuznetsov,6-3; 4-6; 4-6; 7-5; 6-3,R64,192,9,9,100,161,76,100,31,61,8,10,25,107,161,7,8,105,150,82,105,17,45,5,9,25,99,150
2014-08-25 00:00:00.000,US Open NY; U.S.A. Grand Slams,HARD,3,Andy Murray,Matthias Bachinger,Andy Murray,6-3; 6-3; 6-4,R64,106,6,1,48,73,40,48,17,25,3,3,14,57,73,6,3,60,91,38,60,15,31,8,12,14,53,91
2014-08-25 00:00:00.000,US Open NY; U.S.A. Grand Slams,HARD,3,Stan Wawrinka,Thomaz Bellucci,Stan Wawrinka,6-3; 6-4; 3-6; 7-6(1),R64,156,16,1,74,106,63,74,16,32,0,3,20,79,106,9,5,85,137,62,85,22,52,10,14,20,84,137
2014-08-25 00:00:00.000,US Open NY; U.S.A. Grand Slams,HARD,3,Blaz Kavcic,Jeremy Chardy,Blaz Kavcic,6-2; 7-6(6); 6-3,R64,142,8,6,67,104,51,67,18,37,8,10,15,69,104,14,8,62,106,44,62,16,44,10,15,14,60,106
2014-08-25 00:00:00.000,US Open NY; U.S.A. Grand Slams,HARD,3,Nick Kyrgios,Andreas Seppi,Nick Kyrgios,6-4; 7-6(2); 6-4,R64,116,22,3,58,91,49,58,25,33,5,5,16,74,91,10,4,47,95,35,47,29,48,2,4,16,64,95
2014-08-25 00:00:00.000,US Open NY; U.S.A. Grand Slams,HARD,3,Tommy Robredo,Simone Bolelli,Tommy Robredo,5-7; 6-7(5); 6-4; 6-3; 6-2,R64,217,8,2,114,163,91,114,27,49,7,8,26,118,163,11,2,94,149,67,94,37,55,7,11,25,104,149
2014-08-25 00:00:00.000,US Open NY; U.S.A. Grand Slams,HARD,3,Kei Nishikori,Pablo Andujar,Kei Nishikori,6-4; 6-1 RET,R64,63,4,0,29,47,22,29,14,18,0,0,9,36,47,2,2,34,48,23,34,4,14,1,4,8,27,48
2014-08-25 00:00:00.000,US Open NY; U.S.A. Grand Slams,HARD,3,Leonardo Mayer,Matthew Ebden,Leonardo Mayer,6-1; 6-3; 6-4,R64,104,9,4,44,79,33,44,22,35,4,5,13,55,79,3,7,45,80,26,45,14,35,3,9,13,40,80
2014-08-25 00:00:00.000,US Open NY; U.S.A. Grand Slams,HARD,3,Victor Estrella Burgos,Borna Coric,Victor Estrella Burgos,7-6(2); 4-6; 6-4; 6-2,R64,191,8,4,79,127,60,79,25,48,1,4,20,85,127,8,4,70,135,48,70,32,65,7,12,20,80,135
2014-08-25 00:00:00.000,US Open NY; U.S.A. Grand Slams,HARD,3,Milos Raonic,Peter Gojowczyk,Milos Raonic,7-6(4); 5-7; 6-4; 7-6(3),R64,186,26,3,80,134,65,80,31,54,2,5,23,96,134,7,5,87,151,67,87,33,64,7,10,23,100,151
2014-08-25 00:00:00.000,US Open NY; U.S.A. Grand Slams,HARD,3,Tomas Berdych,Martin Klizan,Tomas Berdych,6-3; 4-6; 6-2; 3-6; 6-3,R64,225,10,4,86,150,64,86,38,64,12,14,23,102,150,13,9,83,153,60,83,34,70,8,12,22,94,153
2014-08-25 00:00:00.000,US Open NY; U.S.A. Grand Slams,HARD,3,Teymuraz Gabashvili,Alexander Kudryavtsev,Teymuraz Gabashvili,6-1; 6-4; 7-6(4),R64,120,7,4,69,120,47,69,32,51,8,9,15,79,120,15,1,42,83,32,42,21,41,5,9,14,53,83
2014-08-25 00:00:00.000,US Open NY; U.S.A. Grand Slams,HARD,3,Feliciano Lopez,Tatsuma Ito,Feliciano Lopez,6-4; 3-6; 6-4; 7-6(4),R64,171,19,9,82,135,64,82,28,53,5,7,21,92,135,7,6,77,142,51,77,40,65,8,10,20,91,142
2014-08-25 00:00:00.000,US Open NY; U.S.A. Grand Slams,HARD,3,Dominic Thiem,Ernests Gulbis,Dominic Thiem,4-6; 3-6; 6-4; 6-3; 6-3,R64,225,5,7,81,142,55,81,37,61,4,7,23,92,142,20,10,86,157,65,86,35,71,13,18,24,100,157
2014-08-25 00:00:00.000,US Open NY; U.S.A. Grand Slams,HARD,3,Marin Cilic,Illya Marchenko,Marin Cilic,7-6(2); 6-2; 6-4,R64,167,10,10,59,113,49,59,28,54,5,5,15,77,113,6,5,57,107,36,57,28,50,7,10,15,64,107
2014-08-25 00:00:00.000,US Open NY; U.S.A. Grand Slams,HARD,3,Kevin Anderson,Jerzy Janowicz,Kevin Anderson,6-7(6); 6-2; 6-1; 6-3,R64,147,15,3,64,96,48,64,23,32,0,2,18,71,96,2,11,78,130,46,78,22,52,9,17,18,68,130
2014-08-25 00:00:00.000,US Open NY; U.S.A. Grand Slams,HARD,3,Gilles Simon,Federico Delbonis,Gilles Simon,6-4; 3-6; 7-5; 6-1,R64,171,4,8,57,119,43,57,31,62,7,11,19,74,119,4,2,82,123,49,82,19,41,8,15,19,68,123
2014-08-25 00:00:00.000,US Open NY; U.S.A. Grand Slams,HARD,3,David Ferrer,Bernard Tomic,David Ferrer,W/O,R64,0,0,0,0,0,0,0,0,0,0,0,0,0,0,0,0,0,0,0,0,0,0,0,0,0,0,0
2014-08-25 00:00:00.000,US Open NY; U.S.A. Grand Slams,HARD,3,Grigor Dimitrov,Dudi Sela,Grigor Dimitrov,6-1; 6-2; 6-2,R64,89,7,3,42,67,30,42,18,25,5,6,12,48,67,0,3,36,65,19,36,11,29,10,17,11,30,65
2014-08-25 00:00:00.000,US Open NY; U.S.A. Grand Slams,HARD,3,David Goffin,Joao Sousa,David Goffin,6-4; 6-2; 6-0,R64,104,9,2,53,79,38,53,11,26,7,10,12,49,79,4,2,44,82,26,44,8,38,6,15,12,34,82
2014-08-25 00:00:00.000,US Open NY; U.S.A. Grand Slams,HARD,3,Gael Monfils,Alejandro Gonzalez,Gael Monfils,7-5; 6-3; 6-2,R64,127,8,10,47,96,35,47,26,49,6,8,14,61,96,2,4,57,98,32,57,18,41,10,17,15,50,98
2014-08-25 00:00:00.000,US Open NY; U.S.A. Grand Slams,HARD,3,Richard Gasquet,Paolo Lorenzi,Richard Gasquet,7-6(4); 6-3; 6-3,R64,138,14,2,59,88,46,59,18,29,1,2,15,64,88,11,5,56,106,40,56,21,50,14,18,15,61,106
2014-08-25 00:00:00.000,US Open NY; U.S.A. Grand Slams,HARD,3,Adrian Mannarino,Fabio Fognini,Adrian Mannarino,6-3; 6-4; 6-1,R64,117,12,7,47,86,34,47,20,39,5,8,13,54,86,2,10,54,111,33,54,20,57,14,22,13,53,111
2014-08-25 00:00:00.000,US Open NY; U.S.A. Grand Slams,HARD,3,Roberto Bautista Agut,Tim Smyczek,Roberto Bautista Agut,6-3; 6-2; 6-1,R64,97,7,2,48,68,40,48,11,20,3,3,12,51,68,4,5,49,84,28,49,16,35,6,12,12,44,84
2014-08-25 00:00:00.000,US Open NY; U.S.A. Grand Slams,HARD,3,Marcel Granollers,Ivo Karlovic,Marcel Granollers,7-6(6); 6-7(3); 7-6(5); 3-6; 6-4,R64,231,7,5,110,173,91,110,37,63,5,7,28,128,173,31,7,112,178,87,112,39,66,7,8,27,126,178
2014-08-25 00:00:00.000,US Open NY; U.S.A. Grand Slams,HARD,3,Roger Federer,Sam Groth,Roger Federer,6-4; 6-4; 6-4,R64,108,9,4,49,79,41,49,15,30,0,2,15,56,79,9,8,69,109,41,69,20,40,6,11,15,61,109
2014-08-25 00:00:00.000,US Open NY; U.S.A. Grand Slams,HARD,3,Novak Djokovic,Sam Querrey,Novak Djokovic,6-3; 6-2; 6-2,R32,85,5,1,51,74,38,51,11,23,2,4,13,49,74,7,3,46,72,26,46,6,26,5,12,12,32,72
2014-08-25 00:00:00.000,US Open NY; U.S.A. Grand Slams,HARD,3,Philipp Kohlschreiber,John Isner,Philipp Kohlschreiber,7-6(4); 4-6; 7-6(2); 7-6(4),R32,189,13,5,98,157,77,98,36,59,11,12,23,113,157,44,4,95,141,77,95,30,46,5,5,23,107,141
2014-08-25 00:00:00.000,US Open NY; U.S.A. Grand Slams,HARD,3,Jo-Wilfried Tsonga,Pablo Carreno Busta,Jo-Wilfried Tsonga,6-4; 6-4; 6-4,R32,114,14,2,54,84,44,54,19,30,6,6,15,63,84,3,1,67,98,47,67,17,31,8,11,15,64,98
2014-08-25 00:00:00.000,US Open NY; U.S.A. Grand Slams,HARD,3,Andy Murray,Andrey Kuznetsov,Andy Murray,6-1; 7-5; 4-6; 6-2,R32,155,4,5,66,118,46,66,28,52,6,10,19,74,118,3,3,71,121,44,71,18,50,8,16,18,62,121
2014-08-25 00:00:00.000,US Open NY; U.S.A. Grand Slams,HARD,3,Stan Wawrinka,Blaz Kavcic,Stan Wawrinka,W/O,R32,0,0,0,0,0,0,0,0,0,0,0,0,0,0,0,0,0,0,0,0,0,0,0,0,0,0,0
2014-08-25 00:00:00.000,US Open NY; U.S.A. Grand Slams,HARD,3,Tommy Robredo,Nick Kyrgios,Tommy Robredo,3-6; 6-3; 7-6(4); 6-3,R32,148,4,3,86,117,66,86,16,31,6,9,20,82,117,19,3,74,115,60,74,13,41,2,6,19,73,115
2014-08-25 00:00:00.000,US Open NY; U.S.A. Grand Slams,HARD,3,Kei Nishikori,Leonardo Mayer,Kei Nishikori,6-4; 6-2; 6-3,R32,112,4,2,42,86,29,42,30,44,9,10,13,59,86,9,5,49,82,34,49,11,33,5,11,14,45,82
2014-08-25 00:00:00.000,US Open NY; U.S.A. Grand Slams,HARD,3,Milos Raonic,Victor Estrella Burgos,Milos Raonic,7-6(5); 7-6(5); 7-6(3),R32,163,22,6,60,106,53,60,26,46,2,5,18,79,106,7,5,89,138,55,89,28,49,8,11,18,83,138
2014-08-25 00:00:00.000,US Open NY; U.S.A. Grand Slams,HARD,3,Tomas Berdych,Teymuraz Gabashvili,Tomas Berdych,6-3; 6-2; 6-4,R32,108,14,5,46,82,38,46,21,36,2,2,14,59,82,4,10,50,80,35,50,13,30,3,7,13,48,80
2014-08-25 00:00:00.000,US Open NY; U.S.A. Grand Slams,HARD,3,Dominic Thiem,Feliciano Lopez,Dominic Thiem,6-4; 6-2; 6-3,R32,109,6,6,51,87,40,51,17,36,6,8,14,57,87,5,1,48,80,28,48,16,32,6,12,13,44,80
2014-08-25 00:00:00.000,US Open NY; U.S.A. Grand Slams,HARD,3,Marin Cilic,Kevin Anderson,Marin Cilic,6-3; 3-6; 6-3; 6-4,R32,180,13,8,61,108,50,61,21,47,3,7,19,71,108,12,7,86,139,56,86,22,53,14,20,18,78,139
2014-08-25 00:00:00.000,US Open NY; U.S.A. Grand Slams,HARD,3,Gilles Simon,David Ferrer,Gilles Simon,6-3; 3-6; 6-1; 6-3,R32,168,9,1,61,123,40,61,35,62,8,11,17,75,123,4,4,61,106,40,61,17,45,2,9,17,57,106
2014-08-25 00:00:00.000,US Open NY; U.S.A. Grand Slams,HARD,3,Grigor Dimitrov,David Goffin,Grigor Dimitrov,0-6; 6-3; 6-4; 6-1,R32,141,7,10,47,103,40,47,22,56,11,16,16,62,103,4,6,55,102,35,55,19,47,4,11,16,54,102
2014-08-25 00:00:00.000,US Open NY; U.S.A. Grand Slams,HARD,3,Gael Monfils,Richard Gasquet,Gael Monfils,6-4; 6-2; 6-2,R32,115,11,5,38,65,32,38,16,27,0,1,13,48,65,0,0,54,91,31,54,14,37,3,9,13,45,91
2014-08-25 00:00:00.000,US Open NY; U.S.A. Grand Slams,HARD,3,Roberto Bautista Agut,Adrian Mannarino,Roberto Bautista Agut,7-5; 6-2; 6-3,R32,127,1,2,53,94,39,53,22,41,1,3,15,61,94,9,3,58,87,33,58,16,29,3,9,14,49,87
2014-08-25 00:00:00.000,US Open NY; U.S.A. Grand Slams,HARD,3,Roger Federer,Marcel Granollers,Roger Federer,4-6; 6-1; 6-1; 6-1,R32,118,12,0,58,93,41,58,20,35,6,8,15,61,93,5,3,56,99,30,56,18,43,11,20,16,48,99
2014-08-25 00:00:00.000,US Open NY; U.S.A. Grand Slams,HARD,3,Novak Djokovic,Philipp Kohlschreiber,Novak Djokovic,6-1; 7-5; 6-4,R16,123,6,0,55,85,42,55,21,30,2,2,15,63,85,6,3,44,85,32,44,19,41,5,9,14,51,85
2014-08-25 00:00:00.000,US Open NY; U.S.A. Grand Slams,HARD,3,Andy Murray,Jo-Wilfried Tsonga,Andy Murray,7-5; 7-5; 6-4,R16,155,11,3,49,99,41,49,29,50,3,5,17,70,99,5,6,67,113,43,67,24,46,8,13,17,67,113
2014-08-25 00:00:00.000,US Open NY; U.S.A. Grand Slams,HARD,3,Stan Wawrinka,Tommy Robredo,Stan Wawrinka,7-5; 4-6; 7-6(7); 6-2,R16,181,18,6,73,133,58,73,35,60,6,8,21,93,133,4,2,77,120,53,77,26,43,2,6,21,79,120
2014-08-25 00:00:00.000,US Open NY; U.S.A. Grand Slams,HARD,3,Kei Nishikori,Milos Raonic,Kei Nishikori,4-6; 7-6(4); 6-7(6); 7-5; 6-4,R16,259,8,7,92,164,68,92,48,72,5,9,28,116,164,35,10,106,192,87,106,40,86,14,19,28,127,192
2014-08-25 00:00:00.000,US Open NY; U.S.A. Grand Slams,HARD,3,Tomas Berdych,Dominic Thiem,Tomas Berdych,6-1; 6-2; 6-4,R16,98,9,3,46,81,39,46,20,35,7,7,13,59,81,4,4,39,71,30,39,10,32,4,9,12,40,71
2014-08-25 00:00:00.000,US Open NY; U.S.A. Grand Slams,HARD,3,Marin Cilic,Gilles Simon,Marin Cilic,5-7; 7-6(3); 6-4; 3-6; 6-3,R16,253,22,4,84,157,67,84,42,73,7,10,26,109,157,17,3,102,180,72,102,42,78,10,13,26,114,180
2014-08-25 00:00:00.000,US Open NY; U.S.A. Grand Slams,HARD,3,Gael Monfils,Grigor Dimitrov,Gael Monfils,7-5; 7-6(6); 7-5,R16,144,14,6,73,111,57,73,22,38,6,7,18,79,111,11,4,59,103,43,59,26,44,1,4,18,69,103
2014-08-25 00:00:00.000,US Open NY; U.S.A. Grand Slams,HARD,3,Roger Federer,Roberto Bautista Agut,Roger Federer,6-4; 6-3; 6-2,R16,116,8,5,51,87,39,51,19,36,6,7,13,58,87,2,4,65,102,38,65,15,37,7,13,14,53,102
2014-08-25 00:00:00.000,US Open NY; U.S.A. Grand Slams,HARD,3,Novak Djokovic,Andy Murray,Novak Djokovic,7-6(1); 6-7(1); 6-2; 6-4,Q,212,8,3,96,152,64,96,29,56,12,16,21,93,152,9,4,75,133,48,75,28,58,3,10,21,76,133
2014-08-25 00:00:00.000,US Open NY; U.S.A. Grand Slams,HARD,3,Kei Nishikori,Stan Wawrinka,Kei Nishikori,3-6; 7-5; 7-6(7); 6-7(5); 6-4,Q,255,3,6,108,184,82,108,41,76,8,10,27,123,184,18,8,97,174,81,97,39,77,7,10,28,120,174
2014-08-25 00:00:00.000,US Open NY; U.S.A. Grand Slams,HARD,3,Marin Cilic,Tomas Berdych,Marin Cilic,6-2; 6-4; 7-6(4),Q,132,19,5,57,90,48,57,15,33,2,4,15,63,90,4,5,46,92,33,46,19,46,3,8,15,52,92
2014-08-25 00:00:00.000,US Open NY; U.S.A. Grand Slams,HARD,3,Roger Federer,Gael Monfils,Roger Federer,4-6; 3-6; 6-4; 7-5; 6-2,Q,200,5,2,86,151,65,86,37,65,10,15,25,102,151,6,9,99,157,65,99,29,58,7,13,24,94,157
2014-08-25 00:00:00.000,US Open NY; U.S.A. Grand Slams,HARD,3,Kei Nishikori,Novak Djokovic,Kei Nishikori,6-4; 1-6; 7-6(4); 6-3,S,172,5,4,73,125,49,73,26,52,9,13,18,75,125,15,4,66,112,53,66,17,46,2,7,20,70,112
2014-08-25 00:00:00.000,US Open NY; U.S.A. Grand Slams,HARD,3,Marin Cilic,Roger Federer,Marin Cilic,6-3; 6-4; 6-4,S,105,13,1,45,81,39,45,20,36,1,2,15,59,81,12,1,52,84,36,52,16,32,4,8,14,52,84
2014-08-25 00:00:00.000,US Open NY; U.S.A. Grand Slams,HARD,3,Marin Cilic,Kei Nishikori,Marin Cilic,6-3; 6-3; 6-3,F,114,18,3,45,86,36,45,25,41,8,9,14,61,86,2,1,39,75,22,39,21,36,6,11,13,43,75
2014-09-15 00:00:00.000,Metz France ATP World Tour 250,HARD,2,Jo-Wilfried Tsonga,N/A Bye,Jo-Wilfried Tsonga,,R32,0,0,0,0,0,0,0,0,0,0,0,0,0,0,0,0,0,0,0,0,0,0,0,0,0,0,0
2014-09-15 00:00:00.000,Metz France ATP World Tour 250,HARD,2,Gilles Muller,Edouard Roger-Vasselin,Gilles Muller,6-1; 7-6(6),R32,74,18,2,48,63,39,48,9,15,4,4,10,48,63,6,5,40,60,27,40,11,20,6,8,9,38,60
2014-09-15 00:00:00.000,Metz France ATP World Tour 250,HARD,2,Tobias Kamke,Kenny De Schepper,Tobias Kamke,6-3; 7-6(5),R32,101,4,1,47,74,35,47,13,27,2,4,11,48,74,4,7,42,69,32,42,9,27,3,6,10,41,69
2014-09-15 00:00:00.000,Metz France ATP World Tour 250,HARD,2,David Goffin,Florent Serra,David Goffin,6-2; 6-2,R32,58,7,2,25,48,20,25,15,23,0,0,8,35,48,2,0,29,46,16,29,7,17,3,7,8,23,46
2014-09-15 00:00:00.000,Metz France ATP World Tour 250,HARD,2,Philipp Kohlschreiber,N/A Bye,Philipp Kohlschreiber,,R32,0,0,0,0,0,0,0,0,0,0,0,0,0,0,0,0,0,0,0,0,0,0,0,0,0,0,0
2014-09-15 00:00:00.000,Metz France ATP World Tour 250,HARD,2,Paolo Lorenzi,Laurent Lokoli,Paolo Lorenzi,6-2; 6-4,R32,75,2,2,38,53,32,38,7,15,2,2,9,39,53,2,1,30,54,20,30,10,24,2,5,9,30,54
2014-09-15 00:00:00.000,Metz France ATP World Tour 250,HARD,2,Jan-Lennard Struff,Dusan Lajovic,Jan-Lennard Struff,6-7(6); 6-3; 6-3,R32,120,14,1,57,96,42,57,25,39,3,4,15,67,96,6,0,72,112,49,72,18,40,7,11,15,67,112
2014-09-15 00:00:00.000,Metz France ATP World Tour 250,HARD,2,Jeremy Chardy,Nicolas Mahut,Jeremy Chardy,7-6(5); 7-5,R32,99,8,1,37,64,33,37,17,27,0,1,12,50,64,4,3,44,72,32,44,16,28,1,3,12,48,72
2014-09-15 00:00:00.000,Metz France ATP World Tour 250,HARD,2,Joao Sousa,Ivan Dodig,Joao Sousa,6-2; 6-2,R32,63,4,0,31,46,23,31,11,15,4,4,8,34,46,2,4,18,48,13,18,12,30,1,5,8,25,48
2014-09-15 00:00:00.000,Metz France ATP World Tour 250,HARD,2,Igor Sijsling,Andreas Seppi,Igor Sijsling,6-0; 4-1 RET,R32,40,4,1,10,25,10,10,10,15,0,0,5,20,25,3,3,28,49,13,28,5,21,5,10,6,18,49
2014-09-15 00:00:00.000,Metz France ATP World Tour 250,HARD,2,Paul-Henri Mathieu,Benjamin Becker,Paul-Henri Mathieu,7-6(2); 7-6(3),R32,116,8,3,53,96,47,53,22,43,8,8,12,69,96,7,2,48,84,36,48,23,36,7,7,12,59,84
2014-09-15 00:00:00.000,Metz France ATP World Tour 250,HARD,2,Lukas Rosol,N/A Bye,Lukas Rosol,,R32,0,0,0,0,0,0,0,0,0,0,0,0,0,0,0,0,0,0,0,0,0,0,0,0,0,0,0
2014-09-15 00:00:00.000,Metz France ATP World Tour 250,HARD,2,Jerzy Janowicz,Adrian Mannarino,Jerzy Janowicz,2-6; 7-6(5); 6-4,R32,122,11,3,60,89,49,60,12,29,2,4,15,61,89,14,0,63,95,47,63,20,32,5,6,15,67,95
2014-09-15 00:00:00.000,Metz France ATP World Tour 250,HARD,2,Jarkko Nieminen,Sergiy Stakhovsky,Jarkko Nieminen,6-1; 6-4,R32,64,3,0,35,58,25,35,16,23,4,4,9,41,58,1,1,33,50,22,33,7,17,3,6,8,29,50
2014-09-15 00:00:00.000,Metz France ATP World Tour 250,HARD,2,Michal Przysiezny,Pierre-Hugues Herbert,Michal Przysiezny,6-4; 3-6; 7-6(4),R32,138,6,5,64,102,48,64,20,38,2,4,16,68,102,16,2,56,101,45,56,24,45,3,4,15,69,101
2014-09-15 00:00:00.000,Metz France ATP World Tour 250,HARD,2,Gael Monfils,N/A Bye,Gael Monfils,,R32,0,0,0,0,0,0,0,0,0,0,0,0,0,0,0,0,0,0,0,0,0,0,0,0,0,0,0
2014-09-15 00:00:00.000,Metz France ATP World Tour 250,HARD,2,Jo-Wilfried Tsonga,Gilles Muller,Jo-Wilfried Tsonga,7-6(7); 6-4,R16,100,10,3,50,73,43,50,14,23,5,5,11,57,73,15,2,44,73,37,44,15,29,4,5,11,52,73
2014-09-15 00:00:00.000,Metz France ATP World Tour 250,HARD,2,David Goffin,Tobias Kamke,David Goffin,6-1; 6-3,R16,66,6,0,31,48,27,31,8,17,2,2,8,35,48,0,3,26,50,16,26,9,24,1,5,8,25,50
2014-09-15 00:00:00.000,Metz France ATP World Tour 250,HARD,2,Philipp Kohlschreiber,Paolo Lorenzi,Philipp Kohlschreiber,6-3; 7-5,R16,86,12,5,36,74,27,36,20,38,3,4,11,47,74,5,0,34,58,24,34,12,24,5,8,10,36,58
2014-09-15 00:00:00.000,Metz France ATP World Tour 250,HARD,2,Jan-Lennard Struff,Jeremy Chardy,Jan-Lennard Struff,6-7(5); 6-3; 6-4,R16,117,9,0,63,92,50,63,19,29,0,0,16,69,92,12,3,52,93,42,52,23,41,5,7,15,65,93
2014-09-15 00:00:00.000,Metz France ATP World Tour 250,HARD,2,Joao Sousa,Igor Sijsling,Joao Sousa,6-3; 3-6; 7-6(3),R16,128,6,1,79,123,58,79,20,44,14,16,15,78,123,12,3,53,98,39,53,24,45,1,3,15,63,98
2014-09-15 00:00:00.000,Metz France ATP World Tour 250,HARD,2,Paul-Henri Mathieu,Lukas Rosol,Paul-Henri Mathieu,6-3; 6-4,R16,84,8,1,34,59,28,34,17,25,4,4,10,45,59,9,1,42,74,31,42,14,32,10,12,9,45,74
2014-09-15 00:00:00.000,Metz France ATP World Tour 250,HARD,2,Jerzy Janowicz,Jarkko Nieminen,Jerzy Janowicz,6-4; 6-4,R16,70,9,2,45,64,35,45,11,19,3,3,10,46,64,6,0,32,49,20,32,13,17,0,2,10,33,49
2014-09-15 00:00:00.000,Metz France ATP World Tour 250,HARD,2,Gael Monfils,Michal Przysiezny,Gael Monfils,7-5; 6-1,R16,73,5,4,27,49,24,27,10,22,2,3,9,34,49,3,4,45,69,27,45,7,24,4,9,10,34,69
2014-09-15 00:00:00.000,Metz France ATP World Tour 250,HARD,2,David Goffin,Jo-Wilfried Tsonga,David Goffin,1-6; 7-6(5); 7-5,Q,129,7,1,43,82,30,43,27,39,1,4,15,57,82,17,5,62,103,49,62,23,41,6,8,16,72,103
2014-09-15 00:00:00.000,Metz France ATP World Tour 250,HARD,2,Jan-Lennard Struff,Philipp Kohlschreiber,Jan-Lennard Struff,5-0 RET,Q,21,1,0,5,11,4,5,4,6,0,0,2,8,11,0,3,4,15,1,4,2,11,0,3,3,3,15
2014-09-15 00:00:00.000,Metz France ATP World Tour 250,HARD,2,Joao Sousa,Paul-Henri Mathieu,Joao Sousa,3-6; 6-3; 7-6(4),Q,126,4,0,60,89,43,60,19,29,6,9,15,62,89,9,3,61,98,43,61,19,37,7,10,15,62,98
2014-09-15 00:00:00.000,Metz France ATP World Tour 250,HARD,2,Gael Monfils,Jerzy Janowicz,Gael Monfils,6-3; 6-4,Q,64,12,5,35,53,33,35,8,18,0,0,10,41,53,1,3,33,53,23,33,10,20,4,6,9,33,53
2014-09-15 00:00:00.000,Metz France ATP World Tour 250,HARD,2,David Goffin,Jan-Lennard Struff,David Goffin,7-6(4); 6-3,S,93,14,3,49,79,42,49,12,30,5,6,11,54,79,12,2,43,69,32,43,11,26,2,4,10,43,69
2014-09-15 00:00:00.000,Metz France ATP World Tour 250,HARD,2,Joao Sousa,Gael Monfils,Joao Sousa,7-6(6); 6-2,S,88,3,1,58,77,41,58,9,19,8,9,10,50,77,13,2,34,63,26,34,13,29,2,5,10,39,63
2014-09-15 00:00:00.000,Metz France ATP World Tour 250,HARD,2,David Goffin,Joao Sousa,David Goffin,6-4; 6-3,F,74,10,2,33,51,27,33,12,18,4,4,9,39,51,2,0,37,60,23,37,13,23,6,9,10,36,60
2014-09-22 00:00:00.000,Kuala Lumpur Malaysia ATP World Tour 250,HARD,2,Kei Nishikori,N/A Bye,Kei Nishikori,,R32,0,0,0,0,0,0,0,0,0,0,0,0,0,0,0,0,0,0,0,0,0,0,0,0,0,0,0
2014-09-22 00:00:00.000,Kuala Lumpur Malaysia ATP World Tour 250,HARD,2,Rajeev Ram,Omar Jasika,Rajeev Ram,4-6; 7-5; 6-3,R32,106,12,2,46,80,35,46,19,34,3,6,15,54,80,3,3,60,91,37,60,15,31,3,8,16,52,91
2014-09-22 00:00:00.000,Kuala Lumpur Malaysia ATP World Tour 250,HARD,2,Go Soeda,Kento Takeuchi,Go Soeda,6-2; 6-1,R32,61,0,1,22,42,17,22,10,20,1,3,8,27,42,0,2,18,43,7,18,8,25,2,8,7,15,43
2014-09-22 00:00:00.000,Kuala Lumpur Malaysia ATP World Tour 250,HARD,2,Marinko Matosevic,Nick Kyrgios,Marinko Matosevic,7-6(4); 7-6(3),R32,93,7,4,46,75,36,46,18,29,0,1,12,54,75,11,4,50,86,41,50,16,36,6,7,12,57,86
2014-09-22 00:00:00.000,Kuala Lumpur Malaysia ATP World Tour 250,HARD,2,Leonardo Mayer,N/A Bye,Leonardo Mayer,,R32,0,0,0,0,0,0,0,0,0,0,0,0,0,0,0,0,0,0,0,0,0,0,0,0,0,0,0
2014-09-22 00:00:00.000,Kuala Lumpur Malaysia ATP World Tour 250,HARD,2,Jarkko Nieminen,Philipp Oswald,Jarkko Nieminen,6-1; 6-2,R32,49,1,0,27,40,24,27,9,13,3,3,8,33,40,3,4,20,38,11,20,8,18,1,5,7,19,38
2014-09-22 00:00:00.000,Kuala Lumpur Malaysia ATP World Tour 250,HARD,2,Michal Przysiezny,Malek Jaziri,Michal Przysiezny,4-6; 6-4; 6-2,R32,106,19,4,53,79,46,53,13,26,4,5,14,59,79,9,3,43,94,30,43,28,51,8,11,14,58,94
2014-09-22 00:00:00.000,Kuala Lumpur Malaysia ATP World Tour 250,HARD,2,Pablo Andujar,Gregoire Burquier,Pablo Andujar,6-2; 6-4,R32,74,4,0,30,48,20,30,11,18,0,2,9,31,48,6,2,49,65,27,49,5,16,9,14,9,32,65
2014-09-22 00:00:00.000,Kuala Lumpur Malaysia ATP World Tour 250,HARD,2,Pablo Cuevas,Jurgen Melzer,Pablo Cuevas,6-4; 7-6(1),R32,101,8,3,39,73,31,39,19,34,4,5,11,50,73,1,1,54,74,38,54,7,20,6,8,11,45,74
2014-09-22 00:00:00.000,Kuala Lumpur Malaysia ATP World Tour 250,HARD,2,Ivan Dodig,Hiroki Moriya,Ivan Dodig,7-6(6); 6-1,R32,85,5,2,30,54,22,30,14,24,1,3,9,36,54,1,3,40,64,21,40,11,24,0,5,10,32,64
2014-09-22 00:00:00.000,Kuala Lumpur Malaysia ATP World Tour 250,HARD,2,Filip Krajinovic,Taro Daniel,Filip Krajinovic,6-2; 6-4,R32,66,10,0,29,47,25,29,12,18,2,2,9,37,47,2,0,26,46,14,26,14,20,2,5,9,28,46
2014-09-22 00:00:00.000,Kuala Lumpur Malaysia ATP World Tour 250,HARD,2,Julien Benneteau,N/A Bye,Julien Benneteau,,R32,0,0,0,0,0,0,0,0,0,0,0,0,0,0,0,0,0,0,0,0,0,0,0,0,0,0,0
2014-09-22 00:00:00.000,Kuala Lumpur Malaysia ATP World Tour 250,HARD,2,Benjamin Becker,Joao Sousa,Benjamin Becker,7-6(1); 6-2,R32,77,5,1,30,56,26,30,13,26,1,3,10,39,56,2,2,39,63,24,39,10,24,2,6,10,34,63
2014-09-22 00:00:00.000,Kuala Lumpur Malaysia ATP World Tour 250,HARD,2,Pierre-Hugues Herbert,Bernard Tomic,Pierre-Hugues Herbert,6-4; 3-6; 7-6(7),R32,111,9,2,38,92,26,38,34,54,3,6,15,60,92,13,4,70,104,49,70,19,34,3,6,16,68,104
2014-09-22 00:00:00.000,Kuala Lumpur Malaysia ATP World Tour 250,HARD,2,Philipp Petzschner,James Ward,Philipp Petzschner,6-4; 3-6; 7-6(5),R32,126,4,4,55,91,44,55,21,36,4,6,15,65,91,7,2,60,96,45,60,21,36,4,6,16,66,96
2014-09-22 00:00:00.000,Kuala Lumpur Malaysia ATP World Tour 250,HARD,2,Ernests Gulbis,N/A Bye,Ernests Gulbis,,R32,0,0,0,0,0,0,0,0,0,0,0,0,0,0,0,0,0,0,0,0,0,0,0,0,0,0,0
2014-09-22 00:00:00.000,Kuala Lumpur Malaysia ATP World Tour 250,HARD,2,Kei Nishikori,Rajeev Ram,Kei Nishikori,6-2; 6-3,R16,65,3,1,26,47,23,26,11,21,2,2,8,34,47,6,0,44,67,26,44,9,23,6,10,9,35,67
2014-09-22 00:00:00.000,Kuala Lumpur Malaysia ATP World Tour 250,HARD,2,Marinko Matosevic,Go Soeda,Marinko Matosevic,7-6(5); 6-4,R16,120,6,5,51,101,34,51,22,50,12,16,11,56,101,2,3,53,82,28,53,13,29,8,13,11,41,82
2014-09-22 00:00:00.000,Kuala Lumpur Malaysia ATP World Tour 250,HARD,2,Jarkko Nieminen,Leonardo Mayer,Jarkko Nieminen,7-6(5); 6-4,R16,100,0,0,47,71,34,47,18,24,0,0,11,52,71,6,4,40,76,31,40,21,36,3,4,11,52,76
2014-09-22 00:00:00.000,Kuala Lumpur Malaysia ATP World Tour 250,HARD,2,Pablo Andujar,Michal Przysiezny,Pablo Andujar,6-4; 6-7(6); 6-3,R16,149,5,1,74,110,51,74,19,36,2,5,16,70,110,6,3,59,103,40,59,23,44,4,9,15,63,103
2014-09-22 00:00:00.000,Kuala Lumpur Malaysia ATP World Tour 250,HARD,2,Pablo Cuevas,Ivan Dodig,Pablo Cuevas,3-6; 7-5; 7-5,R16,165,8,6,58,117,37,58,26,59,8,14,16,63,117,9,5,61,104,44,61,14,43,7,14,17,58,104
2014-09-22 00:00:00.000,Kuala Lumpur Malaysia ATP World Tour 250,HARD,2,Julien Benneteau,Filip Krajinovic,Julien Benneteau,6-4; 6-3,R16,89,4,1,41,65,33,41,12,24,5,5,9,45,65,5,1,44,82,28,44,18,38,9,12,10,46,82
2014-09-22 00:00:00.000,Kuala Lumpur Malaysia ATP World Tour 250,HARD,2,Benjamin Becker,Pierre-Hugues Herbert,Benjamin Becker,6-4; 7-6(4),R16,84,4,3,45,71,35,45,18,26,2,2,11,53,71,11,3,35,65,30,35,18,30,3,4,11,48,65
2014-09-22 00:00:00.000,Kuala Lumpur Malaysia ATP World Tour 250,HARD,2,Ernests Gulbis,Philipp Petzschner,Ernests Gulbis,6-3; 6-7(3); 6-1,R16,124,15,8,58,97,47,58,19,39,3,4,15,66,97,4,3,50,87,40,50,12,37,5,9,13,52,87
2014-09-22 00:00:00.000,Kuala Lumpur Malaysia ATP World Tour 250,HARD,2,Kei Nishikori,Marinko Matosevic,Kei Nishikori,6-3; 6-0,Q,64,8,1,25,41,21,25,10,16,1,1,7,31,41,2,3,33,65,20,33,9,32,10,15,8,29,65
2014-09-22 00:00:00.000,Kuala Lumpur Malaysia ATP World Tour 250,HARD,2,Jarkko Nieminen,Pablo Andujar,Jarkko Nieminen,6-3; 6-4,Q,74,2,1,32,55,23,32,13,23,2,4,10,36,55,3,4,34,57,21,34,9,23,5,9,9,30,57
2014-09-22 00:00:00.000,Kuala Lumpur Malaysia ATP World Tour 250,HARD,2,Julien Benneteau,Pablo Cuevas,Julien Benneteau,6-3; 6-7(3); 6-4,Q,139,10,6,65,112,48,65,22,47,4,6,16,70,112,8,5,60,96,45,60,16,36,0,4,15,61,96
2014-09-22 00:00:00.000,Kuala Lumpur Malaysia ATP World Tour 250,HARD,2,Ernests Gulbis,Benjamin Becker,Ernests Gulbis,6-3; 7-5,Q,78,12,2,40,67,33,40,17,27,3,3,11,50,67,1,3,28,49,23,28,12,21,0,2,10,35,49
2014-09-22 00:00:00.000,Kuala Lumpur Malaysia ATP World Tour 250,HARD,2,Kei Nishikori,Jarkko Nieminen,Kei Nishikori,6-3; 4-6; 6-2,S,97,8,3,41,72,28,41,18,31,1,4,13,46,72,2,4,56,90,38,56,13,34,7,13,14,51,90
2014-09-22 00:00:00.000,Kuala Lumpur Malaysia ATP World Tour 250,HARD,2,Julien Benneteau,Ernests Gulbis,Julien Benneteau,6-4; 6-4,S,80,4,1,33,55,27,33,14,22,0,0,10,41,55,11,1,38,53,26,38,10,15,1,3,10,36,53
2014-09-22 00:00:00.000,Kuala Lumpur Malaysia ATP World Tour 250,HARD,2,Kei Nishikori,Julien Benneteau,Kei Nishikori,7-6(4); 6-4,F,108,2,3,44,69,35,44,15,25,2,3,11,50,69,9,1,59,90,38,59,15,31,9,11,11,53,90
2014-09-22 00:00:00.000,Shenzhen China ATP World Tour 250,HARD,2,David Ferrer,N/A Bye,David Ferrer,,R32,0,0,0,0,0,0,0,0,0,0,0,0,0,0,0,0,0,0,0,0,0,0,0,0,0,0,0
2014-09-22 00:00:00.000,Shenzhen China ATP World Tour 250,HARD,2,Viktor Troicki,Martin Klizan,Viktor Troicki,5-7; 6-1; 3-0 RET,R32,109,10,3,44,74,32,44,18,30,6,7,11,50,74,4,1,35,72,26,35,16,37,3,7,11,42,72
2014-09-22 00:00:00.000,Shenzhen China ATP World Tour 250,HARD,2,Thanasi Kokkinakis,Egor Gerasimov,Thanasi Kokkinakis,7-6(3); 6-1,R32,73,5,2,27,55,24,27,22,28,2,2,10,46,55,7,4,34,63,28,34,10,29,2,4,9,38,63
2014-09-22 00:00:00.000,Shenzhen China ATP World Tour 250,HARD,2,Santiago Giraldo,Bowen Ouyang,Santiago Giraldo,3-6; 6-3; 6-4,R32,117,10,2,56,80,41,56,13,24,6,8,14,54,80,8,5,52,95,37,52,21,43,7,10,14,58,95
2014-09-22 00:00:00.000,Shenzhen China ATP World Tour 250,HARD,2,Tommy Robredo,N/A Bye,Tommy Robredo,,R32,0,0,0,0,0,0,0,0,0,0,0,0,0,0,0,0,0,0,0,0,0,0,0,0,0,0,0
2014-09-22 00:00:00.000,Shenzhen China ATP World Tour 250,HARD,2,Sam Groth,James Duckworth,Sam Groth,6-3; 6-7(5); 6-3,R32,111,16,1,57,92,46,57,22,35,0,1,16,68,92,8,3,51,93,40,51,21,42,7,10,14,61,93
2014-09-22 00:00:00.000,Shenzhen China ATP World Tour 250,HARD,2,Simone Bolelli,Matthew Ebden,Simone Bolelli,6-4; 6-2,R32,63,7,2,26,44,23,26,13,18,0,0,9,36,44,8,4,22,49,16,22,12,27,0,3,9,28,49
2014-09-22 00:00:00.000,Shenzhen China ATP World Tour 250,HARD,2,Andreas Seppi,Maximo Gonzalez,Andreas Seppi,7-6(3); 6-2,R32,86,7,3,28,69,24,28,26,41,4,4,10,50,69,4,2,37,61,26,37,14,24,2,4,10,40,61
2014-09-22 00:00:00.000,Shenzhen China ATP World Tour 250,HARD,2,Vasek Pospisil,Teymuraz Gabashvili,Vasek Pospisil,6-3; 6-4,R32,84,8,1,38,60,30,38,13,22,4,4,10,43,60,4,7,38,70,30,38,12,32,8,10,9,42,70
2014-09-22 00:00:00.000,Shenzhen China ATP World Tour 250,HARD,2,Juan Monaco,Federico Delbonis,Juan Monaco,6-3; 7-5,R32,90,3,1,37,69,31,37,16,32,3,3,11,47,69,1,3,30,60,22,30,15,30,7,9,10,37,60
2014-09-22 00:00:00.000,Shenzhen China ATP World Tour 250,HARD,2,Gilles Muller,Marco Chiudinelli,Gilles Muller,6-4; 3-6; 6-4,R32,130,22,2,46,73,41,46,13,27,0,1,14,54,73,5,2,59,91,42,59,19,32,3,5,15,61,91
2014-09-22 00:00:00.000,Shenzhen China ATP World Tour 250,HARD,2,Richard Gasquet,N/A Bye,Richard Gasquet,,R32,0,0,0,0,0,0,0,0,0,0,0,0,0,0,0,0,0,0,0,0,0,0,0,0,0,0,0
2014-09-22 00:00:00.000,Shenzhen China ATP World Tour 250,HARD,2,Ricardas Berankis,Gilles Simon,Ricardas Berankis,6-4; 6-2,R32,79,1,4,26,53,19,26,17,27,1,2,9,36,53,2,1,26,53,13,26,16,27,3,7,9,29,53
2014-09-22 00:00:00.000,Shenzhen China ATP World Tour 250,HARD,2,Lukas Lacko,Evgeny Donskoy,Lukas Lacko,6-1; 7-6(4),R32,84,4,1,32,54,26,32,15,22,0,0,9,41,54,7,5,33,72,22,33,20,39,6,9,10,42,72
2014-09-22 00:00:00.000,Shenzhen China ATP World Tour 250,HARD,2,Somdev Devvarman,Xin Gao,Somdev Devvarman,6-3; 4-6; 6-4,R32,128,7,5,51,90,37,51,19,39,3,6,15,56,90,6,5,43,87,30,43,23,44,4,8,14,53,87
2014-09-22 00:00:00.000,Shenzhen China ATP World Tour 250,HARD,2,Andy Murray,N/A Bye,Andy Murray,,R32,0,0,0,0,0,0,0,0,0,0,0,0,0,0,0,0,0,0,0,0,0,0,0,0,0,0,0
2014-09-22 00:00:00.000,Shenzhen China ATP World Tour 250,HARD,2,Viktor Troicki,David Ferrer,Viktor Troicki,6-3; 6-4,R16,66,13,2,33,59,30,33,14,26,2,2,10,44,59,0,2,32,51,22,32,10,19,3,5,9,32,51
2014-09-22 00:00:00.000,Shenzhen China ATP World Tour 250,HARD,2,Santiago Giraldo,Thanasi Kokkinakis,Santiago Giraldo,6-4; 6-3,R16,82,4,0,33,48,28,33,9,15,0,0,9,37,48,11,3,37,68,28,37,11,31,2,5,10,39,68
2014-09-22 00:00:00.000,Shenzhen China ATP World Tour 250,HARD,2,Tommy Robredo,Sam Groth,Tommy Robredo,1-6; 7-5; 6-3,R16,97,3,2,45,78,32,45,21,33,2,4,14,53,78,11,4,55,81,45,55,11,26,8,10,14,56,81
2014-09-22 00:00:00.000,Shenzhen China ATP World Tour 250,HARD,2,Andreas Seppi,Simone Bolelli,Andreas Seppi,6-4; 6-3,R16,68,8,0,31,50,27,31,11,19,2,2,9,38,50,3,1,35,51,23,35,9,16,2,5,10,32,51
2014-09-22 00:00:00.000,Shenzhen China ATP World Tour 250,HARD,2,Juan Monaco,Vasek Pospisil,Juan Monaco,7-5; 2-6; 6-3,R16,119,0,3,62,96,42,62,22,34,6,8,15,64,96,11,5,44,78,34,44,21,34,5,7,14,55,78
2014-09-22 00:00:00.000,Shenzhen China ATP World Tour 250,HARD,2,Richard Gasquet,Gilles Muller,Richard Gasquet,6-3; 6-2,R16,77,5,2,38,59,30,38,13,21,6,6,9,43,59,6,5,25,55,15,25,15,30,2,5,8,30,55
2014-09-22 00:00:00.000,Shenzhen China ATP World Tour 250,HARD,2,Lukas Lacko,Ricardas Berankis,Lukas Lacko,6-4; 7-6(1),R16,99,4,3,45,80,31,45,22,35,4,5,11,53,80,3,2,32,72,26,32,20,40,2,4,11,46,72
2014-09-22 00:00:00.000,Shenzhen China ATP World Tour 250,HARD,2,Andy Murray,Somdev Devvarman,Andy Murray,6-3; 6-3,R16,82,4,2,29,52,24,29,12,23,4,5,9,36,52,2,3,39,61,20,39,12,22,3,7,9,32,61
2014-09-22 00:00:00.000,Shenzhen China ATP World Tour 250,HARD,2,Santiago Giraldo,Viktor Troicki,Santiago Giraldo,7-6(6); 6-3,Q,91,1,2,52,81,38,52,13,29,3,4,11,51,81,9,2,34,60,26,34,14,26,0,2,10,40,60
2014-09-22 00:00:00.000,Shenzhen China ATP World Tour 250,HARD,2,Tommy Robredo,Andreas Seppi,Tommy Robredo,6-4; 6-7(5); 6-3,Q,156,19,3,58,104,48,58,26,46,1,1,16,74,104,11,4,59,102,46,59,23,43,4,6,15,69,102
2014-09-22 00:00:00.000,Shenzhen China ATP World Tour 250,HARD,2,Juan Monaco,Richard Gasquet,Juan Monaco,7-6(7); 6-4,Q,103,4,2,51,77,33,51,13,26,1,4,11,46,77,5,2,41,71,26,41,13,30,4,8,11,39,71
2014-09-22 00:00:00.000,Shenzhen China ATP World Tour 250,HARD,2,Andy Murray,Lukas Lacko,Andy Murray,6-3; 7-5,Q,80,9,2,38,67,32,38,18,29,4,4,11,50,67,3,1,34,56,26,34,9,22,2,4,10,35,56
2014-09-22 00:00:00.000,Shenzhen China ATP World Tour 250,HARD,2,Tommy Robredo,Santiago Giraldo,Tommy Robredo,6-1; 6-4,S,70,10,3,33,57,28,33,11,24,3,4,9,39,57,2,2,37,54,22,37,6,17,3,7,8,28,54
2014-09-22 00:00:00.000,Shenzhen China ATP World Tour 250,HARD,2,Andy Murray,Juan Monaco,Andy Murray,2-6; 6-3; 6-0,S,102,10,2,42,73,26,42,15,31,4,8,12,41,73,4,3,50,71,25,50,9,21,3,9,11,34,71
2014-09-22 00:00:00.000,Shenzhen China ATP World Tour 250,HARD,2,Andy Murray,Tommy Robredo,Andy Murray,5-7; 7-6(9); 6-1,F,150,10,5,55,93,40,55,20,38,4,7,15,60,93,4,7,64,106,44,64,17,42,3,8,16,61,106
2014-09-29 00:00:00.000,Beijing China ATP World Tour 500,HARD,2,Novak Djokovic,Guillermo Garcia-Lopez,Novak Djokovic,6-2; 6-1,R32,64,1,1,34,49,20,34,10,15,4,6,8,30,49,0,3,18,45,8,18,7,27,0,6,7,15,45
2014-09-29 00:00:00.000,Beijing China ATP World Tour 500,HARD,2,Vasek Pospisil,Lukas Rosol,Vasek Pospisil,6-4; 6-3,R32,72,10,3,34,63,24,34,15,29,4,6,10,39,63,1,2,33,51,20,33,7,18,3,7,9,27,51
2014-09-29 00:00:00.000,Beijing China ATP World Tour 500,HARD,2,Pablo Andujar,Julien Benneteau,Pablo Andujar,6-4; 6-1,R32,63,0,3,28,47,20,28,12,19,0,1,9,32,47,2,3,28,54,15,28,11,26,3,7,8,26,54
2014-09-29 00:00:00.000,Beijing China ATP World Tour 500,HARD,2,Grigor Dimitrov,Fernando Verdasco,Grigor Dimitrov,6-1; 3-6; 6-3,R32,95,11,2,53,84,39,53,18,31,7,8,13,57,84,3,4,51,72,35,51,11,21,8,11,12,46,72
2014-09-29 00:00:00.000,Beijing China ATP World Tour 500,HARD,2,Marin Cilic,Yan Bai,Marin Cilic,6-3; 6-4,R32,81,7,3,38,67,29,38,18,29,4,4,10,47,67,3,5,28,57,20,28,15,29,8,10,9,35,57
2014-09-29 00:00:00.000,Beijing China ATP World Tour 500,HARD,2,Joao Sousa,Teymuraz Gabashvili,Joao Sousa,1-6; 7-6(4); 6-4,R32,125,3,5,56,95,38,56,21,39,6,9,14,59,95,1,3,51,91,37,51,22,40,3,5,15,59,91
2014-09-29 00:00:00.000,Beijing China ATP World Tour 500,HARD,2,Pablo Cuevas,Mikhail Kukushkin,Pablo Cuevas,7-6(3); 3-6; 6-4,R32,142,6,4,46,85,36,46,20,39,2,6,15,56,85,3,1,63,112,41,63,26,49,9,13,16,67,112
2014-09-29 00:00:00.000,Beijing China ATP World Tour 500,HARD,2,Andy Murray,Jerzy Janowicz,Andy Murray,6-7(9); 6-4; 6-2,R32,148,7,4,58,108,42,58,25,50,2,5,15,67,108,5,9,61,98,40,61,15,37,5,11,15,55,98
2014-09-29 00:00:00.000,Beijing China ATP World Tour 500,HARD,2,John Isner,Santiago Giraldo,John Isner,6-1; 6-3,R32,61,14,2,34,50,27,34,10,16,5,5,8,37,50,0,1,37,56,21,37,9,19,5,9,8,30,56
2014-09-29 00:00:00.000,Beijing China ATP World Tour 500,HARD,2,Tommy Robredo,Andreas Seppi,Tommy Robredo,3-6; 7-6(4); 6-2,R32,152,10,3,79,129,48,79,26,50,19,23,14,74,129,1,8,67,115,45,67,18,48,11,16,15,63,115
2014-09-29 00:00:00.000,Beijing China ATP World Tour 500,HARD,2,Viktor Troicki,Mikhail Youzhny,Viktor Troicki,6-3; 6-4,R32,76,4,1,31,59,24,31,13,28,1,3,9,37,59,0,4,33,60,22,33,8,27,4,9,10,30,60
2014-09-29 00:00:00.000,Beijing China ATP World Tour 500,HARD,2,Tomas Berdych,Feliciano Lopez,Tomas Berdych,6-1; 6-2,R32,63,5,3,21,43,19,21,14,22,0,0,8,33,43,4,6,31,59,20,31,9,28,10,14,7,29,59
2014-09-29 00:00:00.000,Beijing China ATP World Tour 500,HARD,2,Ernests Gulbis,Fabio Fognini,Ernests Gulbis,6-3; 6-4,R32,79,7,3,29,51,26,29,15,22,0,0,10,41,51,0,6,36,67,26,36,14,31,7,9,9,40,67
2014-09-29 00:00:00.000,Beijing China ATP World Tour 500,HARD,2,Martin Klizan,Leonardo Mayer,Martin Klizan,7-6(2); 6-7(3); 6-4,R32,147,2,5,68,107,52,68,17,39,1,3,17,69,107,10,6,66,109,54,66,16,43,4,7,17,70,109
2014-09-29 00:00:00.000,Beijing China ATP World Tour 500,HARD,2,Peter Gojowczyk,Ivo Karlovic,Peter Gojowczyk,6-4; 2-6; 7-5,R32,112,10,5,49,93,38,49,21,44,2,5,15,59,93,17,4,46,82,36,46,19,36,6,9,15,55,82
2014-09-29 00:00:00.000,Beijing China ATP World Tour 500,HARD,2,Rafael Nadal,Richard Gasquet,Rafael Nadal,6-4; 6-0,R32,79,4,1,38,55,28,38,10,17,3,3,8,38,55,1,1,31,54,19,31,8,23,3,7,8,27,54
2014-09-29 00:00:00.000,Beijing China ATP World Tour 500,HARD,2,Novak Djokovic,Vasek Pospisil,Novak Djokovic,6-3; 7-5,R16,86,5,0,34,50,28,34,11,16,0,1,10,39,50,14,6,46,76,32,46,10,30,5,9,11,42,76
2014-09-29 00:00:00.000,Beijing China ATP World Tour 500,HARD,2,Grigor Dimitrov,Pablo Andujar,Grigor Dimitrov,6-4; 6-4,R16,84,4,5,35,66,26,35,11,31,6,9,10,37,66,0,4,29,57,17,29,14,28,3,8,10,31,57
2014-09-29 00:00:00.000,Beijing China ATP World Tour 500,HARD,2,Marin Cilic,Joao Sousa,Marin Cilic,6-3; 6-3,R16,72,2,0,28,47,24,28,13,19,2,2,9,37,47,1,5,21,56,15,21,17,35,5,8,9,32,56
2014-09-29 00:00:00.000,Beijing China ATP World Tour 500,HARD,2,Andy Murray,Pablo Cuevas,Andy Murray,6-2; 6-2,R16,80,3,1,30,51,22,30,10,21,3,4,8,32,51,1,0,36,56,18,36,8,20,5,10,8,26,56
2014-09-29 00:00:00.000,Beijing China ATP World Tour 500,HARD,2,John Isner,Tommy Robredo,John Isner,3-6; 7-5; 7-6(4),R16,132,16,5,72,109,53,72,16,37,1,4,17,69,109,12,2,67,101,50,67,17,34,1,3,16,67,101
2014-09-29 00:00:00.000,Beijing China ATP World Tour 500,HARD,2,Tomas Berdych,Viktor Troicki,Tomas Berdych,6-3; 6-4,R16,87,4,4,23,71,17,23,30,48,3,4,10,47,71,6,2,23,51,18,23,12,28,0,3,9,30,51
2014-09-29 00:00:00.000,Beijing China ATP World Tour 500,HARD,2,Martin Klizan,Ernests Gulbis,Martin Klizan,6-2; 3-0 RET,R16,55,5,0,24,33,18,24,6,9,3,3,5,24,33,3,2,22,42,15,22,4,20,3,7,6,19,42
2014-09-29 00:00:00.000,Beijing China ATP World Tour 500,HARD,2,Rafael Nadal,Peter Gojowczyk,Rafael Nadal,6-3; 6-4,R16,105,6,2,40,61,34,40,11,21,3,3,10,45,61,8,4,43,89,30,43,21,46,9,11,9,51,89
2014-09-29 00:00:00.000,Beijing China ATP World Tour 500,HARD,2,Novak Djokovic,Grigor Dimitrov,Novak Djokovic,6-2; 6-4,Q,90,2,3,39,63,31,39,8,24,6,8,9,39,63,2,3,34,60,19,34,10,26,3,8,9,29,60
2014-09-29 00:00:00.000,Beijing China ATP World Tour 500,HARD,2,Andy Murray,Marin Cilic,Andy Murray,6-1; 6-4,Q,98,5,1,38,62,27,38,14,24,5,5,8,41,62,1,2,31,68,18,31,18,37,7,11,9,36,68
2014-09-29 00:00:00.000,Beijing China ATP World Tour 500,HARD,2,Tomas Berdych,John Isner,Tomas Berdych,6-1; 6-4,Q,74,5,2,29,56,21,29,20,27,3,3,9,41,56,9,1,34,55,21,34,9,21,5,8,8,30,55
2014-09-29 00:00:00.000,Beijing China ATP World Tour 500,HARD,2,Martin Klizan,Rafael Nadal,Martin Klizan,6-7(7); 6-4; 6-3,Q,157,5,0,63,95,47,63,18,32,4,7,16,65,95,2,3,63,101,46,63,12,38,9,14,15,58,101
2014-09-29 00:00:00.000,Beijing China ATP World Tour 500,HARD,2,Novak Djokovic,Andy Murray,Novak Djokovic,6-3; 6-4,S,97,4,0,35,62,24,35,20,27,4,5,10,44,62,4,2,34,58,24,34,8,24,3,6,9,32,58
2014-09-29 00:00:00.000,Beijing China ATP World Tour 500,HARD,2,Tomas Berdych,Martin Klizan,Tomas Berdych,6-4; 6-1,S,81,8,3,30,50,26,30,12,20,1,1,9,38,50,3,3,41,62,23,41,10,21,6,9,8,33,62
2014-09-29 00:00:00.000,Beijing China ATP World Tour 500,HARD,2,Novak Djokovic,Tomas Berdych,Novak Djokovic,6-0; 6-2,F,67,4,1,32,45,22,32,8,13,1,2,7,30,45,1,3,24,42,11,24,4,18,2,8,7,15,42
2014-09-29 00:00:00.000,Tokyo Japan ATP World Tour 500,HARD,2,Tatsuma Ito,Stan Wawrinka,Tatsuma Ito,7-5; 6-2,R32,80,3,2,40,65,29,40,13,25,2,3,10,42,65,5,1,32,57,23,32,8,25,0,4,10,31,57
2014-09-29 00:00:00.000,Tokyo Japan ATP World Tour 500,HARD,2,Benjamin Becker,Jarkko Nieminen,Benjamin Becker,7-5; 4-1 RET,R32,80,2,2,36,58,23,36,14,22,9,10,8,37,58,2,2,27,53,15,27,12,26,4,8,9,27,53
2014-09-29 00:00:00.000,Tokyo Japan ATP World Tour 500,HARD,2,Andrey Golubev,Pierre-Hugues Herbert,Andrey Golubev,6-4; 6-4,R32,85,2,4,44,71,32,44,18,27,8,8,10,50,71,7,4,26,61,25,26,15,35,1,3,10,40,61
2014-09-29 00:00:00.000,Tokyo Japan ATP World Tour 500,HARD,2,Jack Sock,Alexandr Dolgopolov,Jack Sock,6-4; 6-1,R32,54,4,2,22,37,19,22,10,15,0,1,8,29,37,4,4,36,53,21,36,3,17,0,5,9,24,53
2014-09-29 00:00:00.000,Tokyo Japan ATP World Tour 500,HARD,2,Kei Nishikori,Ivan Dodig,Kei Nishikori,6-3; 6-4,R32,84,2,1,51,63,37,51,4,12,0,1,10,41,63,6,3,33,56,25,33,7,23,4,7,9,32,56
2014-09-29 00:00:00.000,Tokyo Japan ATP World Tour 500,HARD,2,Donald Young,Go Soeda,Donald Young,6-4; 6-2,R32,72,6,4,39,65,29,39,15,26,3,3,9,44,65,1,3,35,56,25,35,8,21,4,7,9,33,56
2014-09-29 00:00:00.000,Tokyo Japan ATP World Tour 500,HARD,2,Jeremy Chardy,Rajeev Ram,Jeremy Chardy,7-5; 5-7; 6-4,R32,142,11,8,66,104,47,66,17,38,5,9,17,64,104,11,6,81,124,54,81,17,43,10,15,17,71,124
2014-09-29 00:00:00.000,Tokyo Japan ATP World Tour 500,HARD,2,Kevin Anderson,Dominic Thiem,Kevin Anderson,7-6(5); 6-4,R32,106,11,1,51,79,35,51,15,28,1,4,11,50,79,4,1,40,71,29,40,12,31,3,7,11,41,71
2014-09-29 00:00:00.000,Tokyo Japan ATP World Tour 500,HARD,2,Michal Przysiezny,Jo-Wilfried Tsonga,Michal Przysiezny,4-6; 7-5; 7-6(9),R32,142,14,2,65,102,50,65,23,37,2,4,17,73,102,12,1,64,100,52,64,21,36,0,2,17,73,100
2014-09-29 00:00:00.000,Tokyo Japan ATP World Tour 500,HARD,2,Denis Istomin,Taro Daniel,Denis Istomin,7-6(2); 6-7(5); 7-5,R32,173,6,2,84,125,62,84,22,41,8,11,18,84,125,3,6,76,120,51,76,23,44,6,10,18,74,120
2014-09-29 00:00:00.000,Tokyo Japan ATP World Tour 500,HARD,2,Jurgen Melzer,Edouard Roger-Vasselin,Jurgen Melzer,7-5; 4-1 RET,R32,69,7,0,31,48,25,31,12,17,1,1,9,37,48,0,0,30,45,22,30,8,15,3,5,8,30,45
2014-09-29 00:00:00.000,Tokyo Japan ATP World Tour 500,HARD,2,Milos Raonic,Bernard Tomic,Milos Raonic,7-6(3); 6-3,R32,76,22,0,47,60,42,47,8,13,2,2,11,50,60,4,2,42,66,28,42,16,24,2,3,10,44,66
2014-09-29 00:00:00.000,Tokyo Japan ATP World Tour 500,HARD,2,Gilles Simon,Roberto Bautista Agut,Gilles Simon,4-6; 7-6(7); 2-1 RET,R32,148,4,5,55,99,35,55,18,44,7,12,13,53,99,3,0,38,74,21,38,19,36,2,6,12,40,74
2014-09-29 00:00:00.000,Tokyo Japan ATP World Tour 500,HARD,2,Gilles Muller,Federico Delbonis,Gilles Muller,6-3; 6-4,R32,68,11,4,34,53,27,34,10,19,0,1,10,37,53,2,4,34,49,20,34,8,15,2,5,9,28,49
2014-09-29 00:00:00.000,Tokyo Japan ATP World Tour 500,HARD,2,Steve Johnson,Hiroki Moriya,Steve Johnson,7-6(4); 6-2,R32,101,12,2,42,71,35,42,12,29,2,4,10,47,71,4,0,52,84,33,52,14,32,9,13,10,47,84
2014-09-29 00:00:00.000,Tokyo Japan ATP World Tour 500,HARD,2,Marcel Granollers,David Ferrer,Marcel Granollers,4-6; 6-4; 6-4,R32,128,5,0,61,97,42,61,20,36,4,7,15,62,97,1,4,57,86,40,57,13,29,5,9,15,53,86
2014-09-29 00:00:00.000,Tokyo Japan ATP World Tour 500,HARD,2,Benjamin Becker,Tatsuma Ito,Benjamin Becker,6-3; 6-3,R16,71,1,1,41,60,29,41,10,19,2,3,9,39,60,5,4,32,48,20,32,7,16,2,6,9,27,48
2014-09-29 00:00:00.000,Tokyo Japan ATP World Tour 500,HARD,2,Jack Sock,Andrey Golubev,Jack Sock,6-3; 1-6; 7-5,R16,109,3,2,54,76,37,54,12,22,0,3,14,49,76,7,3,56,86,39,56,17,30,3,6,14,56,86
2014-09-29 00:00:00.000,Tokyo Japan ATP World Tour 500,HARD,2,Kei Nishikori,Donald Young,Kei Nishikori,6-4; 7-6(4),R16,87,3,1,46,75,37,46,17,29,1,1,11,54,75,10,2,43,65,34,43,12,22,1,2,11,46,65
2014-09-29 00:00:00.000,Tokyo Japan ATP World Tour 500,HARD,2,Jeremy Chardy,Kevin Anderson,Jeremy Chardy,6-4; 6-4,R16,83,4,3,48,58,38,48,5,10,2,2,10,43,58,7,0,48,70,33,48,10,22,4,6,10,43,70
2014-09-29 00:00:00.000,Tokyo Japan ATP World Tour 500,HARD,2,Denis Istomin,Michal Przysiezny,Denis Istomin,6-4; 7-6(5),R16,104,10,0,53,83,36,53,18,30,5,6,11,54,83,6,3,48,77,30,48,16,29,4,6,11,46,77
2014-09-29 00:00:00.000,Tokyo Japan ATP World Tour 500,HARD,2,Milos Raonic,Jurgen Melzer,Milos Raonic,6-4; 6-3,R16,74,11,0,34,52,26,34,12,18,0,1,10,38,52,2,2,34,52,22,34,9,18,1,4,9,31,52
2014-09-29 00:00:00.000,Tokyo Japan ATP World Tour 500,HARD,2,Gilles Simon,Gilles Muller,Gilles Simon,4-6; 7-6(1); 6-3,R16,141,6,2,63,100,51,63,14,37,4,7,15,65,100,15,2,75,109,48,75,15,34,9,13,16,63,109
2014-09-29 00:00:00.000,Tokyo Japan ATP World Tour 500,HARD,2,Steve Johnson,Marcel Granollers,Steve Johnson,4-6; 6-3; 6-4,R16,113,10,1,55,86,47,55,15,31,3,4,15,62,86,5,0,53,77,42,53,13,24,4,6,14,55,77
2014-09-29 00:00:00.000,Tokyo Japan ATP World Tour 500,HARD,2,Benjamin Becker,Jack Sock,Benjamin Becker,4-6; 6-1; 6-4,Q,97,13,1,66,93,50,66,13,27,8,9,14,63,93,6,3,49,67,38,49,7,18,0,3,13,45,67
2014-09-29 00:00:00.000,Tokyo Japan ATP World Tour 500,HARD,2,Kei Nishikori,Jeremy Chardy,Kei Nishikori,6-4; 6-2,Q,86,6,2,36,61,29,36,11,25,4,5,9,40,61,7,2,51,73,31,51,8,22,8,12,9,39,73
2014-09-29 00:00:00.000,Tokyo Japan ATP World Tour 500,HARD,2,Milos Raonic,Denis Istomin,Milos Raonic,7-6(8); 6-3,Q,80,15,6,39,62,38,39,14,23,0,0,11,52,62,1,3,37,59,32,37,12,22,0,1,10,44,59
2014-09-29 00:00:00.000,Tokyo Japan ATP World Tour 500,HARD,2,Gilles Simon,Steve Johnson,Gilles Simon,7-6(4); 6-1,Q,90,7,1,45,64,33,45,12,19,3,4,10,45,64,4,4,38,71,23,38,14,33,6,9,9,37,71
2014-09-29 00:00:00.000,Tokyo Japan ATP World Tour 500,HARD,2,Kei Nishikori,Benjamin Becker,Kei Nishikori,4-6; 6-0; 7-6(2),S,107,8,1,65,85,47,65,12,20,2,4,14,59,85,6,1,54,83,33,54,16,29,3,7,14,49,83
2014-09-29 00:00:00.000,Tokyo Japan ATP World Tour 500,HARD,2,Milos Raonic,Gilles Simon,Milos Raonic,6-1; 6-4,S,71,11,1,31,48,25,31,12,17,0,0,9,37,48,3,3,25,50,14,25,15,25,1,4,8,29,50
2014-09-29 00:00:00.000,Tokyo Japan ATP World Tour 500,HARD,2,Kei Nishikori,Milos Raonic,Kei Nishikori,7-6(5); 4-6; 6-4,F,133,1,4,70,104,54,70,20,34,4,5,16,74,104,22,1,63,89,51,63,15,26,4,5,16,66,89
2014-10-05 00:00:00.000,ATP World Tour Masters 1000 Shanghai Shanghai; China ATP World Tour Masters 1000,HARD,2,Novak Djokovic,N/A Bye,Novak Djokovic,,R64,0,0,0,0,0,0,0,0,0,0,0,0,0,0,0,0,0,0,0,0,0,0,0,0,0,0,0
2014-10-05 00:00:00.000,ATP World Tour Masters 1000 Shanghai Shanghai; China ATP World Tour Masters 1000,HARD,2,Dominic Thiem,Lukas Rosol,Dominic Thiem,6-4; 7-6(3),R64,78,3,2,43,68,37,43,14,25,2,2,11,51,68,4,2,45,60,34,45,10,15,0,1,11,44,60
2014-10-05 00:00:00.000,ATP World Tour Masters 1000 Shanghai Shanghai; China ATP World Tour Masters 1000,HARD,2,Mikhail Kukushkin,Tommy Robredo,Mikhail Kukushkin,3-6; 6-3; 7-6(4),R64,128,5,2,50,83,39,50,20,33,1,4,15,59,83,7,0,53,93,37,53,21,40,3,6,15,58,93
2014-10-05 00:00:00.000,ATP World Tour Masters 1000 Shanghai Shanghai; China ATP World Tour Masters 1000,HARD,2,Kevin Anderson,James Ward,Kevin Anderson,3-6; 6-3; 6-2,R64,104,7,1,57,74,42,57,8,17,4,6,13,50,74,4,3,50,75,35,50,11,25,3,7,13,46,75
2014-10-05 00:00:00.000,ATP World Tour Masters 1000 Shanghai Shanghai; China ATP World Tour Masters 1000,HARD,2,Andy Murray,Teymuraz Gabashvili,Andy Murray,6-1; 7-5,R64,85,6,3,26,44,19,26,11,18,0,2,9,30,44,2,4,43,73,23,43,12,30,9,15,10,35,73
2014-10-05 00:00:00.000,ATP World Tour Masters 1000 Shanghai Shanghai; China ATP World Tour Masters 1000,HARD,2,Jerzy Janowicz,Edouard Roger-Vasselin,Jerzy Janowicz,3-6; 7-5; 7-6(6),R64,138,11,2,62,102,38,62,20,40,4,9,16,58,102,2,2,76,101,56,76,5,25,6,11,17,61,101
2014-10-05 00:00:00.000,ATP World Tour Masters 1000 Shanghai Shanghai; China ATP World Tour Masters 1000,HARD,2,Martin Klizan,Sam Groth,Martin Klizan,7-6(1); 6-3,R64,69,7,1,46,62,38,46,11,16,0,0,11,49,62,12,0,38,55,31,38,8,17,1,2,10,39,55
2014-10-05 00:00:00.000,ATP World Tour Masters 1000 Shanghai Shanghai; China ATP World Tour Masters 1000,HARD,2,David Ferrer,N/A Bye,David Ferrer,,R64,0,0,0,0,0,0,0,0,0,0,0,0,0,0,0,0,0,0,0,0,0,0,0,0,0,0,0
2014-10-05 00:00:00.000,ATP World Tour Masters 1000 Shanghai Shanghai; China ATP World Tour Masters 1000,HARD,2,Roger Federer,N/A Bye,Roger Federer,,R64,0,0,0,0,0,0,0,0,0,0,0,0,0,0,0,0,0,0,0,0,0,0,0,0,0,0,0
2014-10-05 00:00:00.000,ATP World Tour Masters 1000 Shanghai Shanghai; China ATP World Tour Masters 1000,HARD,2,Leonardo Mayer,Di Wu,Leonardo Mayer,6-4; 6-1,R64,65,6,1,34,47,33,34,2,13,4,4,8,35,47,1,2,31,56,17,31,13,25,1,5,9,30,56
2014-10-05 00:00:00.000,ATP World Tour Masters 1000 Shanghai Shanghai; China ATP World Tour Masters 1000,HARD,2,Vasek Pospisil,Santiago Giraldo,Vasek Pospisil,6-2; 6-7(5); 6-1,R64,116,18,1,44,70,36,44,16,26,0,1,13,52,70,3,1,69,98,45,69,10,29,4,10,14,55,98
2014-10-05 00:00:00.000,ATP World Tour Masters 1000 Shanghai Shanghai; China ATP World Tour Masters 1000,HARD,2,Roberto Bautista Agut,Alexandr Dolgopolov,Roberto Bautista Agut,6-4; 6-4,R64,89,4,0,58,69,40,58,5,11,8,9,10,45,69,9,0,41,73,29,41,14,32,9,12,10,43,73
2014-10-05 00:00:00.000,ATP World Tour Masters 1000 Shanghai Shanghai; China ATP World Tour Masters 1000,HARD,2,Grigor Dimitrov,Denis Istomin,Grigor Dimitrov,6-3; 6-3,R64,65,6,4,29,48,25,29,10,19,2,3,9,35,48,1,2,33,48,19,33,5,15,0,4,9,24,48
2014-10-05 00:00:00.000,ATP World Tour Masters 1000 Shanghai Shanghai; China ATP World Tour Masters 1000,HARD,2,Julien Benneteau,Ze Zhang,Julien Benneteau,5-7; 6-3; 6-3,R64,136,10,2,68,102,45,68,17,34,6,9,15,62,102,3,2,67,96,40,67,14,29,8,13,15,54,96
2014-10-05 00:00:00.000,ATP World Tour Masters 1000 Shanghai Shanghai; China ATP World Tour Masters 1000,HARD,2,Jack Sock,Bernard Tomic,Jack Sock,7-6(4); 6-7(4); 6-4,R64,148,4,5,69,120,49,69,34,51,3,4,17,83,120,15,0,68,100,56,68,17,32,3,5,17,73,100
2014-10-05 00:00:00.000,ATP World Tour Masters 1000 Shanghai Shanghai; China ATP World Tour Masters 1000,HARD,2,Kei Nishikori,N/A Bye,Kei Nishikori,,R64,0,0,0,0,0,0,0,0,0,0,0,0,0,0,0,0,0,0,0,0,0,0,0,0,0,0,0
2014-10-05 00:00:00.000,ATP World Tour Masters 1000 Shanghai Shanghai; China ATP World Tour Masters 1000,HARD,2,Tomas Berdych,N/A Bye,Tomas Berdych,,R64,0,0,0,0,0,0,0,0,0,0,0,0,0,0,0,0,0,0,0,0,0,0,0,0,0,0,0
2014-10-05 00:00:00.000,ATP World Tour Masters 1000 Shanghai Shanghai; China ATP World Tour Masters 1000,HARD,2,Richard Gasquet,Jeremy Chardy,Richard Gasquet,7-6(7); 6-2,R64,89,6,1,40,65,29,40,18,25,0,1,10,47,65,8,3,37,67,28,37,13,30,3,6,10,41,67
2014-10-05 00:00:00.000,ATP World Tour Masters 1000 Shanghai Shanghai; China ATP World Tour Masters 1000,HARD,2,Yen-Hsun Lu,Marcel Granollers,Yen-Hsun Lu,6-3; 6-7(5); 6-2,R64,121,5,4,63,91,47,63,20,28,3,3,15,67,91,17,3,64,85,51,64,7,21,3,6,14,58,85
2014-10-05 00:00:00.000,ATP World Tour Masters 1000 Shanghai Shanghai; China ATP World Tour Masters 1000,HARD,2,Ivo Karlovic,Marin Cilic,Ivo Karlovic,7-5; 2-6; 7-6(2),R64,136,20,2,55,90,47,55,18,35,2,4,16,65,90,9,2,71,104,55,71,17,33,3,4,16,72,104
2014-10-05 00:00:00.000,ATP World Tour Masters 1000 Shanghai Shanghai; China ATP World Tour Masters 1000,HARD,2,Chuhan Wang,Fabio Fognini,Chuhan Wang,7-6(5); 6-4,R64,85,6,4,41,76,32,41,19,35,4,5,11,51,76,11,5,37,59,30,37,11,22,1,3,11,41,59
2014-10-05 00:00:00.000,ATP World Tour Masters 1000 Shanghai Shanghai; China ATP World Tour Masters 1000,HARD,2,Malek Jaziri,Donald Young,Malek Jaziri,7-5; 6-4,R64,89,6,2,33,66,26,33,18,33,0,1,11,44,66,5,5,52,74,36,52,6,22,8,11,11,42,74
2014-10-05 00:00:00.000,ATP World Tour Masters 1000 Shanghai Shanghai; China ATP World Tour Masters 1000,HARD,2,Gilles Simon,Guillermo Garcia-Lopez,Gilles Simon,3-6; 6-0; 6-1,R64,109,9,0,41,78,30,41,22,37,6,7,11,52,78,1,0,45,71,25,45,14,26,4,9,11,39,71
2014-10-05 00:00:00.000,ATP World Tour Masters 1000 Shanghai Shanghai; China ATP World Tour Masters 1000,HARD,2,Stan Wawrinka,N/A Bye,Stan Wawrinka,,R64,0,0,0,0,0,0,0,0,0,0,0,0,0,0,0,0,0,0,0,0,0,0,0,0,0,0,0
2014-10-05 00:00:00.000,ATP World Tour Masters 1000 Shanghai Shanghai; China ATP World Tour Masters 1000,HARD,2,Milos Raonic,N/A Bye,Milos Raonic,,R64,0,0,0,0,0,0,0,0,0,0,0,0,0,0,0,0,0,0,0,0,0,0,0,0,0,0,0
2014-10-05 00:00:00.000,ATP World Tour Masters 1000 Shanghai Shanghai; China ATP World Tour Masters 1000,HARD,2,Juan Monaco,Joao Sousa,Juan Monaco,6-2; 7-6(4),R64,95,4,3,48,72,29,48,13,24,3,6,10,42,72,1,4,38,66,22,38,10,28,3,8,10,32,66
2014-10-05 00:00:00.000,ATP World Tour Masters 1000 Shanghai Shanghai; China ATP World Tour Masters 1000,HARD,2,Ivan Dodig,Pablo Cuevas,Ivan Dodig,7-5; 6-2,R64,84,9,6,37,72,29,37,18,35,8,9,10,47,72,6,4,41,67,24,41,13,26,5,9,10,37,67
2014-10-05 00:00:00.000,ATP World Tour Masters 1000 Shanghai Shanghai; China ATP World Tour Masters 1000,HARD,2,Mikhail Youzhny,Ernests Gulbis,Mikhail Youzhny,6-4; 6-1,R64,66,8,2,33,46,29,33,7,13,0,0,9,36,46,3,1,26,49,16,26,10,23,1,4,8,26,49
2014-10-05 00:00:00.000,ATP World Tour Masters 1000 Shanghai Shanghai; China ATP World Tour Masters 1000,HARD,2,John Isner,Pablo Andujar,John Isner,7-6(5); 1-6; 6-3,R64,121,22,0,59,88,42,59,21,29,6,8,14,63,88,3,3,59,91,44,59,19,32,1,2,14,63,91
2014-10-05 00:00:00.000,ATP World Tour Masters 1000 Shanghai Shanghai; China ATP World Tour Masters 1000,HARD,2,Steve Johnson,Andrey Golubev,Steve Johnson,6-3; 1-6; 6-3,R64,85,6,2,44,74,35,44,16,30,0,2,13,51,74,10,2,35,63,24,35,18,28,1,3,12,42,63
2014-10-05 00:00:00.000,ATP World Tour Masters 1000 Shanghai Shanghai; China ATP World Tour Masters 1000,HARD,2,Feliciano Lopez,Thanasi Kokkinakis,Feliciano Lopez,6-7(12); 6-3; 6-4,R64,128,19,4,64,103,54,64,22,39,4,4,16,76,103,16,2,59,98,48,59,20,39,4,6,15,68,98
2014-10-05 00:00:00.000,ATP World Tour Masters 1000 Shanghai Shanghai; China ATP World Tour Masters 1000,HARD,2,Rafael Nadal,N/A Bye,Rafael Nadal,,R64,0,0,0,0,0,0,0,0,0,0,0,0,0,0,0,0,0,0,0,0,0,0,0,0,0,0,0
2014-10-05 00:00:00.000,ATP World Tour Masters 1000 Shanghai Shanghai; China ATP World Tour Masters 1000,HARD,2,Novak Djokovic,Dominic Thiem,Novak Djokovic,6-3; 6-4,R32,88,7,1,43,55,35,43,7,12,2,2,10,42,55,5,3,40,73,28,40,14,33,6,8,9,42,73
2014-10-05 00:00:00.000,ATP World Tour Masters 1000 Shanghai Shanghai; China ATP World Tour Masters 1000,HARD,2,Mikhail Kukushkin,Kevin Anderson,Mikhail Kukushkin,6-4; 6-2,R32,69,3,1,32,47,29,32,9,15,2,2,9,38,47,5,1,36,49,26,36,4,13,3,6,9,30,49
2014-10-05 00:00:00.000,ATP World Tour Masters 1000 Shanghai Shanghai; China ATP World Tour Masters 1000,HARD,2,Andy Murray,Jerzy Janowicz,Andy Murray,7-5; 6-2,R32,89,10,0,39,57,32,39,12,18,2,2,10,44,57,4,6,48,70,33,48,7,22,5,8,10,40,70
2014-10-05 00:00:00.000,ATP World Tour Masters 1000 Shanghai Shanghai; China ATP World Tour Masters 1000,HARD,2,David Ferrer,Martin Klizan,David Ferrer,4-6; 7-6(4); 6-4,R32,148,9,4,75,100,53,75,13,25,5,8,16,66,100,6,1,79,118,49,79,20,39,2,5,16,69,118
2014-10-05 00:00:00.000,ATP World Tour Masters 1000 Shanghai Shanghai; China ATP World Tour Masters 1000,HARD,2,Roger Federer,Leonardo Mayer,Roger Federer,7-5; 3-6; 7-6(7),R32,162,10,2,92,130,63,92,19,38,9,12,17,82,130,3,1,75,117,49,75,25,42,6,8,16,74,117
2014-10-05 00:00:00.000,ATP World Tour Masters 1000 Shanghai Shanghai; China ATP World Tour Masters 1000,HARD,2,Roberto Bautista Agut,Vasek Pospisil,Roberto Bautista Agut,7-6(1); 3-6; 6-4,R32,133,2,4,75,112,52,75,20,37,6,8,16,72,112,15,3,60,90,45,60,17,30,2,3,15,62,90
2014-10-05 00:00:00.000,ATP World Tour Masters 1000 Shanghai Shanghai; China ATP World Tour Masters 1000,HARD,2,Julien Benneteau,Grigor Dimitrov,Julien Benneteau,7-5; 6-3,R32,81,6,0,36,51,25,36,13,15,0,1,10,38,51,9,5,50,80,34,50,10,30,7,11,11,44,80
2014-10-05 00:00:00.000,ATP World Tour Masters 1000 Shanghai Shanghai; China ATP World Tour Masters 1000,HARD,2,Jack Sock,Kei Nishikori,Jack Sock,7-6(5); 6-4,R32,84,13,1,44,61,36,44,13,17,0,0,11,49,61,5,2,41,69,28,41,20,28,0,1,11,48,69
2014-10-05 00:00:00.000,ATP World Tour Masters 1000 Shanghai Shanghai; China ATP World Tour Masters 1000,HARD,2,Tomas Berdych,Richard Gasquet,Tomas Berdych,6-3; 6-1,R32,52,10,0,25,37,24,25,8,12,0,0,8,32,37,1,2,32,42,18,32,4,10,1,5,8,22,42
2014-10-05 00:00:00.000,ATP World Tour Masters 1000 Shanghai Shanghai; China ATP World Tour Masters 1000,HARD,2,Ivo Karlovic,Yen-Hsun Lu,Ivo Karlovic,7-6(6); 6-3,R32,77,24,0,41,59,37,41,13,18,0,0,11,50,59,6,0,51,65,39,51,6,14,0,1,10,45,65
2014-10-05 00:00:00.000,ATP World Tour Masters 1000 Shanghai Shanghai; China ATP World Tour Masters 1000,HARD,2,Malek Jaziri,Chuhan Wang,Malek Jaziri,6-0; 6-4,R32,70,7,2,30,58,25,30,13,28,4,5,8,38,58,1,4,31,50,15,31,6,19,2,7,8,21,50
2014-10-05 00:00:00.000,ATP World Tour Masters 1000 Shanghai Shanghai; China ATP World Tour Masters 1000,HARD,2,Gilles Simon,Stan Wawrinka,Gilles Simon,5-7; 7-5; 6-4,R32,150,7,1,63,116,43,63,29,53,2,5,17,72,116,12,3,58,95,46,58,16,37,7,11,17,62,95
2014-10-05 00:00:00.000,ATP World Tour Masters 1000 Shanghai Shanghai; China ATP World Tour Masters 1000,HARD,2,Juan Monaco,Milos Raonic,Juan Monaco,5-2 RET,R32,24,0,0,14,18,12,14,4,4,0,0,4,16,18,4,2,15,22,10,15,2,7,1,2,3,12,22
2014-10-05 00:00:00.000,ATP World Tour Masters 1000 Shanghai Shanghai; China ATP World Tour Masters 1000,HARD,2,Mikhail Youzhny,Ivan Dodig,Mikhail Youzhny,7-6(7); 6-7(4); 6-3,R32,169,10,3,86,136,60,86,29,50,7,7,17,89,136,26,5,70,106,58,70,16,36,1,2,16,74,106
2014-10-05 00:00:00.000,ATP World Tour Masters 1000 Shanghai Shanghai; China ATP World Tour Masters 1000,HARD,2,John Isner,Steve Johnson,John Isner,7-6(6); 7-6(7),R32,100,24,0,63,79,51,63,9,16,0,0,12,60,79,9,1,63,92,46,63,18,29,5,5,12,64,92
2014-10-05 00:00:00.000,ATP World Tour Masters 1000 Shanghai Shanghai; China ATP World Tour Masters 1000,HARD,2,Feliciano Lopez,Rafael Nadal,Feliciano Lopez,6-3; 7-6(6),R32,104,15,3,45,79,34,45,20,34,4,5,11,54,79,5,1,46,68,29,46,13,22,2,4,10,42,68
2014-10-05 00:00:00.000,ATP World Tour Masters 1000 Shanghai Shanghai; China ATP World Tour Masters 1000,HARD,2,Novak Djokovic,Mikhail Kukushkin,Novak Djokovic,6-3; 4-6; 6-4,R16,126,13,2,65,95,49,65,14,30,3,5,15,63,95,9,0,60,84,40,60,14,24,5,8,14,54,84
2014-10-05 00:00:00.000,ATP World Tour Masters 1000 Shanghai Shanghai; China ATP World Tour Masters 1000,HARD,2,David Ferrer,Andy Murray,David Ferrer,2-6; 6-1; 6-2,R16,115,0,0,51,80,37,51,12,29,4,6,12,49,80,8,0,47,70,35,47,6,23,3,7,11,41,70
2014-10-05 00:00:00.000,ATP World Tour Masters 1000 Shanghai Shanghai; China ATP World Tour Masters 1000,HARD,2,Roger Federer,Roberto Bautista Agut,Roger Federer,6-4; 6-2,R16,73,8,0,37,53,32,37,8,16,1,1,9,40,53,0,0,38,60,25,38,9,22,6,9,9,34,60
2014-10-05 00:00:00.000,ATP World Tour Masters 1000 Shanghai Shanghai; China ATP World Tour Masters 1000,HARD,2,Julien Benneteau,Jack Sock,Julien Benneteau,6-3; 6-4,R16,71,5,1,50,62,40,50,5,12,3,3,10,45,62,1,3,31,49,23,31,9,18,2,4,9,32,49
2014-10-05 00:00:00.000,ATP World Tour Masters 1000 Shanghai Shanghai; China ATP World Tour Masters 1000,HARD,2,Tomas Berdych,Ivo Karlovic,Tomas Berdych,6-3; 6-4,R16,65,10,0,29,46,26,29,14,17,0,0,10,40,46,19,1,34,52,26,34,6,18,4,6,9,32,52
2014-10-05 00:00:00.000,ATP World Tour Masters 1000 Shanghai Shanghai; China ATP World Tour Masters 1000,HARD,2,Gilles Simon,Malek Jaziri,Gilles Simon,6-2; 6-3,R16,73,2,1,37,56,28,37,12,19,3,3,9,40,56,2,1,31,54,19,31,10,23,5,8,8,29,54
2014-10-05 00:00:00.000,ATP World Tour Masters 1000 Shanghai Shanghai; China ATP World Tour Masters 1000,HARD,2,Mikhail Youzhny,Juan Monaco,Mikhail Youzhny,5-7; 6-3; 6-2,R16,130,5,1,56,87,41,56,16,31,6,9,15,57,87,5,2,53,84,33,53,14,31,6,11,14,47,84
2014-10-05 00:00:00.000,ATP World Tour Masters 1000 Shanghai Shanghai; China ATP World Tour Masters 1000,HARD,2,Feliciano Lopez,John Isner,Feliciano Lopez,6-3; 6-4,R16,60,8,1,34,51,30,34,11,17,1,1,10,41,51,14,3,37,57,25,37,10,20,2,4,9,35,57
2014-10-05 00:00:00.000,ATP World Tour Masters 1000 Shanghai Shanghai; China ATP World Tour Masters 1000,HARD,2,Novak Djokovic,David Ferrer,Novak Djokovic,6-4; 6-2,Q,95,4,0,38,53,32,38,9,15,2,2,9,41,53,2,1,42,74,31,42,10,32,4,7,9,41,74
2014-10-05 00:00:00.000,ATP World Tour Masters 1000 Shanghai Shanghai; China ATP World Tour Masters 1000,HARD,2,Roger Federer,Julien Benneteau,Roger Federer,7-6(4); 6-0,Q,70,11,0,37,48,34,37,4,11,0,0,9,38,48,5,1,48,64,25,48,8,16,1,4,9,33,64
2014-10-05 00:00:00.000,ATP World Tour Masters 1000 Shanghai Shanghai; China ATP World Tour Masters 1000,HARD,2,Gilles Simon,Tomas Berdych,Gilles Simon,7-6(4); 4-6; 6-0,Q,148,8,1,64,97,51,64,15,33,3,5,14,66,97,18,4,63,111,50,63,15,48,8,12,14,65,111
2014-10-05 00:00:00.000,ATP World Tour Masters 1000 Shanghai Shanghai; China ATP World Tour Masters 1000,HARD,2,Feliciano Lopez,Mikhail Youzhny,Feliciano Lopez,5-7; 6-4; 6-4,Q,123,12,5,46,87,40,46,20,41,6,10,16,60,87,4,0,67,97,41,67,16,30,3,8,16,57,97
2014-10-05 00:00:00.000,ATP World Tour Masters 1000 Shanghai Shanghai; China ATP World Tour Masters 1000,HARD,2,Roger Federer,Novak Djokovic,Roger Federer,6-4; 6-4,S,96,8,1,51,72,35,51,13,21,1,1,10,48,72,5,0,53,77,32,53,13,24,8,10,10,45,77
2014-10-05 00:00:00.000,ATP World Tour Masters 1000 Shanghai Shanghai; China ATP World Tour Masters 1000,HARD,2,Gilles Simon,Feliciano Lopez,Gilles Simon,6-2; 7-6(1),S,80,5,0,34,51,32,34,12,17,0,0,10,44,51,7,2,47,75,35,47,8,28,2,4,10,43,75
2014-10-05 00:00:00.000,ATP World Tour Masters 1000 Shanghai Shanghai; China ATP World Tour Masters 1000,HARD,2,Roger Federer,Gilles Simon,Roger Federer,7-6(6); 7-6(2),F,113,4,0,50,71,39,50,15,21,2,3,12,54,71,3,1,46,90,28,46,28,44,6,7,12,56,90
2014-10-13 00:00:00.000,Moscow Russia ATP World Tour 250,HARD,2,Milos Raonic,N/A Bye,Milos Raonic,,R32,0,0,0,0,0,0,0,0,0,0,0,0,0,0,0,0,0,0,0,0,0,0,0,0,0,0,0
2014-10-13 00:00:00.000,Moscow Russia ATP World Tour 250,HARD,2,Ricardas Berankis,Aslan Karatsev,Ricardas Berankis,6-3; 6-4,R32,84,2,1,43,70,29,43,15,27,4,5,10,44,70,2,3,40,59,24,40,10,19,5,8,9,34,59
2014-10-13 00:00:00.000,Moscow Russia ATP World Tour 250,HARD,2,Sam Groth,Andrey Rublev,Sam Groth,7-6(4); 7-5,R32,92,20,2,41,74,37,41,18,33,1,1,12,55,74,4,0,45,71,35,45,15,26,3,4,12,50,71
2014-10-13 00:00:00.000,Moscow Russia ATP World Tour 250,HARD,2,Roberto Bautista Agut,Andrey Kuznetsov,Roberto Bautista Agut,6-3; 6-4,R32,79,3,1,38,65,25,38,15,27,1,3,10,40,65,1,2,33,61,20,33,11,28,7,11,9,31,61
2014-10-13 00:00:00.000,Moscow Russia ATP World Tour 250,HARD,2,Ernests Gulbis,N/A Bye,Ernests Gulbis,,R32,0,0,0,0,0,0,0,0,0,0,0,0,0,0,0,0,0,0,0,0,0,0,0,0,0,0,0
2014-10-13 00:00:00.000,Moscow Russia ATP World Tour 250,HARD,2,Daniel Gimeno-Traver,Jiri Vesely,Daniel Gimeno-Traver,7-5; 6-3,R32,82,7,1,32,55,29,32,13,23,3,4,11,42,55,2,2,55,76,38,55,6,21,9,12,10,44,76
2014-10-13 00:00:00.000,Moscow Russia ATP World Tour 250,HARD,2,Ivan Dodig,Pere Riba,Ivan Dodig,6-4; 6-2,R32,53,12,3,34,52,28,34,6,18,2,3,9,34,52,1,1,29,47,17,29,10,18,2,6,9,27,47
2014-10-13 00:00:00.000,Moscow Russia ATP World Tour 250,HARD,2,Andreas Seppi,Dusan Lajovic,Andreas Seppi,7-5; 6-4,R32,84,9,1,45,70,34,45,17,25,2,2,11,51,70,5,0,41,68,30,41,14,27,5,7,11,44,68
2014-10-13 00:00:00.000,Moscow Russia ATP World Tour 250,HARD,2,Mikhail Youzhny,Victor Baluda,Mikhail Youzhny,6-3; 6-4,R32,89,2,1,26,55,21,26,19,29,0,1,10,40,55,4,2,44,70,26,44,14,26,5,8,9,40,70
2014-10-13 00:00:00.000,Moscow Russia ATP World Tour 250,HARD,2,Juan Monaco,Paolo Lorenzi,Juan Monaco,6-3; 5-7; 6-3,R32,146,3,3,65,94,42,65,15,29,6,10,15,57,94,4,2,62,100,37,62,18,38,6,12,15,55,100
2014-10-13 00:00:00.000,Moscow Russia ATP World Tour 250,HARD,2,Mikhail Kukushkin,Karen Khachanov,Mikhail Kukushkin,6-7(3); 6-0; 6-2,R32,124,6,1,56,89,41,56,16,33,2,3,13,57,89,4,3,56,90,32,56,14,34,9,15,13,46,90
2014-10-13 00:00:00.000,Moscow Russia ATP World Tour 250,HARD,2,Fabio Fognini,N/A Bye,Fabio Fognini,,R32,0,0,0,0,0,0,0,0,0,0,0,0,0,0,0,0,0,0,0,0,0,0,0,0,0,0,0
2014-10-13 00:00:00.000,Moscow Russia ATP World Tour 250,HARD,2,Tommy Robredo,Pedja Krstin,Tommy Robredo,7-6(6); 6-4,R32,87,7,0,40,61,30,40,14,21,1,3,11,44,61,2,4,44,67,26,44,13,23,1,4,11,39,67
2014-10-13 00:00:00.000,Moscow Russia ATP World Tour 250,HARD,2,Filip Krajinovic,Malek Jaziri,Filip Krajinovic,6-4; 6-2,R32,68,4,0,30,49,23,30,13,19,1,2,9,36,49,5,1,39,79,26,39,14,40,11,15,9,40,79
2014-10-13 00:00:00.000,Moscow Russia ATP World Tour 250,HARD,2,Evgeny Donskoy,Dudi Sela,Evgeny Donskoy,6-4; 6-0,R32,63,8,2,26,46,23,26,12,20,3,3,8,35,46,1,5,34,61,20,34,11,27,6,10,8,31,61
2014-10-13 00:00:00.000,Moscow Russia ATP World Tour 250,HARD,2,Marin Cilic,N/A Bye,Marin Cilic,,R32,0,0,0,0,0,0,0,0,0,0,0,0,0,0,0,0,0,0,0,0,0,0,0,0,0,0,0
2014-10-13 00:00:00.000,Moscow Russia ATP World Tour 250,HARD,2,Ricardas Berankis,Milos Raonic,Ricardas Berankis,6-3; 4-6; 6-3,R16,113,7,3,59,83,42,59,12,24,3,5,14,54,83,15,3,50,85,38,50,14,35,3,7,14,52,85
2014-10-13 00:00:00.000,Moscow Russia ATP World Tour 250,HARD,2,Roberto Bautista Agut,Sam Groth,Roberto Bautista Agut,7-6(5); 7-6(4),R16,84,7,0,45,71,39,45,21,26,0,0,12,60,71,19,1,51,72,40,51,16,21,2,2,12,56,72
2014-10-13 00:00:00.000,Moscow Russia ATP World Tour 250,HARD,2,Ernests Gulbis,Daniel Gimeno-Traver,Ernests Gulbis,6-3; 7-6(3),R16,89,6,1,47,74,33,47,15,27,1,3,11,48,74,1,3,43,70,25,43,15,27,4,7,10,40,70
2014-10-13 00:00:00.000,Moscow Russia ATP World Tour 250,HARD,2,Andreas Seppi,Ivan Dodig,Andreas Seppi,7-5; 7-6(3),R16,111,4,7,60,101,43,60,18,41,10,12,12,61,101,13,1,47,77,36,47,11,30,1,4,12,47,77
2014-10-13 00:00:00.000,Moscow Russia ATP World Tour 250,HARD,2,Mikhail Youzhny,Juan Monaco,Mikhail Youzhny,6-3; 7-6(6),R16,102,3,1,45,80,31,45,20,35,4,6,11,51,80,1,1,49,65,29,49,10,16,3,6,10,39,65
2014-10-13 00:00:00.000,Moscow Russia ATP World Tour 250,HARD,2,Mikhail Kukushkin,Fabio Fognini,Mikhail Kukushkin,6-4; 6-2,R16,76,3,1,34,59,24,34,12,25,2,4,9,36,59,4,8,34,65,20,34,10,31,6,11,9,30,65
2014-10-13 00:00:00.000,Moscow Russia ATP World Tour 250,HARD,2,Tommy Robredo,Filip Krajinovic,Tommy Robredo,6-3; 6-4,R16,60,10,1,37,52,35,37,7,15,2,2,10,42,52,2,1,30,50,21,30,12,20,5,7,9,33,50
2014-10-13 00:00:00.000,Moscow Russia ATP World Tour 250,HARD,2,Marin Cilic,Evgeny Donskoy,Marin Cilic,6-3; 3-6; 6-3,R16,113,8,3,51,88,39,51,18,37,3,5,14,57,88,5,1,40,69,31,40,14,29,2,5,13,45,69
2014-10-13 00:00:00.000,Moscow Russia ATP World Tour 250,HARD,2,Roberto Bautista Agut,Ricardas Berankis,Roberto Bautista Agut,7-5; 6-3,Q,97,9,4,59,89,42,59,14,30,12,13,11,56,89,0,2,37,61,23,37,10,24,3,6,10,33,61
2014-10-13 00:00:00.000,Moscow Russia ATP World Tour 250,HARD,2,Ernests Gulbis,Andreas Seppi,Ernests Gulbis,7-6(6); 4-6; 7-6(3),Q,148,17,5,64,112,55,64,19,48,3,5,17,74,112,7,6,64,108,50,64,26,44,1,2,17,76,108
2014-10-13 00:00:00.000,Moscow Russia ATP World Tour 250,HARD,2,Mikhail Kukushkin,Mikhail Youzhny,Mikhail Kukushkin,1-6; 7-6(5); 6-0,Q,132,4,1,54,82,40,54,13,28,1,4,12,53,82,5,1,60,93,41,60,14,33,4,8,13,55,93
2014-10-13 00:00:00.000,Moscow Russia ATP World Tour 250,HARD,2,Marin Cilic,Tommy Robredo,Marin Cilic,6-3; 6-3,Q,77,10,1,39,65,32,39,10,26,6,7,9,42,65,1,1,34,54,21,34,8,20,5,9,9,29,54
2014-10-13 00:00:00.000,Moscow Russia ATP World Tour 250,HARD,2,Roberto Bautista Agut,Ernests Gulbis,Roberto Bautista Agut,6-4; 6-4,S,83,4,4,33,57,27,33,16,24,1,1,10,43,57,7,0,39,67,29,39,13,28,6,8,10,42,67
2014-10-13 00:00:00.000,Moscow Russia ATP World Tour 250,HARD,2,Marin Cilic,Mikhail Kukushkin,Marin Cilic,4-6; 6-3; 6-2,S,133,10,1,53,98,40,53,22,45,6,8,14,62,98,1,1,59,96,33,59,22,37,9,13,13,55,96
2014-10-13 00:00:00.000,Moscow Russia ATP World Tour 250,HARD,2,Marin Cilic,Roberto Bautista Agut,Marin Cilic,6-4; 6-4,F,84,10,1,47,71,32,47,16,24,6,6,10,48,71,2,1,40,59,28,40,11,19,2,4,10,39,59
2014-10-13 00:00:00.000,Stockholm Sweden ATP World Tour 250,HARD,2,Tomas Berdych,N/A Bye,Tomas Berdych,,R32,0,0,0,0,0,0,0,0,0,0,0,0,0,0,0,0,0,0,0,0,0,0,0,0,0,0,0
2014-10-13 00:00:00.000,Stockholm Sweden ATP World Tour 250,HARD,2,Dustin Brown,Christian Lindell,Dustin Brown,6-4; 7-6(3),R32,80,10,6,58,83,42,58,11,25,4,6,11,53,83,8,6,42,65,33,42,7,23,3,6,11,40,65
2014-10-13 00:00:00.000,Stockholm Sweden ATP World Tour 250,HARD,2,Pierre-Hugues Herbert,Pablo Carreno Busta,Pierre-Hugues Herbert,7-6(3); 6-4,R32,74,12,2,36,59,29,36,18,23,0,0,11,47,59,4,3,42,66,34,42,12,24,3,4,11,46,66
2014-10-13 00:00:00.000,Stockholm Sweden ATP World Tour 250,HARD,2,Marius Copil,Joao Sousa,Marius Copil,7-6(4); 4-6; 6-4,R32,146,18,3,61,105,47,61,30,44,10,11,16,77,105,3,3,70,114,52,70,25,44,7,8,16,77,114
2014-10-13 00:00:00.000,Stockholm Sweden ATP World Tour 250,HARD,2,Alexandr Dolgopolov,N/A Bye,Alexandr Dolgopolov,,R32,0,0,0,0,0,0,0,0,0,0,0,0,0,0,0,0,0,0,0,0,0,0,0,0,0,0,0
2014-10-13 00:00:00.000,Stockholm Sweden ATP World Tour 250,HARD,2,Adrian Mannarino,Marcos Baghdatis,Adrian Mannarino,2-6; 6-2; 6-4,R32,123,6,0,57,94,38,57,21,37,12,14,13,59,94,11,3,47,88,32,47,20,41,8,11,13,52,88
2014-10-13 00:00:00.000,Stockholm Sweden ATP World Tour 250,HARD,2,Matthias Bachinger,Igor Sijsling,Matthias Bachinger,2-6; 7-6(3); 6-4,R32,96,5,2,70,93,53,70,10,23,5,7,15,63,93,5,3,64,100,45,64,19,36,5,6,15,64,100
2014-10-13 00:00:00.000,Stockholm Sweden ATP World Tour 250,HARD,2,Leonardo Mayer,Donald Young,Leonardo Mayer,6-4; 6-4,R32,76,6,2,30,49,27,30,13,19,0,0,10,40,49,2,4,57,86,35,57,14,29,8,10,10,49,86
2014-10-13 00:00:00.000,Stockholm Sweden ATP World Tour 250,HARD,2,Fernando Verdasco,Marinko Matosevic,Fernando Verdasco,6-3; 3-6; 6-3,R32,107,8,4,55,90,47,55,15,35,8,9,14,62,90,4,2,44,79,30,44,22,35,4,6,13,52,79
2014-10-13 00:00:00.000,Stockholm Sweden ATP World Tour 250,HARD,2,Jarkko Nieminen,Albert Ramos-Vinolas,Jarkko Nieminen,6-4; 6-4,R32,93,5,4,53,73,39,53,8,20,2,3,10,47,73,2,1,38,65,23,38,14,27,8,11,10,37,65
2014-10-13 00:00:00.000,Stockholm Sweden ATP World Tour 250,HARD,2,Bernard Tomic,Patrik Rosenholm,Bernard Tomic,7-6(1); 5-7; 6-4,R32,116,19,2,68,104,51,68,21,36,1,3,17,72,104,13,1,59,95,46,59,21,36,3,5,17,67,95
2014-10-13 00:00:00.000,Stockholm Sweden ATP World Tour 250,HARD,2,Kevin Anderson,N/A Bye,Kevin Anderson,,R32,0,0,0,0,0,0,0,0,0,0,0,0,0,0,0,0,0,0,0,0,0,0,0,0,0,0,0
2014-10-13 00:00:00.000,Stockholm Sweden ATP World Tour 250,HARD,2,Jeremy Chardy,Elias Ymer,Jeremy Chardy,6-3; 6-4,R32,69,6,3,41,64,31,41,12,23,5,6,10,43,64,2,2,25,44,17,25,10,19,0,3,9,27,44
2014-10-13 00:00:00.000,Stockholm Sweden ATP World Tour 250,HARD,2,Jack Sock,Andrey Golubev,Jack Sock,6-1; 4-6; 6-0,R32,103,11,3,38,64,32,38,14,26,2,3,11,46,64,5,6,60,96,33,60,16,36,11,17,12,49,96
2014-10-13 00:00:00.000,Stockholm Sweden ATP World Tour 250,HARD,2,Teymuraz Gabashvili,Alejandro Falla,Teymuraz Gabashvili,6-2; 6-4,R32,70,3,4,32,61,25,32,8,29,5,8,9,33,61,1,1,28,53,17,28,5,25,3,9,9,22,53
2014-10-13 00:00:00.000,Stockholm Sweden ATP World Tour 250,HARD,2,Grigor Dimitrov,N/A Bye,Grigor Dimitrov,,R32,0,0,0,0,0,0,0,0,0,0,0,0,0,0,0,0,0,0,0,0,0,0,0,0,0,0,0
2014-10-13 00:00:00.000,Stockholm Sweden ATP World Tour 250,HARD,2,Tomas Berdych,Dustin Brown,Tomas Berdych,7-5; 6-3,R16,84,7,2,32,60,30,32,17,28,3,3,11,47,60,5,4,45,69,35,45,9,24,6,8,10,44,69
2014-10-13 00:00:00.000,Stockholm Sweden ATP World Tour 250,HARD,2,Marius Copil,Pierre-Hugues Herbert,Marius Copil,6-4; 6-3,R16,71,6,0,31,48,26,31,11,17,0,0,9,37,48,7,7,43,74,29,43,14,31,6,9,10,43,74
2014-10-13 00:00:00.000,Stockholm Sweden ATP World Tour 250,HARD,2,Adrian Mannarino,Alexandr Dolgopolov,Adrian Mannarino,6-4; 6-7(2); 7-6(4),R16,160,7,3,75,117,56,75,24,42,10,12,17,80,117,11,3,58,126,47,58,34,68,6,9,17,81,126
2014-10-13 00:00:00.000,Stockholm Sweden ATP World Tour 250,HARD,2,Matthias Bachinger,Leonardo Mayer,Matthias Bachinger,7-6(3); 6-7(4); 6-3,R16,122,15,3,73,107,53,73,25,34,2,3,17,78,107,7,2,62,95,47,62,20,33,5,7,16,67,95
2014-10-13 00:00:00.000,Stockholm Sweden ATP World Tour 250,HARD,2,Fernando Verdasco,Jarkko Nieminen,Fernando Verdasco,6-3; 6-4,R16,89,4,2,46,72,32,46,13,26,3,5,10,45,72,1,1,38,70,23,38,14,32,9,13,9,37,70
2014-10-13 00:00:00.000,Stockholm Sweden ATP World Tour 250,HARD,2,Bernard Tomic,Kevin Anderson,Bernard Tomic,7-6(4); 6-4,R16,85,7,0,47,71,36,47,15,24,3,3,11,51,71,15,1,40,55,32,40,11,15,0,1,11,43,55
2014-10-13 00:00:00.000,Stockholm Sweden ATP World Tour 250,HARD,2,Jack Sock,Jeremy Chardy,Jack Sock,7-6(3); 6-3,R16,79,14,3,43,72,37,43,14,29,2,2,11,51,72,13,1,36,53,30,36,9,17,0,1,10,39,53
2014-10-13 00:00:00.000,Stockholm Sweden ATP World Tour 250,HARD,2,Grigor Dimitrov,Teymuraz Gabashvili,Grigor Dimitrov,7-5; 7-6(4),R16,114,8,4,52,89,34,52,18,37,4,7,12,52,89,3,2,51,77,30,51,13,26,1,5,12,43,77
2014-10-13 00:00:00.000,Stockholm Sweden ATP World Tour 250,HARD,2,Tomas Berdych,Marius Copil,Tomas Berdych,6-2; 6-2,Q,67,8,4,24,47,22,24,14,23,3,3,8,36,47,10,3,39,62,24,39,8,23,5,9,8,32,62
2014-10-13 00:00:00.000,Stockholm Sweden ATP World Tour 250,HARD,2,Matthias Bachinger,Adrian Mannarino,Matthias Bachinger,4-6; 6-1; 6-4,Q,102,13,0,38,68,35,38,14,30,1,3,14,49,68,4,4,58,87,37,58,12,29,3,7,13,49,87
2014-10-13 00:00:00.000,Stockholm Sweden ATP World Tour 250,HARD,2,Bernard Tomic,Fernando Verdasco,Bernard Tomic,0-6; 6-4; 7-6(6),Q,120,7,2,58,90,40,58,15,32,4,9,14,55,90,10,4,66,97,46,66,15,31,3,6,14,61,97
2014-10-13 00:00:00.000,Stockholm Sweden ATP World Tour 250,HARD,2,Grigor Dimitrov,Jack Sock,Grigor Dimitrov,5-7; 6-4; 6-3,Q,119,5,2,65,92,51,65,17,27,6,7,16,68,92,9,2,63,95,42,63,19,32,6,8,15,61,95
2014-10-13 00:00:00.000,Stockholm Sweden ATP World Tour 250,HARD,2,Tomas Berdych,Matthias Bachinger,Tomas Berdych,7-6(7); 6-4,S,86,9,1,44,66,34,44,12,22,2,4,11,46,66,8,2,42,68,31,42,11,26,1,4,11,42,68
2014-10-13 00:00:00.000,Stockholm Sweden ATP World Tour 250,HARD,2,Grigor Dimitrov,Bernard Tomic,Grigor Dimitrov,6-3; 7-5,S,79,7,3,42,68,33,42,13,26,3,4,11,46,68,4,1,40,63,27,40,10,23,1,4,10,37,63
2014-10-13 00:00:00.000,Stockholm Sweden ATP World Tour 250,HARD,2,Tomas Berdych,Grigor Dimitrov,Tomas Berdych,5-7; 6-4; 6-4,F,141,13,1,53,93,40,53,24,40,4,6,16,64,93,8,3,72,103,46,72,19,31,5,8,16,65,103
2014-10-13 00:00:00.000,Vienna Austria ATP World Tour 250,HARD,2,David Ferrer,N/A Bye,David Ferrer,,R32,0,0,0,0,0,0,0,0,0,0,0,0,0,0,0,0,0,0,0,0,0,0,0,0,0,0,0
2014-10-13 00:00:00.000,Vienna Austria ATP World Tour 250,HARD,2,Tobias Kamke,Simone Bolelli,Tobias Kamke,3-6; 6-3; 6-4,R32,135,4,3,46,92,31,46,27,46,3,6,14,58,92,4,8,58,106,39,58,22,48,7,11,14,61,106
2014-10-13 00:00:00.000,Vienna Austria ATP World Tour 250,HARD,2,Jurgen Melzer,Norbert Gombos,Jurgen Melzer,3-6; 6-4; 6-3,R32,125,4,6,59,95,40,59,17,36,10,13,14,57,95,7,9,53,84,37,53,13,31,6,10,14,50,84
2014-10-13 00:00:00.000,Vienna Austria ATP World Tour 250,HARD,2,Ivo Karlovic,Federico Delbonis,Ivo Karlovic,6-7(1); 7-6(9); 7-6(2),R32,146,29,7,77,106,68,77,18,29,0,0,18,86,106,13,6,63,112,56,63,32,49,0,0,18,88,112
2014-10-13 00:00:00.000,Vienna Austria ATP World Tour 250,HARD,2,Philipp Kohlschreiber,N/A Bye,Philipp Kohlschreiber,,R32,0,0,0,0,0,0,0,0,0,0,0,0,0,0,0,0,0,0,0,0,0,0,0,0,0,0,0
2014-10-13 00:00:00.000,Vienna Austria ATP World Tour 250,HARD,2,Carlos Berlocq,Gerald Melzer,Carlos Berlocq,6-3; 7-6(2),R32,97,5,2,36,65,24,36,18,29,2,5,10,42,65,1,3,40,70,25,40,11,30,3,8,11,36,70
2014-10-13 00:00:00.000,Vienna Austria ATP World Tour 250,HARD,2,Benjamin Becker,Victor Hanescu,Benjamin Becker,4-6; 6-1; 6-3,R32,98,8,3,39,65,32,39,16,26,1,3,13,48,65,9,3,59,85,35,59,11,26,5,10,13,46,85
2014-10-13 00:00:00.000,Vienna Austria ATP World Tour 250,HARD,2,Robin Haase,Dominic Thiem,Robin Haase,6-3; 3-6; 6-3,R32,91,11,0,45,72,35,45,16,27,2,4,14,51,72,7,3,30,68,27,30,19,38,2,5,13,46,68
2014-10-13 00:00:00.000,Vienna Austria ATP World Tour 250,HARD,2,Lukas Rosol,Lukas Lacko,Lukas Rosol,6-2; 6-4,R32,61,5,0,25,54,20,25,19,29,0,0,9,39,54,6,2,28,51,19,28,10,23,1,4,9,29,51
2014-10-13 00:00:00.000,Vienna Austria ATP World Tour 250,HARD,2,Viktor Troicki,Victor Estrella Burgos,Viktor Troicki,6-0; 6-3,R32,55,14,1,25,37,22,25,10,12,0,0,8,32,37,1,2,29,54,17,29,10,25,6,10,7,27,54
2014-10-13 00:00:00.000,Vienna Austria ATP World Tour 250,HARD,2,Thomaz Bellucci,Paul-Henri Mathieu,Thomaz Bellucci,6-1; 6-4,R32,76,12,2,28,49,22,28,14,21,2,2,8,36,49,1,5,28,66,17,28,18,38,5,9,9,35,66
2014-10-13 00:00:00.000,Vienna Austria ATP World Tour 250,HARD,2,Feliciano Lopez,N/A Bye,Feliciano Lopez,,R32,0,0,0,0,0,0,0,0,0,0,0,0,0,0,0,0,0,0,0,0,0,0,0,0,0,0,0
2014-10-13 00:00:00.000,Vienna Austria ATP World Tour 250,HARD,2,Jan-Lennard Struff,Guillermo Garcia-Lopez,Jan-Lennard Struff,6-3; 6-4,R32,69,9,3,36,58,31,36,12,22,3,3,10,43,58,3,2,23,49,15,23,16,26,2,4,9,31,49
2014-10-13 00:00:00.000,Vienna Austria ATP World Tour 250,HARD,2,Sergiy Stakhovsky,Miloslav Mecir,Sergiy Stakhovsky,6-2; 4-6; 6-3,R32,96,7,1,46,82,37,46,21,36,3,4,14,58,82,6,6,51,83,38,51,14,32,3,6,13,52,83
2014-10-13 00:00:00.000,Vienna Austria ATP World Tour 250,HARD,2,Vasek Pospisil,Daniel Brands,Vasek Pospisil,6-3; 6-7(3); 7-6(2),R32,141,27,10,68,124,56,68,27,56,6,8,17,83,124,1,3,73,103,55,73,13,30,3,6,16,68,103
2014-10-13 00:00:00.000,Vienna Austria ATP World Tour 250,HARD,2,Andy Murray,N/A Bye,Andy Murray,,R32,0,0,0,0,0,0,0,0,0,0,0,0,0,0,0,0,0,0,0,0,0,0,0,0,0,0,0
2014-10-13 00:00:00.000,Vienna Austria ATP World Tour 250,HARD,2,David Ferrer,Tobias Kamke,David Ferrer,7-5; 6-1,R16,89,1,4,39,68,31,39,14,29,2,2,10,45,68,1,2,29,57,18,29,14,28,6,9,9,32,57
2014-10-13 00:00:00.000,Vienna Austria ATP World Tour 250,HARD,2,Ivo Karlovic,Jurgen Melzer,Ivo Karlovic,6-4; 7-6(1),R16,99,21,1,51,71,42,51,13,20,3,3,11,55,71,3,4,56,77,37,56,11,21,4,5,11,48,77
2014-10-13 00:00:00.000,Vienna Austria ATP World Tour 250,HARD,2,Philipp Kohlschreiber,Carlos Berlocq,Philipp Kohlschreiber,3-6; 6-1; 6-4,R16,105,8,5,43,77,39,43,17,34,3,4,13,56,77,2,3,43,72,33,43,15,29,4,7,13,48,72
2014-10-13 00:00:00.000,Vienna Austria ATP World Tour 250,HARD,2,Benjamin Becker,Robin Haase,Benjamin Becker,6-3; 6-3,R16,59,5,1,25,45,23,25,13,20,0,0,9,36,45,4,6,35,53,25,35,4,18,4,7,9,29,53
2014-10-13 00:00:00.000,Vienna Austria ATP World Tour 250,HARD,2,Viktor Troicki,Lukas Rosol,Viktor Troicki,6-3; 6-2,R16,55,12,0,27,48,24,27,13,21,2,2,9,37,48,3,6,28,50,21,28,9,22,3,6,8,30,50
2014-10-13 00:00:00.000,Vienna Austria ATP World Tour 250,HARD,2,Thomaz Bellucci,Feliciano Lopez,Thomaz Bellucci,6-7(9); 6-1; 6-4,R16,122,11,2,55,95,43,55,23,40,3,5,15,66,95,9,5,51,97,34,51,21,46,5,10,14,55,97
2014-10-13 00:00:00.000,Vienna Austria ATP World Tour 250,HARD,2,Jan-Lennard Struff,Sergiy Stakhovsky,Jan-Lennard Struff,7-6(6); 2-6; 7-6(3),R16,145,12,3,48,105,35,48,32,57,4,8,16,67,105,4,6,72,120,51,72,24,48,7,9,16,75,120
2014-10-13 00:00:00.000,Vienna Austria ATP World Tour 250,HARD,2,Andy Murray,Vasek Pospisil,Andy Murray,6-4; 6-4,R16,99,1,3,32,66,25,32,19,34,5,6,10,44,66,3,8,38,74,28,38,15,36,3,6,10,43,74
2014-10-13 00:00:00.000,Vienna Austria ATP World Tour 250,HARD,2,David Ferrer,Ivo Karlovic,David Ferrer,7-6(5); 6-4,Q,85,5,2,37,62,32,37,17,25,0,0,11,49,62,17,5,49,69,40,49,9,20,2,3,11,49,69
2014-10-13 00:00:00.000,Vienna Austria ATP World Tour 250,HARD,2,Philipp Kohlschreiber,Benjamin Becker,Philipp Kohlschreiber,6-4; 7-6(3),Q,85,11,1,41,74,30,41,20,33,9,11,11,50,74,3,3,37,62,29,37,13,25,1,4,11,42,62
2014-10-13 00:00:00.000,Vienna Austria ATP World Tour 250,HARD,2,Viktor Troicki,Thomaz Bellucci,Viktor Troicki,7-6(4); 6-7(2); 6-2,Q,148,13,6,50,97,43,50,21,47,4,7,16,64,97,9,5,66,119,44,66,24,53,4,9,16,68,119
2014-10-13 00:00:00.000,Vienna Austria ATP World Tour 250,HARD,2,Andy Murray,Jan-Lennard Struff,Andy Murray,6-2; 7-5,Q,86,10,1,30,52,26,30,13,22,0,1,10,39,52,6,2,34,66,25,34,11,32,4,8,10,36,66
2014-10-13 00:00:00.000,Vienna Austria ATP World Tour 250,HARD,2,David Ferrer,Philipp Kohlschreiber,David Ferrer,6-3; 2-6; 7-6(3),S,147,3,6,49,95,34,49,29,46,8,11,15,63,95,4,6,60,114,42,60,24,54,6,8,14,66,114
2014-10-13 00:00:00.000,Vienna Austria ATP World Tour 250,HARD,2,Andy Murray,Viktor Troicki,Andy Murray,6-4; 6-3,S,83,2,4,30,50,25,30,10,20,0,1,9,35,50,5,4,37,75,26,37,14,38,7,11,10,40,75
2014-10-13 00:00:00.000,Vienna Austria ATP World Tour 250,HARD,2,Andy Murray,David Ferrer,Andy Murray,5-7; 6-2; 7-5,F,161,9,2,67,106,47,67,16,39,13,18,16,63,106,1,7,54,108,35,54,22,54,5,12,16,57,108
2014-10-20 00:00:00.000,Basel Switzerland ATP World Tour 500,HARD,2,Roger Federer,Gilles Muller,Roger Federer,6-2; 6-1,R32,46,9,2,21,36,20,21,12,15,0,0,8,32,36,3,2,20,38,11,20,8,18,1,5,7,19,38
2014-10-20 00:00:00.000,Basel Switzerland ATP World Tour 500,HARD,2,Denis Istomin,Jerzy Janowicz,Denis Istomin,6-1; 6-1,R32,55,14,2,26,41,22,26,8,15,2,2,7,30,41,2,7,30,59,17,30,10,29,6,11,7,27,59
2014-10-20 00:00:00.000,Basel Switzerland ATP World Tour 500,HARD,2,Vasek Pospisil,Jarkko Nieminen,Vasek Pospisil,6-3; 6-7(4); 6-4,R32,118,29,3,62,104,55,62,23,42,3,3,16,78,104,2,4,65,96,55,65,12,31,6,8,15,67,96
2014-10-20 00:00:00.000,Basel Switzerland ATP World Tour 500,HARD,2,Grigor Dimitrov,Alexander Zverev,Grigor Dimitrov,2-6; 6-4; 6-2,R32,105,7,5,43,80,31,43,20,37,11,14,13,51,80,4,3,49,76,32,49,14,27,1,5,13,46,76
2014-10-20 00:00:00.000,Basel Switzerland ATP World Tour 500,HARD,2,Mikhail Kukushkin,Stan Wawrinka,Mikhail Kukushkin,6-4; 6-7(1); 6-3,R32,133,2,1,50,90,39,50,23,40,4,6,16,62,90,3,4,48,97,38,48,26,49,6,10,15,64,97
2014-10-20 00:00:00.000,Basel Switzerland ATP World Tour 500,HARD,2,Benjamin Becker,Gastao Elias,Benjamin Becker,6-3; 6-2,R32,62,3,4,32,48,27,32,8,16,2,2,8,35,48,13,3,23,57,19,23,12,34,3,7,9,31,57
2014-10-20 00:00:00.000,Basel Switzerland ATP World Tour 500,HARD,2,Kenny De Schepper,Federico Delbonis,Kenny De Schepper,7-6(3); 7-5,R32,115,15,5,53,85,41,53,15,32,3,4,12,56,85,4,2,40,81,27,40,22,41,7,9,12,49,81
2014-10-20 00:00:00.000,Basel Switzerland ATP World Tour 500,HARD,2,Ivo Karlovic,Lukas Rosol,Ivo Karlovic,7-6(4); 6-3,R32,67,23,1,44,55,42,44,7,11,0,0,11,49,55,7,7,32,61,27,32,16,29,3,4,10,43,61
2014-10-20 00:00:00.000,Basel Switzerland ATP World Tour 500,HARD,2,David Goffin,Dominic Thiem,David Goffin,7-6(4); 6-3,R32,76,15,2,35,66,32,35,17,31,0,1,11,49,66,1,3,42,60,27,42,11,18,1,3,10,38,60
2014-10-20 00:00:00.000,Basel Switzerland ATP World Tour 500,HARD,2,Ivan Dodig,Marco Chiudinelli,Ivan Dodig,6-4; 6-7(7); 6-4,R32,172,17,3,55,115,43,55,28,60,9,12,16,71,115,2,4,61,120,41,61,28,59,9,14,16,69,120
2014-10-20 00:00:00.000,Basel Switzerland ATP World Tour 500,HARD,2,Donald Young,Carlos Berlocq,Donald Young,7-6(5); 6-4,R32,105,4,3,29,64,26,29,17,35,0,2,11,43,64,2,5,46,88,28,46,23,42,8,11,11,51,88
2014-10-20 00:00:00.000,Basel Switzerland ATP World Tour 500,HARD,2,Milos Raonic,Steve Johnson,Milos Raonic,7-6(4); 6-4,R32,90,12,1,36,74,29,36,26,38,5,5,11,55,74,5,1,35,66,26,35,21,31,1,2,11,47,66
2014-10-20 00:00:00.000,Basel Switzerland ATP World Tour 500,HARD,2,Borna Coric,Ernests Gulbis,Borna Coric,7-6(2); 6-3,R32,94,6,2,34,69,25,34,22,35,4,6,11,47,69,9,4,42,72,26,42,13,30,11,14,10,39,72
2014-10-20 00:00:00.000,Basel Switzerland ATP World Tour 500,HARD,2,Andrey Golubev,Teymuraz Gabashvili,Andrey Golubev,6-3; 6-3,R32,62,1,0,21,42,20,21,16,21,0,0,9,36,42,2,0,38,54,23,38,8,16,2,5,9,31,54
2014-10-20 00:00:00.000,Basel Switzerland ATP World Tour 500,HARD,2,Pierre-Hugues Herbert,Edouard Roger-Vasselin,Pierre-Hugues Herbert,6-3; 6-7(5); 7-6(3),R32,139,26,3,59,115,52,59,32,56,4,4,17,84,115,3,2,74,110,55,74,19,36,2,3,16,74,110
2014-10-20 00:00:00.000,Basel Switzerland ATP World Tour 500,HARD,2,Rafael Nadal,Simone Bolelli,Rafael Nadal,6-2; 6-2,R32,72,3,0,36,52,29,36,8,16,0,0,8,37,52,0,0,30,46,16,30,6,16,3,7,8,22,46
2014-10-20 00:00:00.000,Basel Switzerland ATP World Tour 500,HARD,2,Roger Federer,Denis Istomin,Roger Federer,3-6; 6-3; 6-4,R16,108,6,0,44,71,40,44,17,27,3,4,14,57,71,11,4,56,98,42,56,21,42,10,12,14,63,98
2014-10-20 00:00:00.000,Basel Switzerland ATP World Tour 500,HARD,2,Grigor Dimitrov,Vasek Pospisil,Grigor Dimitrov,6-2; 6-2,R16,64,3,3,29,48,25,29,9,19,0,0,8,34,48,4,4,25,53,19,25,10,28,7,11,8,29,53
2014-10-20 00:00:00.000,Basel Switzerland ATP World Tour 500,HARD,2,Benjamin Becker,Mikhail Kukushkin,Benjamin Becker,6-7(3); 7-6(4); 4-0 RET,R16,128,15,3,54,83,42,54,13,29,2,5,14,55,83,9,1,55,94,34,55,21,39,5,10,14,55,94
2014-10-20 00:00:00.000,Basel Switzerland ATP World Tour 500,HARD,2,Ivo Karlovic,Kenny De Schepper,Ivo Karlovic,6-7(6); 6-4; 6-3,R16,117,18,4,50,84,48,50,21,34,1,1,16,69,84,8,2,57,92,43,57,22,35,4,6,15,65,92
2014-10-20 00:00:00.000,Basel Switzerland ATP World Tour 500,HARD,2,David Goffin,Ivan Dodig,David Goffin,7-6(0); 6-4,R16,92,5,5,37,68,27,37,16,31,4,7,11,43,68,5,4,37,78,28,37,15,41,8,12,11,43,78
2014-10-20 00:00:00.000,Basel Switzerland ATP World Tour 500,HARD,2,Milos Raonic,Donald Young,Milos Raonic,6-4; 6-7(5); 7-6(2),R16,139,22,7,68,114,57,68,23,46,2,2,17,80,114,8,2,58,109,48,58,27,51,2,3,17,75,109
2014-10-20 00:00:00.000,Basel Switzerland ATP World Tour 500,HARD,2,Borna Coric,Andrey Golubev,Borna Coric,6-4; 6-4,R16,84,2,1,25,55,23,25,17,30,0,1,10,40,55,4,1,33,60,24,33,12,27,1,4,10,36,60
2014-10-20 00:00:00.000,Basel Switzerland ATP World Tour 500,HARD,2,Rafael Nadal,Pierre-Hugues Herbert,Rafael Nadal,6-1; 6-1,R16,57,0,1,29,41,21,29,9,12,2,2,7,30,41,2,11,10,37,6,10,8,27,1,6,7,14,37
2014-10-20 00:00:00.000,Basel Switzerland ATP World Tour 500,HARD,2,Roger Federer,Grigor Dimitrov,Roger Federer,7-6(4); 6-2,Q,90,10,1,37,65,31,37,18,28,4,4,10,49,65,7,1,45,74,32,45,13,29,4,6,10,45,74
2014-10-20 00:00:00.000,Basel Switzerland ATP World Tour 500,HARD,2,Ivo Karlovic,Benjamin Becker,Ivo Karlovic,6-4; 6-4,Q,76,19,5,46,62,40,46,4,16,4,5,10,44,62,4,3,43,64,28,43,11,21,3,6,10,39,64
2014-10-20 00:00:00.000,Basel Switzerland ATP World Tour 500,HARD,2,David Goffin,Milos Raonic,David Goffin,6-7(3); 6-3; 6-4,Q,135,12,6,48,104,44,48,28,56,6,7,16,72,104,21,8,54,110,45,54,25,56,6,9,15,70,110
2014-10-20 00:00:00.000,Basel Switzerland ATP World Tour 500,HARD,2,Borna Coric,Rafael Nadal,Borna Coric,6-2; 7-6(4),Q,101,6,2,36,74,29,36,20,38,3,4,10,49,74,1,0,44,60,30,44,7,16,2,5,10,37,60
2014-10-20 00:00:00.000,Basel Switzerland ATP World Tour 500,HARD,2,Roger Federer,Ivo Karlovic,Roger Federer,7-6(8); 3-6; 6-3,S,102,7,3,55,86,47,55,22,31,1,2,15,69,86,33,2,63,85,53,63,12,22,3,4,15,65,85
2014-10-20 00:00:00.000,Basel Switzerland ATP World Tour 500,HARD,2,David Goffin,Borna Coric,David Goffin,6-4; 3-6; 6-3,S,126,10,6,39,84,32,39,26,45,2,3,14,58,84,10,7,56,96,42,56,20,40,5,7,14,62,96
2014-10-20 00:00:00.000,Basel Switzerland ATP World Tour 500,HARD,2,Roger Federer,David Goffin,Roger Federer,6-2; 6-2,F,52,5,1,22,37,18,22,14,15,0,0,8,32,37,6,4,23,47,18,23,6,24,2,6,8,24,47
2014-10-20 00:00:00.000,Valencia Spain ATP World Tour 500,HARD,2,David Ferrer,Andreas Seppi,David Ferrer,6-3; 7-5,R32,94,1,2,36,58,27,36,13,22,1,3,11,40,58,3,1,37,71,22,37,15,34,5,9,10,37,71
2014-10-20 00:00:00.000,Valencia Spain ATP World Tour 500,HARD,2,Fernando Verdasco,Leonardo Mayer,Fernando Verdasco,6-4; 3-6; 6-3,R32,116,7,1,62,90,47,62,13,28,4,5,14,60,90,9,4,57,86,45,57,14,29,4,6,14,59,86
2014-10-20 00:00:00.000,Valencia Spain ATP World Tour 500,HARD,2,Thomaz Bellucci,Mikhail Youzhny,Thomaz Bellucci,7-5; 6-3,R32,77,8,3,34,56,29,34,12,22,0,0,10,41,56,5,3,42,68,27,42,14,26,4,7,11,41,68
2014-10-20 00:00:00.000,Valencia Spain ATP World Tour 500,HARD,2,Roberto Bautista Agut,Santiago Giraldo,Roberto Bautista Agut,6-4; 6-4,R32,70,1,2,37,48,32,37,8,11,0,0,10,40,48,1,1,40,59,23,40,13,19,0,2,10,36,59
2014-10-20 00:00:00.000,Valencia Spain ATP World Tour 500,HARD,2,Andy Murray,Jurgen Melzer,Andy Murray,6-3; 6-3,R32,80,10,3,32,52,26,32,6,20,5,8,9,32,52,0,2,39,59,19,39,7,20,5,11,9,26,59
2014-10-20 00:00:00.000,Valencia Spain ATP World Tour 500,HARD,2,Fabio Fognini,Albert Ramos-Vinolas,Fabio Fognini,6-4; 6-2,R32,68,3,1,27,43,23,27,13,16,0,0,9,36,43,2,6,41,67,26,41,12,26,6,9,9,38,67
2014-10-20 00:00:00.000,Valencia Spain ATP World Tour 500,HARD,2,Martin Klizan,Stefan Kozlov,Martin Klizan,6-3; 6-3,R32,82,1,3,36,62,27,36,13,26,5,6,9,40,62,2,4,31,55,19,31,12,24,7,11,9,31,55
2014-10-20 00:00:00.000,Valencia Spain ATP World Tour 500,HARD,2,Kevin Anderson,Philipp Kohlschreiber,Kevin Anderson,6-3; 6-4,R32,83,12,2,53,65,38,53,8,12,8,8,10,46,65,4,2,32,64,21,32,17,32,5,7,9,38,64
2014-10-20 00:00:00.000,Valencia Spain ATP World Tour 500,HARD,2,Alexandr Dolgopolov,Gilles Simon,Alexandr Dolgopolov,6-0; 6-3,R32,66,10,2,29,55,23,29,12,26,4,5,8,35,55,2,3,29,55,15,29,9,26,9,14,7,24,55
2014-10-20 00:00:00.000,Valencia Spain ATP World Tour 500,HARD,2,Jeremy Chardy,Malek Jaziri,Jeremy Chardy,6-2; 6-1,R32,47,6,2,19,35,18,19,10,16,0,0,7,28,35,2,1,23,49,15,23,5,26,1,6,8,20,49
2014-10-20 00:00:00.000,Valencia Spain ATP World Tour 500,HARD,2,Pablo Carreno Busta,Marcel Granollers,Pablo Carreno Busta,6-2; 3-1 RET,R32,60,0,0,20,33,16,20,9,13,1,1,6,25,33,2,1,13,40,9,13,11,27,3,6,6,20,40
2014-10-20 00:00:00.000,Valencia Spain ATP World Tour 500,HARD,2,Feliciano Lopez,Norbert Gombos,Feliciano Lopez,6-4; 6-4,R32,66,8,2,25,48,22,25,14,23,0,1,10,36,48,6,5,39,62,27,39,10,23,5,8,10,37,62
2014-10-20 00:00:00.000,Valencia Spain ATP World Tour 500,HARD,2,Tommy Robredo,John Isner,Tommy Robredo,7-6(3); 6-3,R32,80,6,1,47,65,43,47,9,18,5,5,11,52,65,10,1,45,68,34,45,12,23,5,6,10,46,68
2014-10-20 00:00:00.000,Valencia Spain ATP World Tour 500,HARD,2,Yen-Hsun Lu,Guillermo Garcia-Lopez,Yen-Hsun Lu,6-2; 6-3,R32,72,4,4,32,47,25,32,9,15,0,0,8,34,47,3,2,29,59,18,29,12,30,6,10,9,30,59
2014-10-20 00:00:00.000,Valencia Spain ATP World Tour 500,HARD,2,Dusan Lajovic,Joao Sousa,Dusan Lajovic,6-3; 7-6(8),R32,94,5,2,40,63,29,40,15,23,3,4,10,44,63,4,0,51,79,34,51,14,28,6,9,11,48,79
2014-10-20 00:00:00.000,Valencia Spain ATP World Tour 500,HARD,2,Pablo Andujar,Tomas Berdych,Pablo Andujar,6-3; 6-2,R32,71,1,0,26,43,20,26,14,17,3,3,8,34,43,5,4,23,47,16,23,8,24,1,5,9,24,47
2014-10-20 00:00:00.000,Valencia Spain ATP World Tour 500,HARD,2,David Ferrer,Fernando Verdasco,David Ferrer,6-3; 6-2,R16,68,1,0,34,51,26,34,12,17,0,0,9,38,51,5,5,32,50,23,32,6,18,6,9,8,29,50
2014-10-20 00:00:00.000,Valencia Spain ATP World Tour 500,HARD,2,Thomaz Bellucci,Roberto Bautista Agut,Thomaz Bellucci,W/O,R16,0,0,0,0,0,0,0,0,0,0,0,0,0,0,0,0,0,0,0,0,0,0,0,0,0,0,0
2014-10-20 00:00:00.000,Valencia Spain ATP World Tour 500,HARD,2,Andy Murray,Fabio Fognini,Andy Murray,6-2; 6-4,R16,72,4,1,25,44,23,25,13,19,0,0,9,36,44,2,5,39,69,25,39,12,30,7,10,9,37,69
2014-10-20 00:00:00.000,Valencia Spain ATP World Tour 500,HARD,2,Kevin Anderson,Martin Klizan,Kevin Anderson,W/O,R16,0,0,0,0,0,0,0,0,0,0,0,0,0,0,0,0,0,0,0,0,0,0,0,0,0,0,0
2014-10-20 00:00:00.000,Valencia Spain ATP World Tour 500,HARD,2,Jeremy Chardy,Alexandr Dolgopolov,Jeremy Chardy,3-6; 7-6(4); 7-5,R16,123,8,9,57,98,48,57,16,41,8,12,16,64,98,10,8,51,100,38,51,25,49,3,7,17,63,100
2014-10-20 00:00:00.000,Valencia Spain ATP World Tour 500,HARD,2,Pablo Carreno Busta,Feliciano Lopez,Pablo Carreno Busta,6-4; 6-4,R16,65,1,0,31,48,24,31,12,17,0,1,10,36,48,4,4,24,54,19,24,15,30,1,4,10,34,54
2014-10-20 00:00:00.000,Valencia Spain ATP World Tour 500,HARD,2,Tommy Robredo,Yen-Hsun Lu,Tommy Robredo,6-2; 6-4,R16,77,3,3,30,47,25,30,11,17,1,2,9,36,47,3,2,35,65,21,35,13,30,8,12,9,34,65
2014-10-20 00:00:00.000,Valencia Spain ATP World Tour 500,HARD,2,Pablo Andujar,Dusan Lajovic,Pablo Andujar,6-3; 6-2,R16,70,1,0,23,48,17,23,17,25,0,1,9,34,48,1,0,32,48,17,32,8,16,2,6,8,25,48
2014-10-20 00:00:00.000,Valencia Spain ATP World Tour 500,HARD,2,David Ferrer,Thomaz Bellucci,David Ferrer,6-1; 6-2,Q,67,1,1,30,47,24,30,11,17,3,3,8,35,47,1,1,28,55,15,28,11,27,4,8,7,26,55
2014-10-20 00:00:00.000,Valencia Spain ATP World Tour 500,HARD,2,Andy Murray,Kevin Anderson,Andy Murray,6-7(3); 6-4; 6-4,Q,164,8,7,45,93,36,45,23,48,3,6,16,59,93,9,2,80,120,53,80,15,40,7,12,16,68,120
2014-10-20 00:00:00.000,Valencia Spain ATP World Tour 500,HARD,2,Jeremy Chardy,Pablo Carreno Busta,Jeremy Chardy,6-1; 6-2,Q,51,7,1,27,48,25,27,11,21,3,3,8,36,48,1,1,20,35,13,20,4,15,1,5,7,17,35
2014-10-20 00:00:00.000,Valencia Spain ATP World Tour 500,HARD,2,Tommy Robredo,Pablo Andujar,Tommy Robredo,7-6(4); 6-4,Q,113,5,3,36,68,29,36,16,32,2,4,11,45,68,0,3,58,91,33,58,19,33,5,8,11,52,91
2014-10-20 00:00:00.000,Valencia Spain ATP World Tour 500,HARD,2,Andy Murray,David Ferrer,Andy Murray,6-4; 7-5,S,119,4,2,45,71,34,45,12,26,5,7,11,46,71,1,6,40,72,28,40,13,32,6,10,11,41,72
2014-10-20 00:00:00.000,Valencia Spain ATP World Tour 500,HARD,2,Tommy Robredo,Jeremy Chardy,Tommy Robredo,7-6(7); 7-6(2),S,121,6,6,48,97,34,48,26,49,4,6,12,60,97,5,4,49,81,35,49,16,32,1,3,12,51,81
2014-10-20 00:00:00.000,Valencia Spain ATP World Tour 500,HARD,2,Andy Murray,Tommy Robredo,Andy Murray,3-6; 7-6(7); 7-6(8),F,200,6,5,74,108,54,74,17,34,0,4,17,71,108,8,4,87,135,64,87,20,48,11,13,16,84,135
2014-10-27 00:00:00.000,ATP World Tour Masters 1000 Paris France ATP World Tour Masters 1000,HARD,2,Novak Djokovic,N/A Bye,Novak Djokovic,,R64,0,0,0,0,0,0,0,0,0,0,0,0,0,0,0,0,0,0,0,0,0,0,0,0,0,0,0
2014-10-27 00:00:00.000,ATP World Tour Masters 1000 Paris France ATP World Tour Masters 1000,HARD,2,Philipp Kohlschreiber,Edouard Roger-Vasselin,Philipp Kohlschreiber,6-3; 6-1,R64,62,8,0,28,48,24,28,11,20,3,3,8,35,48,5,4,26,48,19,26,5,22,2,6,8,24,48
2014-10-27 00:00:00.000,ATP World Tour Masters 1000 Paris France ATP World Tour Masters 1000,HARD,2,Gael Monfils,Joao Sousa,Gael Monfils,6-1; 6-4,R64,76,9,1,44,68,35,44,10,24,5,5,9,45,68,2,5,41,66,26,41,10,25,6,9,8,36,66
2014-10-27 00:00:00.000,ATP World Tour Masters 1000 Paris France ATP World Tour Masters 1000,HARD,2,John Isner,N/A Bye,John Isner,,R64,0,0,0,0,0,0,0,0,0,0,0,0,0,0,0,0,0,0,0,0,0,0,0,0,0,0,0
2014-10-27 00:00:00.000,ATP World Tour Masters 1000 Paris France ATP World Tour Masters 1000,HARD,2,Grigor Dimitrov,N/A Bye,Grigor Dimitrov,,R64,0,0,0,0,0,0,0,0,0,0,0,0,0,0,0,0,0,0,0,0,0,0,0,0,0,0,0
2014-10-27 00:00:00.000,ATP World Tour Masters 1000 Paris France ATP World Tour Masters 1000,HARD,2,Pablo Cuevas,Leonardo Mayer,Pablo Cuevas,7-6(3); 1-0 RET,R64,61,5,1,24,37,20,24,9,13,2,2,6,29,37,4,1,25,49,18,25,13,24,4,5,7,31,49
2014-10-27 00:00:00.000,ATP World Tour Masters 1000 Paris France ATP World Tour Masters 1000,HARD,2,Julien Benneteau,Yen-Hsun Lu,Julien Benneteau,6-3; 6-4,R64,67,7,2,33,58,27,33,15,25,0,0,10,42,58,7,3,31,47,25,31,8,16,0,2,9,33,47
2014-10-27 00:00:00.000,ATP World Tour Masters 1000 Paris France ATP World Tour Masters 1000,HARD,2,Andy Murray,N/A Bye,Andy Murray,,R64,0,0,0,0,0,0,0,0,0,0,0,0,0,0,0,0,0,0,0,0,0,0,0,0,0,0,0
2014-10-27 00:00:00.000,ATP World Tour Masters 1000 Paris France ATP World Tour Masters 1000,HARD,2,David Ferrer,N/A Bye,David Ferrer,,R64,0,0,0,0,0,0,0,0,0,0,0,0,0,0,0,0,0,0,0,0,0,0,0,0,0,0,0
2014-10-27 00:00:00.000,ATP World Tour Masters 1000 Paris France ATP World Tour Masters 1000,HARD,2,David Goffin,Lukas Rosol,David Goffin,6-4; 6-3,R64,66,9,2,33,62,26,33,18,29,2,2,10,44,62,3,3,25,49,22,25,9,24,1,3,9,31,49
2014-10-27 00:00:00.000,ATP World Tour Masters 1000 Paris France ATP World Tour Masters 1000,HARD,2,Fernando Verdasco,Donald Young,Fernando Verdasco,4-6; 6-1; 6-3,R64,100,9,3,45,77,36,45,18,32,2,3,13,54,77,1,10,50,89,31,50,19,39,4,8,13,50,89
2014-10-27 00:00:00.000,ATP World Tour Masters 1000 Paris France ATP World Tour Masters 1000,HARD,2,Gilles Simon,N/A Bye,Gilles Simon,,R64,0,0,0,0,0,0,0,0,0,0,0,0,0,0,0,0,0,0,0,0,0,0,0,0,0,0,0
2014-10-27 00:00:00.000,ATP World Tour Masters 1000 Paris France ATP World Tour Masters 1000,HARD,2,Jo-Wilfried Tsonga,N/A Bye,Jo-Wilfried Tsonga,,R64,0,0,0,0,0,0,0,0,0,0,0,0,0,0,0,0,0,0,0,0,0,0,0,0,0,0,0
2014-10-27 00:00:00.000,ATP World Tour Masters 1000 Paris France ATP World Tour Masters 1000,HARD,2,Jurgen Melzer,Guillermo Garcia-Lopez,Jurgen Melzer,6-4; 6-1,R64,65,3,0,34,42,24,34,5,8,0,1,8,29,42,2,5,26,55,14,26,14,29,3,8,9,28,55
2014-10-27 00:00:00.000,ATP World Tour Masters 1000 Paris France ATP World Tour Masters 1000,HARD,2,Tommy Robredo,Vasek Pospisil,Tommy Robredo,6-3; 4-6; 7-6(5),R64,130,1,4,80,117,53,80,22,37,5,7,15,75,117,13,4,45,82,39,45,23,37,0,3,16,62,82
2014-10-27 00:00:00.000,ATP World Tour Masters 1000 Paris France ATP World Tour Masters 1000,HARD,2,Kei Nishikori,N/A Bye,Kei Nishikori,,R64,0,0,0,0,0,0,0,0,0,0,0,0,0,0,0,0,0,0,0,0,0,0,0,0,0,0,0
2014-10-27 00:00:00.000,ATP World Tour Masters 1000 Paris France ATP World Tour Masters 1000,HARD,2,Tomas Berdych,N/A Bye,Tomas Berdych,,R64,0,0,0,0,0,0,0,0,0,0,0,0,0,0,0,0,0,0,0,0,0,0,0,0,0,0,0
2014-10-27 00:00:00.000,ATP World Tour Masters 1000 Paris France ATP World Tour Masters 1000,HARD,2,Adrian Mannarino,Pierre-Hugues Herbert,Adrian Mannarino,7-6(3); 6-3,R64,90,4,1,46,70,30,46,17,24,1,3,11,47,70,9,4,34,69,24,34,18,35,6,9,10,42,69
2014-10-27 00:00:00.000,ATP World Tour Masters 1000 Paris France ATP World Tour Masters 1000,HARD,2,Sam Querrey,Jerzy Janowicz,Sam Querrey,6-7(5); 6-2; 6-4,R64,117,17,4,55,101,46,55,23,46,3,3,15,69,101,11,6,64,97,52,64,10,33,6,9,15,62,97
2014-10-27 00:00:00.000,ATP World Tour Masters 1000 Paris France ATP World Tour Masters 1000,HARD,2,Feliciano Lopez,N/A Bye,Feliciano Lopez,,R64,0,0,0,0,0,0,0,0,0,0,0,0,0,0,0,0,0,0,0,0,0,0,0,0,0,0,0
2014-10-27 00:00:00.000,ATP World Tour Masters 1000 Paris France ATP World Tour Masters 1000,HARD,2,Kevin Anderson,N/A Bye,Kevin Anderson,,R64,0,0,0,0,0,0,0,0,0,0,0,0,0,0,0,0,0,0,0,0,0,0,0,0,0,0,0
2014-10-27 00:00:00.000,ATP World Tour Masters 1000 Paris France ATP World Tour Masters 1000,HARD,2,Santiago Giraldo,Mikhail Youzhny,Santiago Giraldo,6-2; 6-4,R64,63,1,0,28,44,21,28,9,16,1,3,9,30,44,1,4,31,54,19,31,7,23,3,8,9,26,54
2014-10-27 00:00:00.000,ATP World Tour Masters 1000 Paris France ATP World Tour Masters 1000,HARD,2,Dominic Thiem,Alexandr Dolgopolov,Dominic Thiem,6-2; 4-6; 6-0,R64,86,1,3,46,67,33,46,12,21,4,6,12,45,67,4,4,31,75,18,31,19,44,4,10,12,37,75
2014-10-27 00:00:00.000,ATP World Tour Masters 1000 Paris France ATP World Tour Masters 1000,HARD,2,Stan Wawrinka,N/A Bye,Stan Wawrinka,,R64,0,0,0,0,0,0,0,0,0,0,0,0,0,0,0,0,0,0,0,0,0,0,0,0,0,0,0
2014-10-27 00:00:00.000,ATP World Tour Masters 1000 Paris France ATP World Tour Masters 1000,HARD,2,Milos Raonic,N/A Bye,Milos Raonic,,R64,0,0,0,0,0,0,0,0,0,0,0,0,0,0,0,0,0,0,0,0,0,0,0,0,0,0,0
2014-10-27 00:00:00.000,ATP World Tour Masters 1000 Paris France ATP World Tour Masters 1000,HARD,2,Jack Sock,Pablo Andujar,Jack Sock,6-1; 6-1,R64,68,1,2,20,47,18,20,13,27,4,5,7,31,47,0,7,34,59,18,34,6,25,2,8,7,24,59
2014-10-27 00:00:00.000,ATP World Tour Masters 1000 Paris France ATP World Tour Masters 1000,HARD,2,Richard Gasquet,Denis Istomin,Richard Gasquet,6-7(4); 6-2; 4-0 RET,R64,122,13,2,50,79,42,50,16,29,2,2,12,58,79,12,2,51,83,34,51,18,32,4,8,12,52,83
2014-10-27 00:00:00.000,ATP World Tour Masters 1000 Paris France ATP World Tour Masters 1000,HARD,2,Roberto Bautista Agut,N/A Bye,Roberto Bautista Agut,,R64,0,0,0,0,0,0,0,0,0,0,0,0,0,0,0,0,0,0,0,0,0,0,0,0,0,0,0
2014-10-27 00:00:00.000,ATP World Tour Masters 1000 Paris France ATP World Tour Masters 1000,HARD,2,Fabio Fognini,N/A Bye,Fabio Fognini,,R64,0,0,0,0,0,0,0,0,0,0,0,0,0,0,0,0,0,0,0,0,0,0,0,0,0,0,0
2014-10-27 00:00:00.000,ATP World Tour Masters 1000 Paris France ATP World Tour Masters 1000,HARD,2,Lucas Pouille,Ivo Karlovic,Lucas Pouille,6-1; 6-4,R64,68,9,1,29,53,22,29,17,24,3,3,9,39,53,5,3,33,54,18,33,11,21,1,4,8,29,54
2014-10-27 00:00:00.000,ATP World Tour Masters 1000 Paris France ATP World Tour Masters 1000,HARD,2,Jeremy Chardy,Kenny De Schepper,Jeremy Chardy,7-6(5); 7-6(4),R64,123,8,5,59,94,46,59,17,35,6,6,12,63,94,15,4,52,82,42,52,13,30,2,2,12,55,82
2014-10-27 00:00:00.000,ATP World Tour Masters 1000 Paris France ATP World Tour Masters 1000,HARD,2,Roger Federer,N/A Bye,Roger Federer,,R64,0,0,0,0,0,0,0,0,0,0,0,0,0,0,0,0,0,0,0,0,0,0,0,0,0,0,0
2014-10-27 00:00:00.000,ATP World Tour Masters 1000 Paris France ATP World Tour Masters 1000,HARD,2,Novak Djokovic,Philipp Kohlschreiber,Novak Djokovic,6-3; 6-4,R32,85,3,1,38,62,28,38,13,24,0,1,10,41,62,2,0,27,58,18,27,15,31,4,7,9,33,58
2014-10-27 00:00:00.000,ATP World Tour Masters 1000 Paris France ATP World Tour Masters 1000,HARD,2,Gael Monfils,John Isner,Gael Monfils,6-4; 7-6(4),R32,93,11,2,47,68,38,47,14,21,0,0,11,52,68,9,1,63,85,47,63,8,22,8,9,11,55,85
2014-10-27 00:00:00.000,ATP World Tour Masters 1000 Paris France ATP World Tour Masters 1000,HARD,2,Grigor Dimitrov,Pablo Cuevas,Grigor Dimitrov,6-0; 6-3,R32,62,6,1,31,55,25,31,13,24,2,2,8,38,55,4,1,24,47,13,24,10,23,2,6,7,23,47
2014-10-27 00:00:00.000,ATP World Tour Masters 1000 Paris France ATP World Tour Masters 1000,HARD,2,Andy Murray,Julien Benneteau,Andy Murray,6-3; 6-4,R32,72,5,0,25,52,21,25,18,27,3,4,10,39,52,2,3,36,49,25,36,4,13,0,3,9,29,49
2014-10-27 00:00:00.000,ATP World Tour Masters 1000 Paris France ATP World Tour Masters 1000,HARD,2,David Ferrer,David Goffin,David Ferrer,6-3; 2-6; 6-3,R32,106,0,4,48,72,35,48,12,24,3,6,13,47,72,5,5,41,82,27,41,21,41,6,10,13,48,82
2014-10-27 00:00:00.000,ATP World Tour Masters 1000 Paris France ATP World Tour Masters 1000,HARD,2,Fernando Verdasco,Gilles Simon,Fernando Verdasco,6-3; 3-6; 6-4,R32,113,3,3,40,72,30,40,17,32,1,4,14,47,72,4,2,55,94,38,55,19,39,5,9,14,57,94
2014-10-27 00:00:00.000,ATP World Tour Masters 1000 Paris France ATP World Tour Masters 1000,HARD,2,Jo-Wilfried Tsonga,Jurgen Melzer,Jo-Wilfried Tsonga,6-2; 4-6; 6-2,R32,101,10,3,44,71,37,44,9,27,2,5,13,46,71,6,2,37,69,24,37,14,32,2,8,13,38,69
2014-10-27 00:00:00.000,ATP World Tour Masters 1000 Paris France ATP World Tour Masters 1000,HARD,2,Kei Nishikori,Tommy Robredo,Kei Nishikori,6-7(4); 6-2; 6-3,R32,117,4,6,53,91,46,53,22,38,2,2,15,68,91,3,2,50,83,35,50,19,33,3,6,14,54,83
2014-10-27 00:00:00.000,ATP World Tour Masters 1000 Paris France ATP World Tour Masters 1000,HARD,2,Tomas Berdych,Adrian Mannarino,Tomas Berdych,6-4; 6-7(3); 6-2,R32,142,7,1,51,90,37,51,24,39,3,5,15,61,90,8,5,56,108,39,56,28,52,6,11,15,67,108
2014-10-27 00:00:00.000,ATP World Tour Masters 1000 Paris France ATP World Tour Masters 1000,HARD,2,Feliciano Lopez,Sam Querrey,Feliciano Lopez,6-4; 6-4,R32,66,10,1,28,52,22,28,15,24,0,1,10,37,52,13,0,43,69,26,43,14,26,6,9,10,40,69
2014-10-27 00:00:00.000,ATP World Tour Masters 1000 Paris France ATP World Tour Masters 1000,HARD,2,Kevin Anderson,Santiago Giraldo,Kevin Anderson,6-4; 7-6(8),R32,115,12,3,64,89,50,64,10,25,5,6,11,60,89,2,1,66,86,42,66,13,20,4,6,11,55,86
2014-10-27 00:00:00.000,ATP World Tour Masters 1000 Paris France ATP World Tour Masters 1000,HARD,2,Stan Wawrinka,Dominic Thiem,Stan Wawrinka,6-4; 7-6(6),R32,97,2,2,45,73,38,45,12,28,2,3,11,50,73,3,1,59,83,43,59,8,24,5,7,11,51,83
2014-10-27 00:00:00.000,ATP World Tour Masters 1000 Paris France ATP World Tour Masters 1000,HARD,2,Milos Raonic,Jack Sock,Milos Raonic,6-3; 5-7; 7-6(4),R32,122,19,3,61,99,51,61,23,38,1,2,17,74,99,17,3,57,94,49,57,21,37,3,4,16,70,94
2014-10-27 00:00:00.000,ATP World Tour Masters 1000 Paris France ATP World Tour Masters 1000,HARD,2,Roberto Bautista Agut,Richard Gasquet,Roberto Bautista Agut,6-4; 6-2,R32,72,5,2,41,57,33,41,8,16,1,1,9,41,57,5,1,33,51,21,33,10,18,2,5,9,31,51
2014-10-27 00:00:00.000,ATP World Tour Masters 1000 Paris France ATP World Tour Masters 1000,HARD,2,Lucas Pouille,Fabio Fognini,Lucas Pouille,7-6(5); 7-6(7),R32,102,3,3,43,82,32,43,20,39,2,5,12,52,82,5,5,48,82,35,48,15,34,3,6,12,50,82
2014-10-27 00:00:00.000,ATP World Tour Masters 1000 Paris France ATP World Tour Masters 1000,HARD,2,Roger Federer,Jeremy Chardy,Roger Federer,7-6(5); 6-7(5); 6-4,R32,152,10,3,72,123,55,72,27,51,7,9,17,82,123,7,8,72,119,54,72,23,47,9,12,17,77,119
2014-10-27 00:00:00.000,ATP World Tour Masters 1000 Paris France ATP World Tour Masters 1000,HARD,2,Novak Djokovic,Gael Monfils,Novak Djokovic,6-3; 7-6(2),R16,92,1,5,39,70,32,39,16,31,2,3,11,48,70,12,4,38,60,27,38,10,22,4,6,10,37,60
2014-10-27 00:00:00.000,ATP World Tour Masters 1000 Paris France ATP World Tour Masters 1000,HARD,2,Andy Murray,Grigor Dimitrov,Andy Murray,6-3; 6-3,R16,70,7,2,29,44,27,29,9,15,0,0,9,36,44,0,2,33,53,21,33,10,20,1,4,9,31,53
2014-10-27 00:00:00.000,ATP World Tour Masters 1000 Paris France ATP World Tour Masters 1000,HARD,2,David Ferrer,Fernando Verdasco,David Ferrer,6-1; 6-2,R16,55,0,0,28,42,21,28,9,14,0,1,8,30,42,1,5,22,39,10,22,4,17,2,7,7,14,39
2014-10-27 00:00:00.000,ATP World Tour Masters 1000 Paris France ATP World Tour Masters 1000,HARD,2,Kei Nishikori,Jo-Wilfried Tsonga,Kei Nishikori,6-1; 4-6; 6-4,R16,129,1,3,47,87,33,47,24,40,5,6,13,57,87,10,5,51,101,38,51,21,50,8,12,14,59,101
2014-10-27 00:00:00.000,ATP World Tour Masters 1000 Paris France ATP World Tour Masters 1000,HARD,2,Tomas Berdych,Feliciano Lopez,Tomas Berdych,7-5; 6-3,R16,94,8,2,45,77,32,45,16,32,6,8,11,48,77,5,3,30,59,22,30,10,29,2,6,10,32,59
2014-10-27 00:00:00.000,ATP World Tour Masters 1000 Paris France ATP World Tour Masters 1000,HARD,2,Kevin Anderson,Stan Wawrinka,Kevin Anderson,6-7(2); 7-5; 7-6(3),R16,170,18,3,84,125,63,84,23,41,4,5,18,86,125,8,3,59,114,48,59,31,55,6,8,18,79,114
2014-10-27 00:00:00.000,ATP World Tour Masters 1000 Paris France ATP World Tour Masters 1000,HARD,2,Milos Raonic,Roberto Bautista Agut,Milos Raonic,7-5; 7-6(7),R16,104,23,2,48,84,38,48,17,36,2,4,12,55,84,1,5,57,80,37,57,14,23,3,6,12,51,80
2014-10-27 00:00:00.000,ATP World Tour Masters 1000 Paris France ATP World Tour Masters 1000,HARD,2,Roger Federer,Lucas Pouille,Roger Federer,6-4; 6-4,R16,75,4,1,29,54,27,29,15,25,0,0,10,42,54,7,3,47,77,37,47,10,30,8,10,10,47,77
2014-10-27 00:00:00.000,ATP World Tour Masters 1000 Paris France ATP World Tour Masters 1000,HARD,2,Novak Djokovic,Andy Murray,Novak Djokovic,7-5; 6-2,Q,101,1,1,35,55,28,35,12,20,1,2,10,40,55,5,3,34,67,23,34,14,33,9,13,10,37,67
2014-10-27 00:00:00.000,ATP World Tour Masters 1000 Paris France ATP World Tour Masters 1000,HARD,2,Kei Nishikori,David Ferrer,Kei Nishikori,3-6; 7-6(5); 6-4,Q,164,3,3,63,105,43,63,13,42,3,9,15,56,105,1,4,59,116,40,59,24,57,10,16,16,64,116
2014-10-27 00:00:00.000,ATP World Tour Masters 1000 Paris France ATP World Tour Masters 1000,HARD,2,Tomas Berdych,Kevin Anderson,Tomas Berdych,6-7(4); 6-4; 6-4,Q,154,16,7,54,103,48,54,22,49,0,2,16,70,103,12,2,69,101,52,69,13,32,5,9,16,65,101
2014-10-27 00:00:00.000,ATP World Tour Masters 1000 Paris France ATP World Tour Masters 1000,HARD,2,Milos Raonic,Roger Federer,Milos Raonic,7-6(5); 7-5,Q,93,21,1,47,70,40,47,15,23,1,1,12,55,70,8,1,43,69,38,43,14,26,1,2,12,52,69
2014-10-27 00:00:00.000,ATP World Tour Masters 1000 Paris France ATP World Tour Masters 1000,HARD,2,Novak Djokovic,Kei Nishikori,Novak Djokovic,6-2; 6-3,S,62,8,0,36,48,29,36,6,12,3,4,9,35,48,1,4,32,48,21,32,2,16,3,7,8,23,48
2014-10-27 00:00:00.000,ATP World Tour Masters 1000 Paris France ATP World Tour Masters 1000,HARD,2,Milos Raonic,Tomas Berdych,Milos Raonic,6-3; 3-6; 7-5,S,129,12,3,51,90,46,51,17,39,3,4,15,63,90,7,4,51,88,37,51,21,37,1,3,15,58,88
2014-10-27 00:00:00.000,ATP World Tour Masters 1000 Paris France ATP World Tour Masters 1000,HARD,2,Novak Djokovic,Milos Raonic,Novak Djokovic,6-2; 6-3,F,83,4,0,42,56,34,42,7,14,4,4,9,41,56,9,2,37,56,24,37,7,19,6,9,8,31,56
